,active_period,swap_count,burn_mean_period,swap_mean_period,swapIn,swapOut,lp_avg,creator_holding_ratio
0,25188,31,25188,779,27,4,4.761904761904762,72.38
1,204,23,204,52,21,2,5.0,56.32
2,15828,94,15828,123,88,6,1.162790697674419,7.12
3,185700,972,0,5602,539,433,1.0,0.0
4,226284,581,0,19135,254,327,1.818181818181818,5.0
5,1956,57,0,663,46,11,50.0,99.99
6,3372,3,0,1156,1,2,100.0,0.0
7,216,18,216,62,16,2,9.090909090909092,68.03
8,251736,60,0,5822,51,9,100.0,0.0
9,38736,58,0,1902,39,19,100.0,100.0
10,72,3,48,32,2,1,25.0,62.36
11,240468,544,0,7851,290,254,2.127659574468085,7.73
12,13236,50,13236,125,48,2,3.571428571428572,68.1
13,29796,33,29796,1128,26,7,5.555555555555555,70.63
14,2484,56,0,717,45,11,33.333333333333336,0.0
15,540,6,0,358,4,2,25.0,2.54
16,21192,32,21192,1587,29,3,4.0,76.1
17,12000,43,0,1312,28,15,100.0,0.0
18,83412,569,0,5913,298,271,2.0,0.0
19,1524,14,1524,1290,12,2,9.090909090909092,87.89
20,372,32,372,145,29,3,5.882352941176471,14.54
21,83208,221,0,7594,168,53,2.9411764705882355,0.0
22,44268,48,0,1722,36,12,50.0,0.0
23,34524,38,0,1489,27,11,100.0,100.0
24,1020,5,1020,76,3,2,33.333333333333336,37.59
25,8748,143,0,480,79,64,2.4390243902439024,0.0
26,44160,45,0,1762,33,12,50.0,0.0
27,1452,21,1452,24,21,0,4.3478260869565215,56.09
28,288,24,288,95,22,2,4.545454545454546,21.66
29,2232,28,2232,837,22,6,5.555555555555555,42.26
30,268992,284,0,40803,154,130,1.7857142857142858,0.0
31,56304,368,0,872,299,69,1.0,0.0
32,72468,26,0,14457,20,6,7.142857142857143,0.12
33,144120,222,0,1808,105,117,3.125,0.0
34,11604,119,0,949,70,49,100.0,0.0
35,79284,75,79284,4115,60,15,1.694915254237288,40.03
36,2520,27,2520,396,18,9,9.090909090909092,32.37
37,250068,932,4476,2808,517,415,1.0,0.0
38,225648,904,0,3811,476,428,1.694915254237288,3.39
39,1320,69,1320,64,41,28,2.702702702702702,67.37
40,48744,46,0,1930,38,8,50.0,0.0
41,170448,732,0,7713,427,305,2.2222222222222223,0.0
42,13032,44,0,928,36,8,50.0,0.0
43,231360,1722,0,6895,992,730,1.0,0.0
44,281712,448,0,113585,216,232,1.0,0.0
45,17736,31,0,2490,18,13,8.333333333333334,0.0
46,468,7,468,145,7,0,14.285714285714286,43.89
47,83280,89,83280,1831,74,15,1.4492753623188406,7.02
48,75852,53,75852,16004,49,4,2.5641025641025643,9.7
49,46752,60,0,2169,43,17,100.0,100.0
50,240000,603,0,22718,568,35,1.4492753623188406,0.0
51,65544,42,0,3799,36,6,100.0,0.0
52,250488,218,0,4271,134,84,3.571428571428572,0.0
53,273048,679,2592,8975,336,343,1.0526315789473684,0.0
54,66948,22,66948,374,18,4,6.666666666666667,49.0
55,39456,226,0,3318,153,73,1.2820512820512822,0.0
56,10836,16,10836,519,15,1,6.25,86.83
57,10236,178,0,1069,104,74,100.0,0.0
58,852,0,852,0,0,0,100.0,100.0
59,5976,109,0,335,72,37,100.0,0.0
60,132,6,0,22,6,0,11.11111111111111,23.77
61,744,2,744,0,2,0,25.0,22.03
62,284940,276,279216,159258,276,0,1.0,70.77
63,27180,24,27180,4026,20,4,4.761904761904762,66.4
64,18216,1083,0,1623,948,135,1.0,0.0
65,312,6,312,40,4,2,20.0,94.28
66,36144,36,0,1476,25,11,100.0,100.0
67,288396,4564,42636,75619,2623,1941,1.0,0.0
68,3384,26,3384,885,19,7,7.6923076923076925,85.96
69,126432,209,0,1070,103,106,2.9411764705882355,0.0
70,276480,112,170172,22915,77,35,1.8867924528301887,11.85
71,81264,48,0,3752,46,2,50.0,0.0
72,1464,2,1464,402,2,0,50.0,99.99
73,228,83,228,64,33,50,8.333333333333334,24.0
74,1488,18,1488,444,12,6,14.285714285714286,0.0
75,156300,486,0,4139,277,209,2.3255813953488373,0.0
76,12012,40,0,1293,25,15,100.0,0.0
77,96,1,96,36,1,0,33.333333333333336,63.17
78,186828,607,0,1728,333,274,1.5625,0.0
79,7500,21,7500,536,17,4,6.666666666666667,86.21
80,17928,48,0,1043,34,14,100.0,100.0
81,1128,119,0,252,50,69,5.882352941176471,3.95
82,4908,104,0,787,74,30,2.1739130434782608,0.0
83,70488,72,0,4594,67,5,50.0,0.0
84,7728,9,7728,3261,7,2,16.666666666666668,56.94
85,3852,134,0,813,81,53,100.0,0.0
86,290280,38,0,42323,35,3,50.0,0.0
87,18468,22,18468,688,20,2,5.2631578947368425,51.36
88,283560,3849,0,87995,2195,1654,1.0,0.0
89,179760,940,0,3804,515,425,1.2048192771084338,0.0
90,1512,41,1512,754,30,11,6.666666666666667,88.43
91,246288,348,0,14129,181,167,2.2222222222222223,0.0
92,97536,53,97536,11549,52,1,2.1739130434782608,12.7
93,20496,14,20496,522,13,1,9.090909090909092,70.23
94,48,34,48,13,20,14,6.25,61.15
95,8412,18,8412,67,16,2,6.666666666666667,52.59
96,1668,77,1668,22,65,12,1.694915254237288,10.36
97,2052,36,2052,742,26,10,6.25,0.0
98,60,72,60,18,42,30,3.4482758620689653,51.77
99,2136,117,2136,24,109,8,1.0,6.34
100,84,3,84,24,2,1,25.0,12.78
101,280176,328,0,7417,195,133,1.7857142857142858,1.99
102,67308,12,67308,3391,10,2,25.0,93.46
103,2544,302,2544,298,134,168,2.380952380952381,22.74
104,264,0,264,0,0,0,100.0,100.0
105,77280,194,77280,6444,192,2,3.0303030303030303,18.48
106,29664,47,0,3632,39,8,50.0,0.0
107,9240,9,48,1040,7,2,14.285714285714286,52.89
108,204,14,204,120,10,4,10.0,66.06
109,48,2,48,0,2,0,25.0,76.42
110,10476,17,10476,128,14,3,9.090909090909092,58.82
111,468,28,468,179,27,1,5.2631578947368425,14.58
112,1524,7,1524,288,7,0,12.5,0.0
113,96,20,96,16,14,6,7.6923076923076925,45.66
114,45480,27,45480,422,24,3,4.761904761904762,64.42
115,12924,125,12924,490,55,70,7.142857142857143,89.07
116,1464,16,1464,26,13,3,8.333333333333334,75.08
117,792,186,792,302,124,62,1.1235955056179776,34.15
118,12084,20,12084,196,17,3,6.25,45.94
119,1320,27,1188,562,20,7,6.25,85.43
120,299004,3133,146520,74264,1795,1338,1.0,0.2
121,756,21,756,471,17,4,7.6923076923076925,0.0
122,2568,31,2568,148,27,4,4.166666666666667,53.01
123,192,25,192,63,19,6,5.555555555555555,42.06
124,288,23,288,86,13,10,20.0,67.5
125,4824,40,4824,1864,28,12,1.1363636363636365,17.47
126,120,84,120,9,66,18,1.6666666666666667,41.25
127,56712,0,56712,0,0,0,50.0,81.3
128,8952,45,0,1090,30,15,100.0,0.0
129,612,39,612,470,35,4,2.857142857142857,25.62
130,48,76,36,12,62,14,1.694915254237288,7.57
131,120,108,120,10,90,18,1.2048192771084338,28.91
132,7104,119,0,204,52,67,5.555555555555555,0.0
133,19500,50,0,1362,39,11,50.0,0.0
134,288,14,288,10,12,2,8.333333333333334,65.97
135,19740,48,0,1194,39,9,50.0,0.0
136,19872,46,0,1368,38,8,50.0,0.0
137,25860,25,25860,20,24,1,4.166666666666667,82.0
138,173652,514,0,2330,279,235,1.7543859649122806,0.0
139,2988,6,2988,262,4,2,33.333333333333336,98.71
140,15960,120,324,269,89,31,12.5,94.21
141,81936,46,0,3496,45,1,50.0,0.0
142,276,4,276,12,2,2,50.0,56.84
143,68304,715,0,1589,509,206,1.0,0.0
144,288,13,264,104,8,5,16.666666666666668,65.65
145,72,45,72,26,31,14,3.8461538461538463,43.0
146,271548,354,0,2458,185,169,1.5873015873015872,0.0
147,300,7,300,102,7,0,11.11111111111111,91.62
148,92988,67,92988,4233,54,13,9.090909090909092,19.59
149,156,44,156,54,28,16,4.545454545454546,52.35
150,672,10,672,147,7,3,25.0,58.24
151,384,238,264,125,164,74,1.0,17.61
152,1884,45,0,784,37,8,100.0,0.0
153,8220,20,8220,190,17,3,6.25,48.51
154,303048,4284,0,80299,2503,1781,1.0,3.48
155,246276,434,0,4168,217,217,2.083333333333333,0.0
156,216,74,216,106,30,44,9.090909090909092,39.07
157,299112,1809,0,17796,1009,800,1.0,0.0
158,1608,57,1608,141,30,27,16.666666666666668,69.9
159,7800,99,4956,1859,51,48,3.703703703703704,65.77
160,26532,2,1968,26394,1,1,50.0,13.46
161,33084,5,0,11517,3,2,50.0,0.0
162,3036,235,3036,221,101,134,2.857142857142857,19.72
163,108,25,108,10,24,1,4.166666666666667,50.47
164,291264,538,0,34744,285,253,1.25,0.0
165,48,30,48,12,24,6,4.761904761904762,18.73
166,96,42,96,36,26,16,5.0,57.96
167,144,109,108,35,69,40,2.0,53.3
168,1020,68,1020,131,26,42,14.285714285714286,85.45
169,54972,30,0,3750,26,4,50.0,0.0
170,169284,53,0,10933,31,22,11.11111111111111,0.0
171,52332,88,0,1632,51,37,5.0,2.0
172,1116,7,1116,414,4,3,50.0,99.97
173,16152,140,0,2063,88,52,2.272727272727273,0.0
174,2436,51,0,1002,42,9,100.0,100.0
175,201180,947,0,1841,493,454,1.1363636363636365,0.0
176,9036,30,5334,698,22,8,5.882352941176471,91.95
177,216,46,120,92,43,3,2.4390243902439024,28.56
178,768,20,768,279,13,7,12.5,45.52
179,624,20,84,48,15,5,8.333333333333334,45.1
180,83100,51,2484,3692,29,22,5.2631578947368425,69.75
181,3612,5,3612,787,5,0,20.0,95.84
182,2172,66,0,849,51,15,100.0,100.0
183,456,34,456,76,19,15,16.666666666666668,66.15
184,176664,689,0,2950,345,344,2.5,0.0
185,251892,535,0,2126,193,342,2.272727272727273,5.7
186,249144,195,0,3527,95,100,4.0,0.0
187,34416,13,34416,413,11,2,10.0,59.51
188,144,21,84,72,18,3,5.2631578947368425,51.66
189,309108,3935,0,33347,2232,1703,1.0,0.0
190,336,0,336,0,0,0,50.0,59.29
191,60,36,0,18,26,10,4.166666666666667,0.0
192,92076,47,92076,11551,44,3,2.5,13.7
193,168,12,168,3,12,0,7.142857142857143,64.15
194,252,6,0,92,3,3,100.0,0.0
195,132,77,132,54,51,26,2.5641025641025643,39.18
196,81276,338,0,2817,169,169,2.9411764705882355,0.0
197,4320,1,0,4320,1,0,50.0,40.0
198,42240,16,42240,346,15,1,6.666666666666667,65.42
199,108,2,108,12,1,1,50.0,63.45
200,62724,12,62724,3761,8,4,11.11111111111111,58.5
201,103236,295,0,1676,153,142,2.5,0.0
202,22020,213,0,1519,131,82,1.6666666666666667,0.0
203,1968,18,1968,376,15,3,6.666666666666667,88.92
204,43392,19,43392,776,17,2,7.142857142857143,71.85
205,89184,162,0,4780,84,78,5.2631578947368425,1.97
206,588,3,456,364,2,1,25.0,50.51
207,279132,284,0,49997,179,105,1.818181818181818,0.17
208,456,11,456,302,7,4,14.285714285714286,88.74
209,38304,36,38304,997,28,8,5.555555555555555,46.74
210,408,36,408,157,35,1,2.857142857142857,44.16
211,147768,1,147768,348,1,0,33.333333333333336,76.24
212,204,31,204,46,23,8,4.761904761904762,64.97
213,1272,23,1272,663,18,5,6.25,70.93
214,24912,37,0,1044,28,9,100.0,100.0
215,876,14,876,523,8,6,9.090909090909092,56.25
216,504,0,504,0,0,0,100.0,100.0
217,396,135,396,128,103,32,5.0,44.86
218,0,0,0,0,0,0,100.0,100.0
219,888,95,888,145,67,28,1.818181818181818,41.84
220,480,291,480,162,142,149,2.5641025641025643,73.39
221,193716,501,0,4593,255,246,2.702702702702702,0.0
222,36192,47,0,1837,37,10,50.0,0.0
223,180,0,180,0,0,0,50.0,60.1
224,6372,39,6372,1064,33,6,4.761904761904762,35.07
225,26664,45,0,1056,32,13,100.0,100.0
226,301128,1570,0,46880,961,609,1.0,0.0
227,207324,252,0,3518,123,129,4.3478260869565215,5.0
228,492,133,492,147,93,40,1.96078431372549,17.53
229,269424,1856,0,21148,1102,754,1.0,0.0
230,244908,2117,0,18858,1181,936,1.0,0.0
231,6384,106,0,764,77,29,1.9230769230769231,0.0
232,121452,601,0,2226,263,338,2.083333333333333,0.0
233,120,8,120,15,5,3,25.0,28.96
234,312,72,312,57,48,24,2.631578947368421,47.39
235,260820,544,0,37258,270,274,1.6129032258064515,0.0
236,97236,250,0,1254,119,131,3.125,0.0
237,156,2,156,30,2,0,25.0,59.8
238,12516,43,0,1281,28,15,100.0,0.0
239,28872,75,0,1005,53,22,100.0,100.0
240,283464,280,0,7011,153,127,3.8461538461538463,0.0
241,153456,4,153456,927,2,2,50.0,39.62
242,372,24,120,58,16,8,9.090909090909092,24.12
243,7944,28,7944,1096,25,3,4.545454545454546,74.68
244,324,63,324,44,57,6,2.631578947368421,60.15
245,48,51,48,15,31,20,4.3478260869565215,54.17
246,14820,36,0,504,17,19,14.285714285714286,0.0
247,300,34,300,35,25,9,5.555555555555555,62.62
248,152808,442,0,11648,205,237,2.127659574468085,0.0
249,47664,198,0,10865,150,48,100.0,0.0
250,588,13,588,506,9,4,11.11111111111111,75.11
251,912,74,0,169,58,16,100.0,0.0
252,307128,1141,0,2445,739,402,1.0,0.0
253,228,293,204,62,188,105,1.0,38.74
254,185952,594,0,3947,325,269,1.9230769230769231,2.31
255,179208,389,0,7353,190,199,2.5,0.0
256,828,31,828,577,31,0,3.0303030303030303,32.01
257,69792,218,0,1790,108,110,3.703703703703704,0.0
258,176124,1207,0,7854,649,558,1.0,0.0
259,2724,8,2724,541,6,2,16.666666666666668,0.0
260,300,217,264,98,155,62,2.631578947368421,63.7
261,96,3,96,40,2,1,33.333333333333336,77.68
262,96,0,96,0,0,0,50.0,60.1
263,22488,162,0,480,76,86,4.0,0.0
264,13920,90,0,965,59,31,100.0,0.0
265,336,35,336,108,34,1,2.9411764705882355,50.45
266,624,48,624,110,27,21,12.5,68.33
267,3192,64,3192,59,54,10,1.96078431372549,17.92
268,96,3,96,64,3,0,20.0,51.84
269,588,1,588,0,1,0,33.333333333333336,58.52
270,3228,118,0,689,77,41,100.0,0.0
271,7776,350,1368,247,197,153,1.0,36.59
272,1608,15,1608,58,14,1,6.666666666666667,71.68
273,226224,43,0,18389,27,16,7.6923076923076925,0.0
274,4272,5,4272,52,5,0,14.285714285714286,21.6
275,222684,110,222684,3433,50,60,5.2631578947368425,82.26
276,1032,69,1032,140,27,42,12.5,87.47
277,268188,102,0,7369,44,58,7.142857142857143,0.0
278,576,11,576,118,11,0,7.6923076923076925,64.42
279,127572,905,0,2774,513,392,1.2195121951219512,0.0
280,63156,16,72,5592,15,1,6.25,14.88
281,228,121,228,94,73,48,1.851851851851852,25.23
282,360,1,360,24,1,0,33.333333333333336,62.56
283,792,3,0,396,2,1,50.0,0.0
284,648,47,648,37,37,10,2.9411764705882355,50.5
285,270900,142,0,5016,64,78,6.25,0.0
286,5148,138,0,742,84,54,100.0,0.0
287,329856,7227,0,41888,4092,3135,1.0,0.0
288,64116,257,0,1809,173,84,100.0,0.0
289,1020,51,1020,297,44,7,3.703703703703704,62.77
290,282324,996,0,3052,630,366,1.0,0.0
291,84,102,72,36,62,40,2.3255813953488373,57.19
292,146376,21,146376,926,17,4,7.6923076923076925,39.96
293,16356,21,16356,529,17,4,7.142857142857143,63.6
294,58908,27,58908,88,25,2,3.8461538461538463,25.36
295,11352,41,0,1218,26,15,100.0,0.0
296,1500,42,0,112,33,9,100.0,0.0
297,6960,0,6960,0,0,0,50.0,77.0
298,267324,323,0,4387,150,173,2.702702702702702,0.0
299,43248,48,43248,2109,39,9,2.702702702702702,54.48
300,144,272,144,41,168,104,1.075268817204301,28.78
301,168,35,168,55,25,10,5.0,52.66
302,3252,87,0,227,51,36,100.0,0.0
303,252,9,0,121,5,4,33.333333333333336,0.0
304,144336,333,0,3573,187,146,2.127659574468085,0.0
305,1524,125,0,424,93,32,100.0,0.0
306,147396,26,147396,897,22,4,6.666666666666667,68.08
307,1704,26,1704,674,18,8,1.162790697674419,21.64
308,334812,1639,0,21523,908,731,1.0,0.0
309,132,41,132,33,27,14,4.545454545454546,53.91
310,444,7,444,156,7,0,11.11111111111111,58.57
311,331032,734,0,24241,344,390,1.694915254237288,0.0
312,2172,104,984,549,60,44,2.272727272727273,46.0
313,300,3,300,84,2,1,33.333333333333336,78.27
314,240,92,204,107,75,17,1.7857142857142858,28.45
315,231984,932,0,4287,539,393,1.0,0.0
316,240,13,96,51,10,3,10.0,22.35
317,4188,79,0,1109,55,24,100.0,100.0
318,264,1,264,192,0,1,50.0,86.67
319,72,34,72,25,24,10,6.25,43.94
320,4200,24,1308,627,16,8,11.11111111111111,0.0
321,6732,2,6732,240,2,0,100.0,100.0
322,540,13,48,60,9,4,11.11111111111111,59.51
323,33276,61,33276,2419,52,9,11.11111111111111,17.29
324,80928,5,0,16512,3,2,33.333333333333336,0.0
325,228,47,192,86,27,20,5.555555555555555,64.74
326,312,168,312,77,108,60,1.818181818181818,38.13
327,117720,221,0,882,108,113,2.5641025641025643,0.0
328,3660,62,0,1590,49,13,100.0,0.0
329,9552,243,396,120,160,83,1.1494252873563218,60.13
330,200208,870,0,3001,586,284,1.0,0.0
331,7572,170,0,914,140,30,100.0,0.0
332,7284,49,0,879,37,12,100.0,100.0
333,4068,12,4068,816,8,4,16.666666666666668,96.11
334,285588,944,0,6756,534,410,1.0,0.0
335,324,9,324,117,8,1,11.11111111111111,51.86
336,333408,865,0,162909,507,358,1.0,0.45
337,90216,23,0,5563,22,1,50.0,0.0
338,7152,71,0,916,49,22,100.0,100.0
339,456,19,456,86,14,5,9.090909090909092,66.37
340,924,0,924,0,0,0,50.0,81.0
341,13752,23,13752,429,21,2,5.2631578947368425,34.6
342,58248,139,58248,1638,103,36,1.0638297872340423,20.34
343,343392,1416,0,44258,816,600,1.0,2.72
344,576,0,576,0,0,0,50.0,59.29
345,336,35,336,80,35,0,2.7777777777777777,47.0
346,328248,2122,0,12239,1158,964,1.0,0.0
347,53220,46,0,3698,43,3,50.0,0.0
348,720,99,720,60,71,28,1.7241379310344829,11.51
349,346620,2435,0,54461,1305,1130,1.0,2.66
350,26292,189,0,1432,135,54,1.6666666666666667,0.0
351,11232,30,11232,1201,20,10,8.333333333333334,28.09
352,228,13,228,49,11,2,8.333333333333334,70.09
353,108,8,108,30,4,4,50.0,58.99
354,10056,698,0,2293,446,252,1.0,0.0
355,888,8,888,309,4,4,50.0,54.66
356,180,53,180,20,31,22,4.545454545454546,41.64
357,302340,966,0,3753,551,415,1.1235955056179776,0.0
358,2796,6,2796,52,6,0,12.5,70.84
359,600,1,600,252,1,0,33.333333333333336,89.81
360,3528,25,0,1084,15,10,12.5,4.0
361,15372,28,15372,29,17,11,12.5,56.94
362,348,3,348,272,2,1,33.333333333333336,95.52
363,17520,126,0,1190,77,49,100.0,0.0
364,528,23,528,171,19,4,5.882352941176471,40.56
365,384,66,348,107,63,3,1.694915254237288,38.78
366,564,109,564,70,71,38,1.408450704225352,65.53
367,8244,4,8244,2184,3,1,50.0,60.64
368,33600,209,0,1254,125,84,100.0,0.0
369,336,127,336,94,69,58,2.702702702702702,66.93
370,17076,23,17076,9,23,0,4.0,33.09
371,282228,829,0,2658,428,401,1.4705882352941178,0.0
372,31848,51,0,1464,39,12,50.0,0.0
373,307896,229,0,165585,155,74,1.5625,0.0
374,14976,33,14976,1709,28,5,3.8461538461538463,0.17
375,291780,1715,10164,6204,945,770,1.3888888888888888,0.0
376,43104,31,43104,500,27,4,5.882352941176471,42.86
377,32676,52,0,1426,41,11,50.0,0.0
378,33168,51,0,2223,44,7,50.0,0.0
379,1212,63,0,235,40,23,100.0,0.0
380,209568,517,0,2496,270,247,1.851851851851852,0.0
381,54360,41,46224,10005,39,2,2.5641025641025643,17.95
382,33600,55,0,2000,42,13,50.0,0.0
383,59904,49,0,3276,42,7,50.0,0.0
384,45324,26,45324,273,22,4,5.882352941176471,46.7
385,14436,65,0,920,46,19,100.0,100.0
386,59544,14,59544,441,13,1,9.090909090909092,69.66
387,21720,19,21720,714,15,4,7.142857142857143,42.56
388,34452,26,34452,1130,23,3,5.2631578947368425,50.25
389,48,8,48,22,4,4,50.0,22.12
390,408,1,408,0,1,0,33.333333333333336,54.07
391,56328,43,0,3660,36,7,100.0,0.0
392,65484,1,65484,132,1,0,50.0,99.96
393,768,17,84,77,15,2,7.6923076923076925,68.57
394,120024,9,120024,44,9,0,10.0,88.63
395,84,48,84,24,36,12,3.333333333333333,10.44
396,59580,27,59580,1485,26,1,4.545454545454546,22.24
397,39192,217,0,1151,134,83,1.5151515151515151,0.0
398,1092,51,0,218,43,8,100.0,0.0
399,432,72,432,30,64,8,1.5873015873015872,30.05
400,15672,65,0,1034,44,21,100.0,100.0
401,3180,119,0,1117,87,32,100.0,100.0
402,142224,439,0,1973,229,210,2.272727272727273,0.0
403,9264,22,9264,540,19,3,5.555555555555555,86.25
404,2316,20,2316,759,20,0,5.0,55.1
405,95556,139,0,2685,60,79,7.142857142857143,0.0
406,5460,139,0,697,61,78,9.090909090909092,5.0
407,216,12,216,20,11,1,8.333333333333334,17.64
408,372,19,372,75,18,1,5.555555555555555,66.83
409,168,4,168,57,2,2,50.0,58.66
410,324,76,300,83,38,38,5.555555555555555,65.17
411,15108,70,0,828,50,20,100.0,100.0
412,72,10,72,19,5,5,50.0,61.25
413,346152,896,0,2199,473,423,1.0638297872340423,2.38
414,2508,78,0,947,59,19,100.0,0.0
415,132420,377,0,1909,196,181,2.9411764705882355,0.0
416,228,25,228,43,17,8,9.090909090909092,51.66
417,72,19,72,15,18,1,5.555555555555555,51.56
418,68832,61,68832,2862,55,6,2.127659574468085,10.09
419,12024,42,0,1293,26,16,100.0,0.0
420,10572,26,10572,10112,20,6,6.25,79.13
421,1296,7,0,858,6,1,50.0,0.0
422,1620,25,1620,20,24,1,4.166666666666667,81.02
423,2364,27,2364,923,27,0,4.0,51.43
424,252,121,144,66,89,32,1.2820512820512822,7.83
425,13176,10,0,1856,5,5,12.5,0.0
426,11988,11,11988,646,9,2,25.0,95.33
427,492,38,492,10,32,6,3.225806451612903,49.38
428,339996,914,0,4576,458,456,1.492537313432836,0.0
429,240,8,240,54,4,4,33.333333333333336,97.01
430,58212,47,0,4774,43,4,50.0,0.0
431,324,5,276,175,4,1,25.0,71.6
432,1032,1,1032,504,1,0,50.0,99.93
433,13992,11,13992,387,9,2,20.0,95.58
434,124416,695,0,1486,379,316,1.5873015873015872,0.0
435,364584,4417,0,55497,2489,1928,1.0,0.0
436,48972,132,1032,474,102,30,1.4285714285714286,54.48
437,1212,12,1056,182,11,1,7.6923076923076925,23.66
438,17004,4,17004,4623,4,0,6.25,0.0
439,350196,16,0,289285,14,2,7.142857142857143,0.0
440,8544,23,8544,428,20,3,5.882352941176471,88.11
441,2016,20,2016,1000,16,4,16.666666666666668,93.82
442,364104,3102,302172,31738,1632,1470,1.0,0.0
443,19368,151,0,1332,87,64,100.0,0.0
444,13644,8,0,2251,6,2,16.666666666666668,0.04
445,62628,54,0,4271,49,5,50.0,0.0
446,354768,681,354768,178481,651,30,1.1764705882352942,20.54
447,12792,15,12792,1217,13,2,10.0,72.78
448,996,67,996,207,30,37,7.6923076923076925,74.63
449,17784,0,17784,0,0,0,50.0,90.0
450,420,105,0,167,81,24,16.666666666666668,0.0
451,492,58,492,20,46,12,2.4390243902439024,43.26
452,108,42,0,30,32,10,3.703703703703704,0.0
453,366120,2283,0,14266,1242,1041,1.0,0.77
454,15072,46,0,1099,40,6,50.0,0.0
455,396,12,396,8,11,1,8.333333333333334,56.28
456,15480,50,0,1233,41,9,50.0,0.0
457,19680,17,19680,172,12,5,25.0,99.56
458,15780,48,0,1088,38,10,50.0,0.0
459,11412,14,11412,138,13,1,7.142857142857143,59.11
460,36408,18,36408,326,16,2,6.666666666666667,68.18
461,15096,23,15096,492,19,4,6.25,30.4
462,16224,48,0,817,39,9,50.0,0.0
463,1440,190,0,408,100,90,100.0,0.0
464,150612,32,150612,987,26,6,5.555555555555555,39.86
465,365412,7346,0,24726,4042,3304,1.0,0.0
466,28392,62,28392,1797,51,11,10.0,17.8
467,1932,25,1932,558,23,2,5.0,53.58
468,45480,14,45480,33431,14,0,6.25,92.53
469,47892,46,47892,803,36,10,4.545454545454546,63.98
470,13368,24,13368,293,19,5,7.142857142857143,47.66
471,321108,573,0,1571,289,284,2.272727272727273,0.0
472,96672,32,96672,1267,24,8,12.5,73.07
473,12000,44,0,1226,30,14,100.0,0.0
474,432,21,264,130,19,2,5.2631578947368425,52.89
475,1644,98,1644,1049,70,28,1.7543859649122806,22.11
476,444,2,444,156,2,0,25.0,23.05
477,1956,37,1956,111,34,3,3.125,33.2
478,159864,1,1044,159864,1,0,100.0,100.0
479,65760,34,0,2494,28,6,50.0,0.0
480,864,2,864,12,2,0,25.0,73.0
481,240996,1209,0,2118,633,576,1.1764705882352942,6.51
482,16416,21,16416,306,18,3,7.142857142857143,46.41
483,12492,7,0,3958,5,2,100.0,0.0
484,375912,15489,106602,77181,8692,6797,1.0,0.0
485,72468,281,72468,5466,273,8,1.162790697674419,23.78
486,328848,778,0,4243,400,378,1.36986301369863,0.0
487,33504,47,0,3521,40,7,50.0,0.0
488,1428,51,1428,10,45,6,2.3255813953488373,40.36
489,23004,45,0,2117,39,6,100.0,0.0
490,24216,25,24216,2114,23,2,4.166666666666667,20.52
491,159048,33,159048,1959,27,6,4.761904761904762,33.48
492,258216,59,258216,33306,53,6,2.272727272727273,17.73
493,188760,134,188760,2952,74,60,1.851851851851852,58.82
494,4116,50,4116,1289,45,5,2.9411764705882355,30.02
495,187236,15,187236,140420,15,0,6.25,86.58
496,312,17,132,38,13,4,8.333333333333334,43.32
497,147300,17,85164,32467,14,3,10.0,56.74
498,6900,28,6900,365,24,4,5.2631578947368425,42.99
499,144,72,144,33,44,28,5.0,83.29
500,5280,118,5280,1147,115,3,1.3888888888888888,50.39
501,23124,57,23124,4091,51,6,2.3255813953488373,12.83
502,684,22,684,9,20,2,5.0,63.93
503,14232,53,0,1371,45,8,50.0,0.0
504,300,14,300,44,14,0,7.6923076923076925,46.62
505,1440,5,1440,19,3,2,25.0,52.57
506,50760,47,0,2400,32,15,33.333333333333336,0.0
507,14700,45,0,1101,34,11,50.0,0.0
508,30972,43,0,2873,34,9,50.0,0.0
509,15156,46,0,1072,41,5,50.0,0.0
510,10056,26,10056,280,21,5,5.882352941176471,40.08
511,15708,50,0,1035,41,9,50.0,0.0
512,216,29,216,27,17,12,12.5,56.45
513,396,20,396,110,18,2,6.25,17.58
514,32952,16,32952,505,15,1,6.25,63.53
515,456,6,456,218,6,0,12.5,51.58
516,80640,0,80640,0,0,0,100.0,100.0
517,192,14,192,93,10,4,12.5,51.71
518,14760,23,14760,477,20,3,5.555555555555555,86.17
519,34164,104,0,3855,92,12,50.0,0.0
520,60,4,60,9,3,1,25.0,56.4
521,305664,1043,0,3682,532,511,1.0,0.0
522,156,127,156,54,87,40,1.7857142857142858,49.92
523,76968,19,0,4173,17,2,5.555555555555555,0.0
524,5928,33,5928,385,29,4,4.166666666666667,44.46
525,1788,40,1788,790,31,9,1.098901098901099,17.98
526,48,4,48,12,2,2,50.0,54.94
527,96,62,96,29,32,30,5.2631578947368425,20.16
528,324,24,288,199,22,2,4.761904761904762,64.25
529,50796,288,396,582,158,130,1.075268817204301,40.21
530,22416,68,0,2286,61,7,50.0,0.0
531,576,33,576,162,30,3,3.125,67.73
532,13572,49,0,1801,41,8,100.0,0.0
533,4188,88,4188,1411,38,50,5.2631578947368425,63.13
534,25152,46,0,2005,41,5,50.0,0.0
535,156,1,156,0,1,0,33.333333333333336,74.0
536,2160,80,0,804,62,18,100.0,0.0
537,352164,2207,3288,6785,1192,1015,1.0,0.0
538,792,29,792,209,26,3,6.25,53.34
539,3096,2,3096,1674,1,1,100.0,100.0
540,60,7,60,0,7,0,11.11111111111111,59.85
541,352824,91,0,4549,51,40,3.225806451612903,5.0
542,395988,179,0,112852,165,14,1.1235955056179776,0.0
543,12000,50,0,1283,32,18,100.0,0.0
544,408,0,408,0,0,0,50.0,80.0
545,2292,72,0,856,56,16,100.0,100.0
546,336,23,336,94,20,3,5.882352941176471,55.67
547,282816,36,45156,74828,27,9,11.11111111111111,94.96
548,72,6,72,22,3,3,50.0,62.32
549,12228,55,0,1296,46,9,50.0,0.0
550,26868,9,26868,366,8,1,12.5,72.64
551,12744,48,0,1111,38,10,50.0,0.0
552,321996,1864,0,7367,1027,837,1.0,0.0
553,5088,17,5088,248,15,2,9.090909090909092,73.36
554,13164,56,0,1508,47,9,50.0,0.0
555,1428,24,1428,711,19,5,7.6923076923076925,92.24
556,13644,48,0,991,36,12,50.0,0.0
557,45588,10,45588,3476,6,4,25.0,75.06
558,105312,17,105312,857,15,2,9.090909090909092,54.42
559,60,24,60,14,15,9,12.5,62.6
560,32520,45,32520,1627,38,7,4.166666666666667,25.85
561,402432,18852,0,89059,10795,8057,1.0,0.0
562,60,46,60,18,38,8,2.7777777777777777,27.54
563,4236,16,4236,891,11,5,11.11111111111111,98.15
564,49728,56,27876,2407,48,8,9.090909090909092,24.05
565,10632,343,10632,5769,340,3,1.0,25.5
566,45600,149,0,1224,102,47,1.818181818181818,0.0
567,336,2,336,216,2,0,33.333333333333336,98.06
568,816,3,552,348,1,2,100.0,0.0
569,180432,1154,0,5514,628,526,1.1111111111111112,0.0
570,45180,208,0,1475,125,83,1.818181818181818,0.0
571,398148,1729,233700,51234,1102,627,1.0,0.0
572,324,10,324,14,10,0,8.333333333333334,53.47
573,79320,229,79320,1066,147,82,1.3157894736842106,0.31
574,72,37,72,16,34,3,3.0303030303030303,22.17
575,6096,17,5877,650,11,6,12.5,55.61
576,1332,81,1332,289,41,40,4.545454545454546,79.99
577,5664,23,5664,2285,16,7,11.11111111111111,64.55
578,184152,272,0,3543,131,141,4.0,0.0
579,1860,25,1704,661,18,7,7.6923076923076925,88.49
580,34788,68,0,1104,47,21,100.0,100.0
581,265764,120,0,5135,61,59,9.090909090909092,0.0
582,38148,45,38148,787,41,4,3.225806451612903,58.44
583,37848,44,37848,1533,37,7,3.8461538461538463,31.53
584,192,10,192,64,10,0,8.333333333333334,60.8
585,63204,4,0,18318,2,2,100.0,0.0
586,1452,24,1452,708,20,4,5.555555555555555,75.29
587,12000,51,0,1100,34,17,100.0,0.0
588,84,21,84,14,14,7,11.11111111111111,59.88
589,88320,11,0,20332,5,6,50.0,0.0
590,5736,186,0,1708,133,53,1.5873015873015872,0.0
591,47928,68,0,1923,28,40,16.666666666666668,0.0
592,6540,229,0,805,158,71,1.36986301369863,0.0
593,444,19,192,84,18,1,5.2631578947368425,54.94
594,1752,19,1752,658,13,6,8.333333333333334,83.07
595,372,20,372,109,20,0,4.545454545454546,58.77
596,97860,1,0,97860,1,0,25.0,0.0
597,1644,26,1644,958,24,2,4.761904761904762,81.12
598,34524,23,34524,462,23,0,4.166666666666667,48.42
599,405084,1197,90384,29432,666,531,1.0,0.0
600,33684,37,20124,3043,33,4,3.125,16.2
601,396,63,0,159,51,12,100.0,0.0
602,26364,46,9900,2102,39,7,6.25,99.49
603,41100,73,0,1235,52,21,100.0,100.0
604,1224,10,0,847,5,5,33.333333333333336,0.0
605,44808,11,44808,1195,9,2,25.0,96.3
606,312,7,312,132,7,0,14.285714285714286,69.57
607,3708,4,3708,750,2,2,25.0,59.58
608,288,8,288,145,8,0,11.11111111111111,95.69
609,552,2,0,462,1,1,50.0,0.0
610,414372,3053,0,147098,1822,1231,1.0,0.0
611,720,42,120,53,34,8,3.125,45.21
612,540,10,540,183,7,3,16.666666666666668,97.15
613,12,1,0,12,1,0,33.333333333333336,62.0
614,3420,71,0,1505,58,13,100.0,0.0
615,432,7,432,164,7,0,16.666666666666668,95.9
616,44328,67,0,1730,52,15,100.0,100.0
617,456,81,456,145,69,12,1.7241379310344829,29.92
618,325788,18,1020,18264,16,2,14.285714285714286,31.91
619,684,7,684,265,7,0,12.5,96.5
620,414504,1477,0,13427,845,632,1.0,2.0
621,57912,7,57912,766,7,0,11.11111111111111,45.46
622,8196,45,8196,1602,38,7,6.666666666666667,99.63
623,18444,63,18444,3528,24,39,33.333333333333336,90.33
624,167808,2,167808,744,2,0,33.333333333333336,95.8
625,1884,0,1884,0,0,0,100.0,0.0
626,60,0,60,0,0,0,50.0,61.58
627,588,14,588,60,10,4,12.5,20.82
628,288,6,288,112,5,1,16.666666666666668,24.36
629,62244,4,62244,1503,4,0,20.0,92.55
630,2832,44,2832,101,41,3,2.4390243902439024,5.5
631,108,12,108,49,9,3,12.5,59.97
632,8664,158,0,973,94,64,100.0,0.0
633,168,26,168,77,21,5,5.555555555555555,50.13
634,1656,14,1656,630,8,6,20.0,72.57
635,7488,8,7488,948,7,1,20.0,97.4
636,2796,242,0,908,162,80,1.4705882352941178,0.0
637,360,10,360,206,8,2,12.5,91.44
638,12012,47,0,1178,31,16,100.0,0.0
639,7392,28,7392,1121,24,4,4.761904761904762,94.67
640,46620,80,0,5001,40,40,7.6923076923076925,0.0
641,236064,2088,0,12499,1177,911,1.0,0.0
642,108,55,108,35,35,20,3.703703703703704,63.61
643,410160,2783,11976,19113,1549,1234,1.0,0.0
644,1248,126,0,65,70,56,100.0,0.0
645,4980,40,0,425,30,10,100.0,100.0
646,468,7,468,306,7,0,11.11111111111111,68.86
647,3576,22,3576,1546,17,5,8.333333333333334,81.18
648,75564,191,0,2447,77,114,6.666666666666667,0.0
649,3600,50,0,411,33,17,3.703703703703704,0.0
650,65268,19,20089,10260,17,2,5.882352941176471,91.08
651,7860,98,0,697,69,29,100.0,0.0
652,8436,90,0,773,40,50,9.090909090909092,0.0
653,413268,978,0,16544,538,440,1.36986301369863,0.0
654,4320,198,0,81,136,62,100.0,0.0
655,288,17,288,189,17,0,5.2631578947368425,49.77
656,282324,423,0,12826,230,193,2.0408163265306123,14.04
657,3372,7,0,2506,1,6,20.0,60.0
658,1236,0,1236,0,0,0,100.0,100.0
659,411876,3049,0,6503,1660,1389,1.0,0.0
660,205644,523,0,4444,250,273,2.2222222222222223,0.0
661,312,45,288,56,33,12,4.166666666666667,37.97
662,83148,152,0,999,125,27,100.0,0.0
663,284904,16,0,19332,9,7,20.0,0.0
664,132,0,132,0,0,0,50.0,59.29
665,192,28,192,41,18,10,10.0,46.54
666,312,11,312,150,8,3,16.666666666666668,89.28
667,310956,833,0,4646,461,372,1.2820512820512822,0.0
668,2568,5,2460,1012,3,2,25.0,0.0
669,1800,117,1800,897,61,56,4.545454545454546,79.79
670,45288,26,45288,1092,23,3,5.555555555555555,64.56
671,402012,20,260556,166716,12,8,1.0,69.11
672,66264,7,66264,35874,6,1,33.333333333333336,35.41
673,324,1,324,12,1,0,50.0,83.92
674,22464,20,22464,699,13,7,11.11111111111111,89.88
675,600,26,600,22,20,6,6.25,60.38
676,18588,57,18588,2617,49,8,11.11111111111111,20.11
677,252,1,252,36,1,0,50.0,62.91
678,310008,785,0,37473,398,387,1.818181818181818,0.0
679,282480,67,0,47316,55,12,100.0,0.0
680,1392,4,1392,432,4,0,20.0,0.0
681,204,3,204,28,1,2,33.333333333333336,85.05
682,16824,16,16824,7674,13,3,7.6923076923076925,92.91
683,33504,77,33504,51,53,24,2.3255813953488373,37.62
684,372,176,0,54,93,83,50.0,50.0
685,376500,292,0,8418,149,143,3.0303030303030303,0.0
686,360,53,360,24,41,12,2.702702702702702,48.94
687,293868,382,0,5709,228,154,1.96078431372549,2.94
688,1272,49,1272,309,27,22,12.5,0.0
689,972,1,972,792,1,0,100.0,100.0
690,2016,24,2016,938,23,1,7.6923076923076925,56.45
691,60,22,48,15,21,1,4.761904761904762,47.65
692,11976,48,0,952,36,12,100.0,100.0
693,39948,18,39948,863,15,3,7.6923076923076925,55.94
694,756,4,756,324,2,2,50.0,99.99
695,33108,181,0,1926,116,65,1.851851851851852,0.0
696,44808,75,0,4890,67,8,50.0,0.0
697,38964,46,0,1668,37,9,50.0,0.0
698,1116,10,1116,766,9,1,14.285714285714286,73.09
699,9996,41,9996,1101,34,7,4.0,92.98
700,342036,3448,0,64158,1767,1681,1.0,0.0
701,11844,58,11844,35,49,9,2.5,52.11
702,7656,11,7656,1282,10,1,14.285714285714286,95.7
703,1632,0,1632,0,0,0,100.0,0.0
704,2304,6,84,422,3,3,33.333333333333336,22.09
705,12012,41,0,1409,26,15,100.0,0.0
706,39660,46,0,1708,35,11,50.0,0.0
707,400248,2261,0,8998,1341,920,1.0,0.0
708,40176,50,0,1909,40,10,50.0,0.0
709,744,9,744,386,8,1,11.11111111111111,75.49
710,4488,21,4488,468,18,3,9.090909090909092,61.29
711,864,11,864,255,11,0,10.0,96.2
712,1932,59,0,669,48,11,100.0,100.0
713,564,7,564,245,5,2,25.0,93.52
714,96,9,96,25,9,0,10.0,69.8
715,125556,4,75522,41664,4,0,16.666666666666668,99.73
716,66876,79,66876,437,53,26,2.702702702702702,28.33
717,480,9,480,237,9,0,14.285714285714286,93.12
718,437328,3183,0,21281,1758,1425,1.0,0.22
719,2892,52,0,684,37,15,100.0,100.0
720,41508,53,0,1738,41,12,50.0,0.0
721,312,6,312,140,6,0,14.285714285714286,97.2
722,288,44,288,74,36,8,2.9411764705882355,23.2
723,120,16,120,30,13,3,8.333333333333334,16.56
724,47400,41,0,2606,35,6,100.0,0.0
725,32820,17,32820,417,15,2,7.142857142857143,81.05
726,63180,17,63180,3256,14,3,11.11111111111111,53.09
727,780,11,780,293,9,2,14.285714285714286,94.82
728,3636,164,0,1405,109,55,1.9230769230769231,0.0
729,199920,891,0,4256,484,407,1.7543859649122806,0.0
730,120,13,120,47,10,3,11.11111111111111,62.11
731,96,10,72,39,9,1,11.11111111111111,62.44
732,360,39,360,52,38,1,2.631578947368421,45.85
733,2916,67,2916,1669,66,1,1.492537313432836,19.57
734,2868,131,0,1032,98,33,100.0,100.0
735,13092,3,13092,1064,3,0,20.0,96.36
736,14520,16,7020,2029,13,3,12.5,94.67
737,7824,88,7824,1977,68,20,2.4390243902439024,30.8
738,2280,57,2280,20,39,18,3.125,46.1
739,192,0,192,0,0,0,100.0,0.0
740,4560,8,0,880,8,0,12.5,90.68
741,1632,3,180,612,2,1,50.0,0.0
742,1404,5,1404,103,4,1,25.0,74.19
743,948,1,948,900,1,0,50.0,61.01
744,427452,1674,0,10165,902,772,1.1111111111111112,0.0
745,31956,65,31956,1918,54,11,3.333333333333333,51.96
746,132,3,132,84,2,1,33.333333333333336,0.0
747,1692,26,960,164,25,1,4.166666666666667,61.89
748,2340,145,2340,158,79,66,4.3478260869565215,85.32
749,16332,65,16332,3844,55,10,2.1739130434782608,12.54
750,14220,46,14220,1658,33,13,3.8461538461538463,16.34
751,696,100,672,132,54,46,3.125,66.94
752,504,4,456,384,2,2,50.0,96.08
753,276,13,276,96,7,6,20.0,0.0
754,17520,24,17520,525,19,5,6.666666666666667,85.42
755,0,0,0,0,0,0,33.333333333333336,2.0
756,3240,10,3240,706,9,1,25.0,95.34
757,6072,218,0,2133,148,70,1.5384615384615383,0.0
758,351936,9,0,39262,8,1,100.0,0.0
759,448344,1774,0,10985,1030,744,1.0,4.99
760,396,7,396,186,6,1,16.666666666666668,96.53
761,22140,23,324,1019,19,4,5.555555555555555,52.66
762,912,231,852,281,129,102,1.6666666666666667,51.08
763,12000,46,0,1503,32,14,100.0,0.0
764,840,8,840,328,8,0,16.666666666666668,94.6
765,312,53,312,31,47,6,2.1739130434782608,40.25
766,32844,328,0,1509,224,104,1.1764705882352942,0.0
767,312,9,312,128,8,1,14.285714285714286,94.44
768,79644,20,0,5107,14,6,100.0,0.0
769,336,9,336,161,7,2,16.666666666666668,95.77
770,7032,36,7032,1124,31,5,7.142857142857143,99.59
771,22092,27,22092,685,24,3,5.555555555555555,66.65
772,451176,1319,0,30520,742,577,1.0,0.0
773,147804,83,10488,10933,49,34,8.333333333333334,0.0
774,14880,35,14880,833,28,7,6.25,51.6
775,1152,8,576,418,6,2,16.666666666666668,58.59
776,2112,12,2112,763,10,2,20.0,93.06
777,153264,51,101352,15308,43,8,5.2631578947368425,14.62
778,64176,46,0,3432,39,7,50.0,0.0
779,64620,30,0,3329,27,3,50.0,0.0
780,13056,20,13056,913,18,2,6.25,89.27
781,720,11,720,329,11,0,10.0,53.86
782,408,4,408,219,3,1,33.333333333333336,96.38
783,12696,12,12696,702,12,0,14.285714285714286,96.39
784,408,12,276,182,10,2,11.11111111111111,95.17
785,11172,36,11172,1127,31,5,4.761904761904762,78.65
786,78864,61,78864,3791,53,8,2.272727272727273,14.3
787,1536,34,924,321,27,7,6.666666666666667,56.56
788,20532,314,0,2016,199,115,1.075268817204301,0.0
789,20124,45,0,1942,38,7,100.0,0.0
790,228,17,120,43,15,2,6.25,40.71
791,235872,23,12384,10778,20,3,5.882352941176471,87.69
792,12048,44,0,1284,30,14,100.0,0.0
793,25512,240,0,1756,154,86,1.818181818181818,0.0
794,840,4,840,588,4,0,16.666666666666668,78.15
795,312,65,312,67,38,27,5.2631578947368425,14.79
796,34092,115,0,1324,76,39,100.0,0.0
797,29880,49,0,3867,44,5,100.0,0.0
798,1764,42,1764,772,31,11,33.333333333333336,35.4
799,84,35,84,17,25,10,5.555555555555555,48.8
800,240,1,240,60,1,0,33.333333333333336,62.76
801,288,23,288,53,19,4,5.2631578947368425,39.81
802,122220,375,0,2024,191,184,2.3255813953488373,0.0
803,144,0,144,0,0,0,50.0,59.29
804,261708,12,261708,1908,5,7,33.333333333333336,92.2
805,27552,28,0,3486,25,3,50.0,0.0
806,469032,3427,0,146345,2131,1296,1.0,0.0
807,336,5,336,110,5,0,14.285714285714286,70.31
808,26076,50,0,1288,38,12,50.0,0.0
809,26412,57,0,1359,49,8,50.0,0.0
810,900,0,900,0,0,0,100.0,100.0
811,465324,7855,22620,43939,4280,3575,1.0,0.0
812,26784,51,0,1546,39,12,50.0,0.0
813,91584,51,0,11539,40,11,100.0,0.0
814,27132,46,0,1017,36,10,50.0,0.0
815,780,1,780,744,1,0,33.333333333333336,80.8
816,264,26,264,74,22,4,4.545454545454546,16.06
817,106500,260,12132,2948,257,3,1.0,18.46
818,27852,19,27852,3929,14,5,10.0,84.36
819,2808,35,2808,2518,35,0,2.702702702702702,25.58
820,180,7,180,6,5,2,20.0,58.39
821,474228,35761,184177,183857,20687,15074,1.0,0.0
822,312,21,312,93,21,0,4.3478260869565215,46.52
823,8880,3,0,2972,1,2,5.882352941176471,0.0
824,1344,48,468,252,39,9,1.0,14.69
825,32448,53,0,2776,50,3,50.0,0.0
826,12468,18,12468,190,15,3,11.11111111111111,67.7
827,351192,1630,3204,3539,870,760,1.0,0.0
828,15732,401,15732,317,183,218,2.127659574468085,61.92
829,432,31,432,113,31,0,7.142857142857143,38.36
830,440604,1320,0,2713,727,593,1.0,0.0
831,468,20,468,138,17,3,7.6923076923076925,50.11
832,77268,12,77268,717,10,2,12.5,57.91
833,1776,20,1776,871,15,5,6.25,83.53
834,1140,19,1140,140,19,0,5.555555555555555,57.37
835,9384,43,0,1839,36,7,100.0,0.0
836,36456,150,36456,638,75,75,1.6666666666666667,47.61
837,84,12,36,11,9,3,10.0,20.79
838,12528,42,0,1800,34,8,100.0,0.0
839,23556,46,0,1685,31,15,50.0,0.0
840,22068,34,22068,1083,29,5,5.555555555555555,99.34
841,42156,63,42156,1569,55,8,9.090909090909092,21.14
842,264,82,264,39,38,44,5.2631578947368425,75.01
843,108,21,108,28,20,1,4.545454545454546,46.45
844,5916,170,5916,1363,165,5,1.4705882352941178,17.12
845,360,6,276,160,4,2,100.0,100.0
846,132,12,132,13,12,0,7.142857142857143,53.0
847,2448,67,0,775,52,15,100.0,0.0
848,9948,2,0,4980,1,1,100.0,0.0
849,30960,0,30960,0,0,0,50.0,90.0
850,408,133,408,215,84,49,1.7857142857142858,52.73
851,600,64,600,244,42,22,3.125,55.04
852,600,6,600,250,6,0,14.285714285714286,99.19
853,456888,5,0,94051,4,1,100.0,0.0
854,480096,5558,0,25161,3134,2424,1.0,0.0
855,1716,27,1200,436,21,6,7.6923076923076925,64.39
856,387408,68,0,46767,63,5,1.7543859649122806,0.0
857,250440,19,130644,50549,18,1,11.11111111111111,99.81
858,476532,2144,0,11171,1274,870,1.0,0.08
859,17724,24,17724,515,22,2,4.761904761904762,70.68
860,161604,25,161604,20130,23,2,11.11111111111111,57.77
861,2184,64,0,710,51,13,50.0,90.0
862,480,31,480,2,31,0,3.0303030303030303,65.24
863,26736,27,26736,1539,24,3,5.2631578947368425,95.45
864,21588,13,0,2920,7,6,20.0,0.0
865,84,11,84,13,8,3,12.5,66.53
866,21936,34,21936,253,28,6,6.25,74.62
867,130596,35,130596,4332,29,6,5.2631578947368425,60.35
868,2856,121,0,990,89,32,100.0,0.0
869,5916,11,5916,992,7,4,14.285714285714286,91.86
870,31848,279,7092,1939,271,8,1.0,16.43
871,290004,47,0,9051,31,16,11.11111111111111,0.0
872,15480,63,0,1232,54,9,50.0,0.0
873,72,2,72,12,1,1,50.0,63.48
874,504,79,504,121,73,6,1.639344262295082,28.24
875,8808,28,8808,1037,24,4,8.333333333333334,99.37
876,22992,217,0,1711,134,83,1.7241379310344829,0.0
877,16068,50,0,1386,42,8,50.0,0.0
878,487200,39,265365,282232,35,4,12.5,99.8
879,16380,51,0,1159,39,12,50.0,0.0
880,144,3,144,52,2,1,25.0,37.06
881,16524,55,0,1206,48,7,50.0,0.0
882,2376,10,2376,1201,8,2,14.285714285714286,93.89
883,51528,35,0,2924,30,5,33.333333333333336,0.0
884,38748,12,38748,796,11,1,7.6923076923076925,63.07
885,11880,18,11880,4816,14,4,9.090909090909092,65.55
886,504,50,504,1,50,0,1.96078431372549,50.7
887,120792,24,120792,1440,20,4,5.2631578947368425,38.82
888,12012,41,0,1445,26,15,100.0,0.0
889,25824,29,25824,698,23,6,5.882352941176471,71.27
890,3984,175,0,1396,118,57,1.5873015873015872,0.0
891,30528,63,0,4083,56,7,50.0,0.0
892,96,14,48,25,7,7,33.333333333333336,60.66
893,540,9,540,121,9,0,9.090909090909092,95.98
894,420,85,420,173,76,9,1.3888888888888888,18.66
895,12732,19,12732,2791,15,4,8.333333333333334,79.31
896,648,73,0,101,66,7,1.5384615384615383,0.0
897,364932,170,0,8710,85,85,4.545454545454546,2.99
898,48,15,48,9,10,5,14.285714285714286,51.48
899,346548,378,0,11180,165,213,2.631578947368421,2.0
900,1200,0,1200,0,0,0,100.0,100.0
901,84,0,84,0,0,0,50.0,59.29
902,1752,16,1752,397,13,3,7.142857142857143,75.53
903,5736,55,1140,601,38,17,5.882352941176471,30.28
904,123192,47,123192,11527,38,9,4.761904761904762,33.39
905,10944,23,10944,332,20,3,5.882352941176471,77.19
906,120,36,108,24,30,6,3.571428571428572,27.56
907,134424,23,0,6136,17,6,100.0,0.0
908,420144,1822,0,17970,951,871,1.0,3.0
909,67128,29,0,7106,11,18,25.0,1.0
910,1224,5,1224,616,4,1,25.0,99.33
911,299808,340,0,20997,181,159,3.571428571428572,0.0
912,80940,6,80940,934,6,0,20.0,56.47
913,38832,48,38832,1519,40,8,4.166666666666667,64.05
914,288,16,288,90,16,0,5.555555555555555,59.07
915,384,48,384,67,47,1,2.083333333333333,58.1
916,88812,12,0,19603,5,7,50.0,0.0
917,9108,87,0,839,56,31,3.4482758620689653,0.0
918,241704,157,0,18038,69,88,3.703703703703704,0.12
919,434844,37,0,187275,37,0,5.0,70.12
920,445572,31,0,116951,16,15,1.0,8.75
921,18060,58,18060,1929,50,8,7.6923076923076925,14.29
922,13092,3,108,4456,2,1,33.333333333333336,25.17
923,441792,1152,0,11813,706,446,1.0,0.0
924,528,6,528,0,6,0,12.5,68.0
925,8280,50,8280,1000,43,7,2.9411764705882355,14.29
926,120,2,120,0,2,0,25.0,62.4
927,176988,756,1188,3638,424,332,1.1764705882352942,9.41
928,396,18,396,42,15,3,7.142857142857143,62.16
929,162288,194,0,5456,100,94,4.545454545454546,4.75
930,488868,3421,0,46588,1969,1452,1.0,3.0
931,2100,11,2100,314,10,1,20.0,93.66
932,335580,326,0,9841,182,144,4.545454545454546,4.76
933,0,0,0,0,0,0,50.0,0.0
934,3144,118,3144,570,75,43,3.333333333333333,79.24
935,492,24,492,55,21,3,5.0,60.15
936,12012,48,0,1139,33,15,100.0,0.0
937,408,7,408,157,7,0,12.5,95.91
938,684,9,684,290,7,2,12.5,65.36
939,1812,53,1068,80,41,12,2.7777777777777777,13.53
940,91488,50,0,20377,20,30,50.0,0.0
941,206844,71,0,13277,29,42,12.5,0.0
942,348,28,348,14,26,2,3.703703703703704,40.5
943,72,0,72,0,0,0,50.0,60.1
944,312,0,312,0,0,0,50.0,88.0
945,2280,62,2280,1183,40,22,4.545454545454546,50.36
946,85572,95,85572,1167,71,24,1.4705882352941178,21.76
947,3108,146,0,677,85,61,100.0,0.0
948,204,0,204,0,0,0,100.0,100.0
949,6372,207,0,2043,134,73,2.631578947368421,0.0
950,3432,39,3432,85,30,9,4.166666666666667,41.75
951,240,6,240,94,3,3,50.0,22.37
952,64788,4,64788,471,3,1,25.0,83.7
953,13044,143,0,550,103,40,1.351351351351351,0.0
954,648,0,648,0,0,0,100.0,100.0
955,503808,564,0,88793,256,308,1.2345679012345678,0.0
956,12396,38,12396,1515,33,5,4.166666666666667,55.53
957,3816,96,0,859,75,21,100.0,0.0
958,228,13,228,114,10,3,11.11111111111111,52.98
959,1056,0,1056,0,0,0,50.0,0.0
960,455736,311,0,23952,166,145,3.0303030303030303,30.43
961,1788,23,1788,61,21,2,4.545454545454546,50.49
962,1140,55,1140,41,39,16,2.9411764705882355,54.73
963,247344,5,247344,1548,5,0,16.666666666666668,56.33
964,168,14,168,23,8,6,25.0,72.42
965,72,14,72,2,13,1,7.142857142857143,15.13
966,395964,229,0,2827,105,124,3.571428571428572,3.0
967,588,2,588,144,2,0,33.333333333333336,23.04
968,485592,1532,0,38834,765,767,1.0,5.3
969,127056,291,0,1830,141,150,2.0,0.0
970,456,0,456,0,0,0,50.0,82.15
971,10416,28,10416,3152,20,8,5.555555555555555,68.83
972,246036,2,0,123444,1,1,100.0,0.0
973,1116,80,1116,72,69,11,1.851851851851852,49.53
974,744,52,672,529,38,14,3.125,38.49
975,394740,552,0,3194,300,252,1.4492753623188406,0.0
976,170964,368,0,30624,192,176,3.225806451612903,0.0
977,36,31,0,11,29,2,3.225806451612903,2.0
978,9072,26,9072,3843,23,3,4.545454545454546,27.86
979,48,2,48,0,2,0,25.0,61.24
980,1872,15,0,1264,12,3,14.285714285714286,0.0
981,273480,183,0,6059,85,98,5.0,0.0
982,108,5,108,16,3,2,50.0,90.93
983,3324,40,0,2215,38,2,2.5641025641025643,0.0
984,346092,7,346092,1080,6,1,14.285714285714286,93.63
985,147228,14,0,12261,11,3,100.0,0.0
986,156,3,156,24,2,1,33.333333333333336,60.22
987,108,10,108,15,9,1,10.0,51.91
988,456,22,456,145,13,9,16.666666666666668,20.31
989,108,28,108,18,20,8,7.142857142857143,15.3
990,2508,19,732,298,14,5,9.090909090909092,44.35
991,81504,187,0,1772,149,38,100.0,0.0
992,360,32,360,160,32,0,3.0303030303030303,47.58
993,300,11,300,60,7,4,33.333333333333336,0.0
994,36,1,36,0,1,0,50.0,91.02
995,624,3,624,180,2,1,33.333333333333336,90.93
996,133572,4,133572,1419,3,1,25.0,0.0
997,48,20,48,8,16,4,7.142857142857143,16.11
998,120,2,120,36,2,0,25.0,92.21
999,7392,1,7392,228,1,0,50.0,97.5
1000,210432,154,0,10068,75,79,5.0,0.0
1001,7692,11,6180,1896,10,1,9.090909090909092,0.0
1002,509544,320,0,3461,170,150,2.4390243902439024,2.0
1003,243828,337,0,5601,168,169,2.7777777777777777,3.0
1004,0,0,0,0,0,0,33.333333333333336,2.0
1005,192,0,192,0,0,0,50.0,98.05
1006,120,0,120,0,0,0,50.0,64.0
1007,120,19,120,12,14,5,9.090909090909092,57.26
1008,211440,320,0,3427,167,153,2.631578947368421,0.0
1009,3324,4,3324,1740,3,1,33.333333333333336,96.41
1010,180,5,108,64,4,1,20.0,21.73
1011,1032,23,96,67,13,10,25.0,19.44
1012,516204,1717,0,192378,1058,659,1.0,0.0
1013,372,6,372,4,6,0,12.5,0.0
1014,984,53,984,312,30,23,5.0,44.09
1015,4032,13,4032,122,9,4,14.285714285714286,62.75
1016,49032,53,49032,3902,44,9,2.2222222222222223,48.49
1017,108,5,108,26,3,2,33.333333333333336,76.57
1018,517884,6557,0,71339,3678,2879,1.0,0.4
1019,168,10,168,13,9,1,10.0,53.47
1020,397692,356,0,5104,184,172,3.703703703703704,0.0
1021,72,1,72,0,1,0,50.0,80.21
1022,518460,1113,0,164558,589,524,1.0,2.1
1023,150828,161,0,1328,82,79,4.166666666666667,5.0
1024,75972,147,0,4184,62,85,3.571428571428572,3.0
1025,408,104,408,135,100,4,1.25,32.68
1026,74952,77,0,18431,55,22,100.0,0.0
1027,4488,203,0,981,154,49,100.0,0.0
1028,319632,480,0,3098,246,234,2.380952380952381,0.0
1029,518112,15531,78438,73665,9000,6531,1.0,0.0
1030,404100,602,0,5618,334,268,1.1494252873563218,0.0
1031,156,15,156,25,15,0,5.882352941176471,52.74
1032,1200,7,1104,294,5,2,16.666666666666668,42.09
1033,264,67,264,71,51,16,2.2222222222222223,45.3
1034,246984,230,0,3012,100,130,4.0,0.0
1035,420,36,420,161,14,22,20.0,93.68
1036,85848,225,0,2455,101,124,3.225806451612903,6.59
1037,2184,8,876,501,5,3,20.0,25.65
1038,1308,0,1308,0,0,0,100.0,100.0
1039,423168,723,0,6894,393,330,1.4492753623188406,2.0
1040,522084,564,0,114303,275,289,1.2987012987012987,0.0
1041,424068,717,0,5874,382,335,1.5384615384615383,3.0
1042,229776,185,0,6968,79,106,3.8461538461538463,0.0
1043,234468,342,0,2606,173,169,2.5,0.0
1044,298032,84,0,10678,36,48,12.5,0.0
1045,72,19,72,8,19,0,5.0,49.78
1046,108,16,108,13,12,4,10.0,51.88
1047,518124,3399,0,17846,1844,1555,1.0,0.0
1048,348,3,348,172,3,0,20.0,56.55
1049,50724,164,0,2716,66,98,6.666666666666667,0.0
1050,6564,211,6564,1482,101,110,1.4492753623188406,0.0
1051,1488,9,1488,154,7,2,16.666666666666668,96.13
1052,157656,20,0,29962,17,3,25.0,0.0
1053,487680,244,0,8392,144,100,2.7777777777777777,1.15
1054,37668,49,0,1553,37,12,50.0,0.0
1055,322788,484,0,6858,282,202,1.4492753623188406,0.0
1056,4032,4,4032,513,4,0,25.0,57.24
1057,60,29,0,17,21,8,5.0,2.0
1058,51036,36,0,3459,30,6,100.0,0.0
1059,372,2,372,150,1,1,50.0,68.33
1060,2160,58,360,110,32,26,5.0,14.18
1061,2040,58,2040,1316,44,14,2.5641025641025643,30.68
1062,443772,146,75192,35862,76,70,5.2631578947368425,0.0
1063,60840,44,0,3844,42,2,50.0,0.0
1064,2316,62,0,746,50,12,100.0,0.0
1065,10308,122,0,801,63,59,100.0,0.0
1066,528480,45,0,100744,33,12,3.125,0.0
1067,2424,62,2424,1320,49,13,2.631578947368421,70.54
1068,70836,17,70836,9,12,5,11.11111111111111,66.35
1069,25140,186,0,1648,125,61,1.818181818181818,0.0
1070,11304,18,11304,427,17,1,5.555555555555555,84.8
1071,852,47,852,78,46,1,2.083333333333333,54.78
1072,684,27,684,14,23,4,4.3478260869565215,57.08
1073,492,7,492,84,7,0,11.11111111111111,63.62
1074,2976,30,0,1438,14,16,25.0,30.57
1075,2400,100,0,743,72,28,100.0,100.0
1076,62064,50,0,10926,37,13,100.0,0.0
1077,960,0,960,0,0,0,100.0,100.0
1078,372,41,372,43,34,7,3.571428571428572,23.93
1079,1944,2,1716,1056,1,1,100.0,100.0
1080,960,0,960,0,0,0,50.0,80.0
1081,8736,15,8736,2008,14,1,12.5,93.53
1082,34632,7,34632,773,7,0,25.0,94.41
1083,50760,32,50760,1141,26,6,7.142857142857143,71.02
1084,276,7,276,123,7,0,16.666666666666668,90.34
1085,756,2,756,18,1,1,100.0,100.0
1086,1056,44,1056,16,36,8,2.9411764705882355,45.76
1087,449364,34,449364,102360,34,0,4.3478260869565215,52.49
1088,381648,282,0,10250,144,138,3.4482758620689653,4.0
1089,15480,24,15480,9093,13,11,3.333333333333333,81.09
1090,79536,45,79536,2727,44,1,3.571428571428572,10.07
1091,401580,616,0,10842,344,272,1.3888888888888888,0.0
1092,6984,183,0,1212,103,80,100.0,0.0
1093,852,73,852,117,63,10,1.694915254237288,42.79
1094,50808,52,0,1790,41,11,50.0,0.0
1095,195252,412,0,2707,203,209,3.225806451612903,0.0
1096,51396,47,0,2556,38,9,50.0,0.0
1097,276,39,276,19,25,14,7.6923076923076925,63.35
1098,1560,9,1560,457,9,0,16.666666666666668,93.97
1099,1392,21,1392,172,18,3,7.6923076923076925,63.42
1100,51780,49,0,1881,39,10,50.0,0.0
1101,14760,42,0,2273,27,15,100.0,0.0
1102,15372,256,15372,6868,254,2,1.0,16.31
1103,108,0,108,0,0,0,50.0,80.0
1104,3336,28,528,291,27,1,3.4482758620689653,55.07
1105,45912,37,45912,1260,32,5,3.8461538461538463,62.58
1106,24132,13,24132,216,8,5,20.0,56.32
1107,1980,13,108,185,7,6,25.0,58.46
1108,984,0,984,0,0,0,100.0,100.0
1109,2052,241,0,497,96,145,4.761904761904762,0.0
1110,54612,8,54612,20962,7,1,11.11111111111111,78.81
1111,13728,28,0,914,22,6,100.0,0.0
1112,282624,20,231276,152928,9,11,33.333333333333336,23.53
1113,324,10,324,99,6,4,33.333333333333336,94.61
1114,624,24,624,198,20,4,8.333333333333334,52.02
1115,11256,22,11256,509,19,3,5.882352941176471,87.01
1116,31140,13,31140,573,12,1,9.090909090909092,18.6
1117,115344,83,0,4977,76,7,20.0,0.0
1118,12300,9,11388,6617,5,4,20.0,0.0
1119,3300,223,0,995,133,90,100.0,0.0
1120,9252,9,9252,385,9,0,16.666666666666668,96.28
1121,372,55,372,26,37,18,3.333333333333333,54.29
1122,398388,816,0,14441,462,354,1.4492753623188406,1.5
1123,672,10,672,274,9,1,12.5,96.74
1124,768,2,768,396,2,0,33.333333333333336,95.6
1125,420,21,420,137,19,2,6.25,48.37
1126,1800,9,0,437,6,3,100.0,0.0
1127,1860,25,1860,24,24,1,4.0,35.82
1128,384,8,384,180,8,0,12.5,96.86
1129,46092,46,0,3473,38,8,50.0,0.0
1130,84,0,84,0,0,0,50.0,60.84
1131,1104,4,1104,303,4,0,16.666666666666668,73.33
1132,744,0,744,0,0,0,100.0,100.0
1133,540228,2064,0,146927,1177,887,1.0,0.0
1134,16608,196,0,1112,121,75,1.8867924528301887,0.0
1135,98904,89,89316,9607,80,9,1.5625,6.72
1136,2784,4,0,993,1,3,33.333333333333336,0.0
1137,60,3,0,32,2,1,25.0,0.09
1138,4272,232,0,1488,141,91,100.0,0.0
1139,1908,70,0,1149,33,37,8.333333333333334,0.0
1140,8808,165,0,944,74,91,5.555555555555555,2.0
1141,132,0,132,0,0,0,50.0,60.84
1142,32892,33,32892,32666,29,4,3.4482758620689653,53.81
1143,3372,3,3372,232,2,1,50.0,97.11
1144,7152,18,7152,364,15,3,7.142857142857143,88.75
1145,120432,56,0,5112,43,13,50.0,0.0
1146,8268,19,0,732,17,2,100.0,0.0
1147,169416,15,169416,19762,15,0,5.882352941176471,45.36
1148,204,34,204,6,34,0,2.7777777777777777,53.51
1149,10836,162,10836,1665,161,1,1.408450704225352,29.87
1150,4368,9,4368,1144,6,3,100.0,100.0
1151,11988,44,0,1047,34,10,50.0,0.0
1152,12444,47,0,982,37,10,50.0,0.0
1153,12000,40,0,1396,26,14,100.0,0.0
1154,12900,48,0,1011,37,11,50.0,0.0
1155,13440,52,0,996,41,11,50.0,0.0
1156,429324,530,0,4101,299,231,2.631578947368421,0.0
1157,300,8,300,21,4,4,25.0,75.58
1158,375132,945,0,8171,504,441,1.818181818181818,5.94
1159,155484,260,0,37386,147,113,6.25,0.0
1160,80856,101,0,2089,54,47,5.555555555555555,0.0
1161,396,0,396,0,0,0,50.0,60.1
1162,336,17,336,225,13,4,8.333333333333334,61.9
1163,228,2,228,78,2,0,33.333333333333336,25.83
1164,10488,132,5784,1810,129,3,1.351351351351351,39.18
1165,52344,28,52344,533,24,4,5.0,87.35
1166,240,8,240,27,8,0,10.0,18.38
1167,144660,356,0,3462,184,172,2.2222222222222223,0.0
1168,132,4,132,42,2,2,50.0,58.06
1169,1488,24,1488,572,20,4,6.666666666666667,81.76
1170,420,26,420,162,26,0,4.0,29.16
1171,9312,137,0,1642,96,41,100.0,0.0
1172,371004,823,0,7432,449,374,2.272727272727273,0.0
1173,426852,1024,0,4039,569,455,1.3333333333333333,0.0
1174,523884,930,0,3359,626,304,1.0,0.0
1175,16284,27,6840,1633,23,4,100.0,0.0
1176,54552,19,54552,205,17,2,6.666666666666667,74.58
1177,6828,48,0,1027,39,9,50.0,0.0
1178,348432,178,0,9015,108,70,16.666666666666668,0.0
1179,876,108,876,341,57,51,6.666666666666667,86.78
1180,323292,60,0,34087,44,16,16.666666666666668,0.0
1181,408,4,408,276,2,2,33.333333333333336,84.8
1182,15576,44,0,1839,37,7,100.0,0.0
1183,5016,114,0,1546,87,27,100.0,100.0
1184,636,6,636,266,5,1,20.0,86.13
1185,566592,10982,0,271801,6764,4218,1.0,0.0
1186,780,51,780,200,47,4,2.631578947368421,58.28
1187,1296,18,1296,111,15,3,12.5,73.43
1188,6096,57,6096,4233,56,1,3.0303030303030303,53.95
1189,101412,112,58914,5859,100,12,1.162790697674419,5.38
1190,528540,2799,0,31494,1572,1227,1.0,0.0
1191,12036,39,0,1306,24,15,100.0,0.0
1192,1632,46,0,451,39,7,100.0,100.0
1193,150408,4,0,150111,3,1,11.11111111111111,60.08
1194,53292,12,53292,718,11,1,11.11111111111111,16.66
1195,75960,176,0,35852,90,86,5.555555555555555,0.0
1196,430260,1150,0,19284,730,420,1.0,0.0
1197,588,63,588,181,42,21,3.0303030303030303,8.13
1198,30216,3,30216,2304,2,1,50.0,59.56
1199,12324,49,0,1056,37,12,50.0,0.0
1200,564,7,564,94,7,0,11.11111111111111,57.77
1201,562560,2033,0,56500,1077,956,1.0,0.0
1202,5508,26,5508,393,21,5,8.333333333333334,71.11
1203,24576,45,0,1939,44,1,50.0,0.0
1204,13500,46,0,1068,35,11,50.0,0.0
1205,2304,84,0,795,65,19,100.0,100.0
1206,420,30,420,222,26,4,3.8461538461538463,43.4
1207,57132,17,57132,673,14,3,12.5,15.21
1208,192,2,192,96,1,1,50.0,69.3
1209,132,0,132,0,0,0,100.0,100.0
1210,3948,116,3948,854,83,33,1.639344262295082,63.32
1211,60,14,60,6,12,2,8.333333333333334,63.82
1212,573588,13364,0,179714,7800,5564,1.0,0.0
1213,84660,40,84660,1376,34,6,5.0,99.45
1214,912,0,912,0,0,0,50.0,77.0
1215,336,21,336,19,21,0,4.545454545454546,39.81
1216,60,28,48,9,23,5,4.761904761904762,12.7
1217,366564,442,0,10476,220,222,2.3255813953488373,3.0
1218,111468,6,0,33216,6,0,12.5,50.0
1219,456,23,312,128,21,2,5.2631578947368425,56.71
1220,27900,18,27900,4839,15,3,9.090909090909092,71.76
1221,402420,645,0,83664,319,326,1.36986301369863,5.0
1222,2988,16,2988,153,14,2,8.333333333333334,66.9
1223,435600,13,0,45062,9,4,7.6923076923076925,4.0
1224,12432,454,0,3297,295,159,1.0,0.0
1225,516,35,516,209,35,0,2.7777777777777777,68.66
1226,387756,8,387756,2514,4,4,25.0,98.11
1227,540,16,540,176,16,0,5.555555555555555,55.11
1228,1176,5,1176,127,5,0,16.666666666666668,61.56
1229,82536,46,0,2457,40,6,25.0,0.0
1230,852,28,840,168,22,6,5.882352941176471,62.98
1231,3672,18,3672,971,16,2,6.666666666666667,90.0
1232,578976,3647,0,272028,2137,1510,1.0,0.0
1233,289644,287,0,18202,147,140,4.545454545454546,0.0
1234,660,56,660,352,40,16,2.9411764705882355,57.99
1235,948,46,948,644,42,4,2.380952380952381,22.19
1236,948,4,948,360,2,2,50.0,98.3
1237,12000,46,0,1405,31,15,100.0,0.0
1238,1068,3,1068,0,3,0,20.0,63.99
1239,2064,59,624,194,45,14,3.333333333333333,40.85
1240,535068,89,315251,282588,87,2,10.0,99.8
1241,912,109,528,178,54,55,3.8461538461538463,75.28
1242,129024,7,1248,36922,4,3,14.285714285714286,45.29
1243,6120,30,6120,940,26,4,7.142857142857143,99.41
1244,144,28,144,37,21,7,6.25,67.12
1245,7560,29,7560,9,23,6,4.166666666666667,39.75
1246,5436,77,0,710,51,26,100.0,0.0
1247,154020,252,0,1403,117,135,4.166666666666667,4.0
1248,432,104,432,136,103,1,1.098901098901099,29.08
1249,440460,1698,0,24098,961,737,1.0,0.0
1250,42732,66,42732,2274,49,17,1.96078431372549,51.25
1251,499536,599,0,198922,428,171,1.0,0.0
1252,102156,170,0,7400,68,102,5.0,0.0
1253,247368,13,247368,26,11,2,9.090909090909092,60.09
1254,244848,1306,0,112825,901,405,1.0,0.0
1255,156,0,156,0,0,0,50.0,51.55
1256,63732,191,0,1073,90,101,6.25,0.0
1257,168,39,156,53,35,4,2.9411764705882355,32.59
1258,19152,109,0,724,68,41,2.2222222222222223,0.0
1259,61872,99,0,1772,39,60,10.0,4.75
1260,3204,0,3204,0,0,0,100.0,100.0
1261,144,23,144,8,23,0,4.0,31.51
1262,156,1,156,36,1,0,33.333333333333336,74.0
1263,84,8,84,7,7,1,12.5,21.27
1264,491352,768,0,5175,441,327,1.0,0.0
1265,283572,433,0,7617,225,208,2.2222222222222223,0.0
1266,96,20,96,12,17,3,6.25,15.44
1267,444,1,444,12,1,0,33.333333333333336,78.6
1268,584808,13650,60996,81271,7953,5697,1.0,0.0
1269,120,17,108,31,13,4,7.6923076923076925,2.0
1270,216,2,216,18,1,1,100.0,100.0
1271,25500,101,0,1233,64,37,100.0,0.0
1272,504,40,504,177,39,1,2.5,62.52
1273,48,40,48,12,40,0,2.4390243902439024,24.77
1274,310980,791,0,10104,446,345,1.162790697674419,0.0
1275,960,84,960,617,52,32,5.882352941176471,80.96
1276,792,4,792,297,3,1,33.333333333333336,99.01
1277,240,0,240,0,0,0,50.0,59.2
1278,208236,36,208236,1215,28,8,4.3478260869565215,35.68
1279,196896,192,0,2890,90,102,3.571428571428572,0.0
1280,3912,207,0,1170,145,62,100.0,0.0
1281,600,3,0,448,3,0,33.333333333333336,99.0
1282,132,8,132,69,6,2,20.0,21.71
1283,492,38,492,120,32,6,3.225806451612903,61.34
1284,1116,0,1116,0,0,0,100.0,100.0
1285,828,34,756,133,31,3,4.166666666666667,48.05
1286,144,1,0,144,1,0,50.0,0.09
1287,4116,193,0,1366,119,74,100.0,0.0
1288,4380,23,1092,524,12,11,12.5,59.09
1289,65124,16,1680,9261,15,1,8.333333333333334,0.0
1290,1128,3,0,828,2,1,100.0,100.0
1291,108,45,108,33,28,17,5.882352941176471,14.22
1292,106320,22,106320,3875,19,3,6.25,63.52
1293,2088,0,2088,0,0,0,50.0,95.0
1294,78396,23,78396,3600,12,11,33.333333333333336,68.39
1295,156,1,156,12,1,0,100.0,99.02
1296,576,1,576,336,1,0,100.0,0.18
1297,590340,819,0,21949,453,366,1.5384615384615383,0.0
1298,2724,53,2724,762,33,20,3.703703703703704,57.62
1299,456,10,456,139,6,4,20.0,89.56
1300,480,118,480,189,70,48,3.8461538461538463,84.14
1301,235740,359,0,1046,232,127,1.0,0.0
1302,300,21,300,42,18,3,5.882352941176471,29.64
1303,103104,24,0,5282,22,2,3.571428571428572,0.0
1304,24636,3,0,22364,2,1,25.0,0.24
1305,2712,37,2712,723,37,0,2.5641025641025643,65.91
1306,924,66,924,420,41,25,3.125,54.88
1307,1020,7,1020,843,5,2,16.666666666666668,94.05
1308,19656,12,19656,132,10,2,9.090909090909092,83.28
1309,597660,3752,0,194445,2046,1706,1.0,0.0
1310,2640,67,2640,184,63,4,1.6666666666666667,39.87
1311,72,17,72,11,11,6,14.285714285714286,20.89
1312,571308,295,0,6242,151,144,2.631578947368421,0.0
1313,1056,6,1056,826,4,2,12.5,5.0
1314,597516,625,0,78035,324,301,1.0,1.62
1315,446148,38,18708,149815,37,1,3.0303030303030303,76.35
1316,10812,20,10812,1721,20,0,12.5,50.87
1317,8028,5,8028,2364,5,0,14.285714285714286,82.18
1318,162060,5,162060,2042,5,0,14.285714285714286,75.27
1319,2184,18,1530,1234,13,5,50.0,99.99
1320,228,2,228,156,1,1,50.0,89.04
1321,577452,7,320508,1980,7,0,11.11111111111111,63.19
1322,60,3,60,0,3,0,20.0,74.01
1323,109956,414,0,2009,270,144,1.0,0.0
1324,840,3,840,24,1,2,50.0,99.9
1325,5520,16,5520,1677,10,6,12.5,76.04
1326,228,11,228,41,6,5,33.333333333333336,73.96
1327,6372,0,6372,0,0,0,100.0,100.0
1328,9840,110,9840,64,68,42,2.0408163265306123,17.35
1329,2220,341,0,55,175,166,100.0,0.0
1330,108,6,108,48,3,3,50.0,77.84
1331,164052,0,164052,0,0,0,100.0,100.0
1332,12468,7,6324,3377,6,1,14.285714285714286,0.0
1333,384,2,384,18,2,0,25.0,68.61
1334,384,47,384,87,31,16,4.0,38.27
1335,426372,357,175812,210837,205,152,1.5151515151515151,0.0
1336,192,1,192,60,1,0,33.333333333333336,83.0
1337,252,1,252,132,1,0,50.0,99.26
1338,260232,537,0,40148,310,227,1.0,4.0
1339,108,19,108,44,10,9,33.333333333333336,58.53
1340,555060,1786,0,14236,983,803,1.0,0.0
1341,14856,75,2892,782,35,40,6.25,82.2
1342,540,35,0,133,24,11,100.0,0.0
1343,511404,1464,0,97337,799,665,1.0,0.0
1344,2844,7,2844,678,7,0,11.11111111111111,17.23
1345,1596,11,1596,494,11,0,10.0,63.91
1346,538248,165,153204,112930,165,0,1.098901098901099,68.94
1347,133716,258,0,1539,136,122,2.3255813953488373,0.0
1348,313272,137,0,6746,69,68,5.882352941176471,0.0
1349,480,38,480,100,29,9,4.545454545454546,44.47
1350,228,9,228,70,7,2,12.5,62.29
1351,1224,116,0,116,99,17,100.0,0.0
1352,4896,0,4896,0,0,0,100.0,41.2
1353,84,0,84,0,0,0,50.0,75.0
1354,40548,142,4728,1047,127,15,1.0,21.53
1355,6312,3,0,4232,2,1,100.0,100.0
1356,192,33,192,147,17,16,11.11111111111111,87.22
1357,456336,1171,0,7702,665,506,1.1363636363636365,2.0
1358,636,1,636,612,1,0,50.0,99.92
1359,7368,5,7368,254,3,2,100.0,100.0
1360,23772,3,23772,76,2,1,50.0,99.64
1361,37560,2,37560,2586,2,0,50.0,99.89
1362,62892,15,0,5407,14,1,50.0,0.0
1363,605628,2655,0,56619,1459,1196,1.0,0.59
1364,25656,164,0,440,94,70,2.083333333333333,0.0
1365,564,47,564,29,45,2,2.5641025641025643,60.9
1366,566784,217,0,33580,130,87,2.9411764705882355,2.0
1367,2064,0,2064,0,0,0,100.0,100.0
1368,149736,207,0,11391,111,96,3.125,0.0
1369,182904,17,0,23721,16,1,50.0,0.0
1370,336,21,336,34,15,6,9.090909090909092,68.17
1371,583848,795,0,42016,399,396,1.1111111111111112,0.0
1372,602328,2330,0,11029,1361,969,1.0,0.0
1373,312,56,312,115,54,2,1.9230769230769231,23.99
1374,2856,19,2856,585,16,3,6.25,76.02
1375,28920,186,0,805,120,66,100.0,0.0
1376,1320,43,1320,606,43,0,2.2222222222222223,68.66
1377,16596,3,16596,16476,3,0,14.285714285714286,71.98
1378,120,20,84,30,13,7,10.0,19.9
1379,0,0,0,0,0,0,100.0,0.0
1380,456,11,456,116,11,0,7.6923076923076925,36.78
1381,4044,222,0,292,151,71,1.0,0.0
1382,144,40,144,40,32,8,3.571428571428572,50.99
1383,37956,40,0,3951,26,14,100.0,0.0
1384,144,8,144,27,4,4,50.0,73.74
1385,72,2,60,36,1,1,33.333333333333336,62.48
1386,156,30,156,16,27,3,3.8461538461538463,32.07
1387,300,32,300,23,27,5,4.0,31.04
1388,71364,73,71364,3021,58,15,1.7241379310344829,42.55
1389,15840,64,1476,345,56,8,1.818181818181818,31.3
1390,828,4,828,39,3,1,25.0,74.27
1391,48216,76,0,1905,59,17,100.0,100.0
1392,46524,47,0,1750,34,13,50.0,0.0
1393,488136,195,0,4213,96,99,4.166666666666667,5.0
1394,46884,50,0,1720,38,12,50.0,0.0
1395,7572,75,0,773,42,33,100.0,0.0
1396,52536,76,52536,2132,69,7,1.694915254237288,9.82
1397,410796,4,410796,180438,4,0,16.666666666666668,0.0
1398,5028,6,1152,2114,4,2,20.0,0.0
1399,55272,45,0,3015,38,7,100.0,0.0
1400,609756,1517,0,15415,821,696,1.0,0.0
1401,75216,11,75216,3868,11,0,20.0,92.26
1402,53304,7,53304,4808,7,0,11.11111111111111,86.2
1403,24228,21,24228,563,19,2,5.555555555555555,85.58
1404,317700,23,0,41936,18,5,25.0,0.0
1405,76332,14,76332,7208,12,2,14.285714285714286,95.91
1406,384,9,384,177,9,0,14.285714285714286,94.14
1407,7824,2,7824,438,1,1,100.0,100.0
1408,288,9,288,157,9,0,11.11111111111111,90.27
1409,548568,54,0,12205,44,10,20.0,0.0
1410,13356,12,13356,256,11,1,9.090909090909092,78.3
1411,53844,49,0,2023,38,11,50.0,0.0
1412,1608,1,1608,492,1,0,33.333333333333336,99.86
1413,420,3,420,268,1,2,50.0,59.93
1414,342204,72,342204,1627,61,11,1.7543859649122806,0.61
1415,804,4,804,18,2,2,50.0,61.21
1416,312,4,312,78,3,1,25.0,99.72
1417,2868,20,2868,402,16,4,8.333333333333334,63.19
1418,30120,5,30120,30036,5,0,14.285714285714286,90.54
1419,1092,4,1092,252,4,0,20.0,60.61
1420,156588,308,0,4236,160,148,6.666666666666667,0.0
1421,888,7,888,228,4,3,33.333333333333336,98.56
1422,227292,56,0,16864,47,9,33.333333333333336,0.0
1423,240,3,240,76,3,0,20.0,22.07
1424,1296,29,1296,335,13,16,11.11111111111111,74.74
1425,85644,54,0,4633,44,10,50.0,0.0
1426,86568,37,0,4638,34,3,50.0,0.0
1427,8880,909,0,3772,560,349,1.0,0.0
1428,11544,161,0,1084,100,61,100.0,0.0
1429,47808,16,47808,912,16,0,8.333333333333334,99.44
1430,1092,4,1092,3,4,0,16.666666666666668,56.11
1431,11568,20,11568,3455,16,4,12.5,89.36
1432,16968,49,0,1789,34,15,100.0,0.0
1433,564,18,564,160,14,4,11.11111111111111,16.59
1434,420,1,420,60,1,0,25.0,62.29
1435,216,43,216,10,39,4,2.5641025641025643,44.85
1436,6780,24,6780,166,21,3,4.761904761904762,59.14
1437,4200,205,0,1357,118,87,1.851851851851852,0.0
1438,23928,27,23928,410,22,5,6.25,67.05
1439,75312,100,42870,6267,90,10,1.25,7.22
1440,2508,1,2508,2292,1,0,33.333333333333336,94.05
1441,420,46,420,146,25,21,16.666666666666668,97.92
1442,83772,20,83772,1284,16,4,10.0,17.67
1443,14664,18,14664,953,16,2,6.25,86.08
1444,744,43,744,17,43,0,2.7777777777777777,63.75
1445,4260,166,0,693,103,63,100.0,0.0
1446,584184,2973,0,11039,1620,1353,1.0,0.0
1447,564,68,468,246,47,21,3.571428571428572,27.14
1448,264,61,264,132,37,24,3.703703703703704,50.69
1449,5040,19,5040,388,16,3,7.142857142857143,89.19
1450,13164,50,0,1130,38,12,50.0,0.0
1451,13608,46,0,1147,35,11,50.0,0.0
1452,95484,35,96,2767,21,14,10.0,71.56
1453,5196,313,5196,2074,137,176,3.0303030303030303,72.69
1454,13944,45,0,1153,37,8,50.0,0.0
1455,14352,52,0,1214,40,12,50.0,0.0
1456,4392,47,0,1589,41,6,3.8461538461538463,0.0
1457,645384,6418,0,145803,3599,2819,1.0,0.0
1458,204,37,204,124,25,12,4.761904761904762,63.86
1459,7548,32,7548,702,27,5,5.0,58.16
1460,154668,19,154668,1070,17,2,6.25,39.16
1461,104028,86,0,9447,73,13,33.333333333333336,0.0
1462,146040,63,146040,4472,53,10,6.666666666666667,26.19
1463,228,17,228,38,17,0,5.2631578947368425,32.47
1464,444948,496,0,7401,272,224,2.9411764705882355,0.0
1465,84,30,72,30,19,11,10.0,42.56
1466,134160,23,108,5865,19,4,5.882352941176471,16.68
1467,636036,63,0,85622,51,12,50.0,0.0
1468,744,83,744,574,59,24,2.127659574468085,58.24
1469,397824,17,92208,93929,13,4,12.5,26.79
1470,386064,1217,386064,54144,927,290,1.0,7.59
1471,156,19,156,22,15,4,7.6923076923076925,52.38
1472,10824,101,10824,744,47,54,16.666666666666668,98.18
1473,26664,44,0,3016,36,8,100.0,0.0
1474,492,21,492,161,16,5,7.6923076923076925,79.9
1475,948,0,948,0,0,0,50.0,57.76
1476,3132,21,3132,137,19,2,5.0,33.53
1477,996,1,996,0,1,0,33.333333333333336,76.25
1478,11820,48,0,1244,32,16,100.0,0.0
1479,7404,46,0,1032,40,6,50.0,0.0
1480,1416,93,1416,303,46,47,11.11111111111111,92.13
1481,144,58,144,64,36,22,4.0,65.76
1482,5712,25,0,1100,22,3,100.0,0.0
1483,8196,48,0,835,38,10,50.0,0.0
1484,506124,1867,0,7189,1005,862,1.0,5.5
1485,348,1,348,72,1,0,33.333333333333336,73.5
1486,638160,1412,0,41774,796,616,1.0,0.0
1487,616896,3486,0,45416,2017,1469,1.0,3.91
1488,36,6,36,0,6,0,14.285714285714286,75.1
1489,70188,50,0,5097,40,10,20.0,0.0
1490,420,27,420,153,14,13,12.5,67.64
1491,608700,16,608700,71853,15,1,6.25,40.94
1492,9768,48,0,1049,42,6,50.0,0.0
1493,31836,93,25710,3125,82,11,1.3888888888888888,7.99
1494,2040,50,0,662,41,9,100.0,100.0
1495,9132,16,0,3717,13,3,100.0,0.0
1496,12648,6,12648,0,6,0,12.5,67.04
1497,348,1,0,348,1,0,33.333333333333336,2.0
1498,144,70,144,21,46,24,2.7777777777777777,52.66
1499,204,9,204,40,7,2,14.285714285714286,56.54
1500,46224,30,0,4831,26,4,50.0,0.0
1501,384,12,384,214,8,4,16.666666666666668,67.07
1502,264,160,264,77,90,70,1.8867924528301887,56.07
1503,646992,186,708,22696,95,91,3.703703703703704,78.94
1504,168,13,168,57,11,2,8.333333333333334,80.34
1505,2544,97,0,919,67,30,100.0,100.0
1506,192,6,192,14,5,1,16.666666666666668,52.9
1507,1392,1,1392,1044,1,0,50.0,99.37
1508,2940,2,2940,126,1,1,50.0,74.78
1509,657228,653,0,204624,378,275,1.0638297872340423,0.0
1510,421008,51,0,92980,44,7,20.0,0.0
1511,101844,395,0,5439,263,132,4.166666666666667,0.0
1512,509724,524,0,6412,279,245,1.851851851851852,2.0
1513,614892,596,0,7177,319,277,1.6666666666666667,0.0
1514,108,4,108,12,2,2,50.0,98.2
1515,85176,171,2496,607,107,64,2.0408163265306123,81.36
1516,612576,1969,0,17099,973,996,1.0,0.0
1517,652740,289,0,173073,175,114,1.0,5.12
1518,300,15,228,161,15,0,6.25,61.7
1519,11520,45,0,4189,30,15,100.0,0.0
1520,228,80,228,68,30,50,14.285714285714286,89.24
1521,1716,136,1716,558,66,70,4.166666666666667,69.71
1522,612540,1912,0,35740,1242,670,1.0,0.1
1523,324,2,0,312,2,0,25.0,10.86
1524,100992,184,0,4264,101,83,5.0,0.0
1525,513336,854,0,6369,461,393,2.380952380952381,0.0
1526,29592,26,29592,799,22,4,100.0,0.0
1527,564,44,564,54,34,10,3.225806451612903,42.48
1528,276,167,252,79,127,40,1.408450704225352,30.86
1529,84,5,84,14,3,2,33.333333333333336,21.38
1530,2592,136,2214,837,98,38,2.083333333333333,3.4
1531,288,1,288,180,1,0,33.333333333333336,83.34
1532,78516,13,78516,221,9,4,11.11111111111111,70.38
1533,156,4,156,6,4,0,16.666666666666668,36.5
1534,444636,100,0,20786,56,44,4.3478260869565215,0.0
1535,34296,15,0,4559,13,2,100.0,0.0
1536,14784,41,14784,1452,35,6,3.333333333333333,50.26
1537,264540,89,0,13296,45,44,7.142857142857143,0.0
1538,638544,698,360,14157,393,305,1.3157894736842106,0.0
1539,616260,909,0,145135,550,359,1.0,5.0
1540,912,106,912,623,60,46,2.5,54.91
1541,82860,3,82860,0,3,0,20.0,21.3
1542,6624,3,6624,428,3,0,20.0,0.0
1543,176988,1357,176988,9571,788,569,1.0,77.67
1544,448020,451,0,10542,218,233,2.9411764705882355,0.0
1545,108,292,108,35,169,123,1.2195121951219512,36.13
1546,28020,174,0,2117,114,60,100.0,0.0
1547,50256,14,50256,366,12,2,11.11111111111111,53.72
1548,636,0,636,0,0,0,100.0,100.0
1549,144,55,144,94,25,30,8.333333333333334,75.57
1550,663024,14480,141256,145599,8660,5820,1.0,0.0
1551,671820,10437,0,144390,5841,4596,1.0,2.14
1552,54612,10,54612,356,9,1,10.0,71.34
1553,168,11,168,16,10,1,8.333333333333334,56.32
1554,97248,178,0,9142,87,91,3.8461538461538463,0.0
1555,960,19,960,130,7,12,25.0,15.0
1556,396,120,396,190,94,26,1.2345679012345678,29.74
1557,667500,69,0,159392,50,19,33.333333333333336,0.0
1558,3588,5,3588,321,5,0,20.0,0.0
1559,348,1,348,108,1,0,100.0,95.05
1560,46908,12,46908,1294,12,0,7.142857142857143,45.44
1561,684,193,480,134,142,51,1.098901098901099,29.85
1562,708,4,708,504,4,0,16.666666666666668,0.0
1563,40500,24,40500,1416,21,3,7.142857142857143,99.44
1564,453432,622,0,16088,249,373,2.857142857142857,0.0
1565,548964,510,0,6931,288,222,1.5151515151515151,0.0
1566,77868,0,77868,0,0,0,100.0,100.0
1567,677508,16120,246022,256894,9177,6943,1.0,4.46
1568,85632,27,85632,1484,27,0,3.4482758620689653,56.69
1569,45108,97,45108,43192,85,12,1.2345679012345678,45.4
1570,489864,538,0,89292,245,293,1.6666666666666667,0.0
1571,264540,83,0,3432,72,11,1.639344262295082,15.36
1572,288,14,288,11,14,0,5.882352941176471,39.79
1573,372,22,372,113,22,0,5.0,48.1
1574,72,0,72,0,0,0,50.0,57.76
1575,462996,395,0,2831,197,198,3.333333333333333,3.0
1576,4944,18,4944,4858,8,10,20.0,75.87
1577,659328,2039,0,60769,1183,856,1.0,0.0
1578,263520,216,236952,87866,192,24,1.1904761904761905,94.15
1579,55476,91,55476,1036,67,24,1.5625,23.55
1580,4188,10,4188,1278,8,2,20.0,93.58
1581,576,48,576,433,34,14,3.571428571428572,56.3
1582,68040,21,68040,809,21,0,4.166666666666667,14.75
1583,648,26,648,178,24,2,4.0,57.07
1584,600924,341,0,5858,186,155,2.2222222222222223,0.0
1585,1176,13,1176,1128,12,1,7.6923076923076925,80.06
1586,70428,11,70428,1462,11,0,9.090909090909092,52.9
1587,1068,202,996,474,127,75,1.5384615384615383,38.97
1588,13044,108,0,8309,95,13,1.0,0.0
1589,588132,608,588132,194710,536,72,1.7241379310344829,0.0
1590,610536,12,0,330035,11,1,50.0,99.98
1591,678876,2357,0,206629,1356,1001,1.0,3.69
1592,9960,137,0,1448,91,46,100.0,0.0
1593,118056,16,118056,1292,13,3,9.090909090909092,30.0
1594,673452,638,0,15663,353,285,1.4285714285714286,0.0
1595,0,0,0,0,0,0,100.0,0.0
1596,516,2,516,66,2,0,20.0,8.0
1597,40512,232,0,1332,144,88,100.0,0.0
1598,32016,51,32016,1901,46,5,10.0,20.66
1599,557136,393,0,178146,205,188,2.083333333333333,0.0
1600,240,40,240,5,38,2,2.5641025641025643,64.48
1601,0,0,0,0,0,0,100.0,0.0
1602,0,0,0,0,0,0,100.0,0.0
1603,74952,122,0,957,104,18,100.0,0.0
1604,1596,9,1596,513,9,0,9.090909090909092,66.32
1605,0,0,0,0,0,0,100.0,0.0
1606,166860,163,0,2576,82,81,4.761904761904762,0.0
1607,503472,53,0,14654,33,20,12.5,11.89
1608,336,6,60,106,5,1,16.666666666666668,55.27
1609,9636,42,9636,980,40,2,2.4390243902439024,24.9
1610,0,0,0,0,0,0,100.0,0.0
1611,96,3,96,16,3,0,20.0,21.3
1612,3792,53,0,1923,51,2,2.702702702702702,0.0
1613,600,6,600,42,6,0,12.5,30.08
1614,413172,667,0,12280,304,363,1.3333333333333333,5.5
1615,15816,81,15816,26,57,24,2.2222222222222223,16.25
1616,28536,53,0,1396,45,8,50.0,0.0
1617,71388,48,0,2056,26,22,12.5,0.0
1618,457788,286,0,6286,120,166,2.5641025641025643,0.0
1619,732,7,732,1,7,0,11.11111111111111,49.17
1620,225768,641,0,2695,427,214,1.0,0.0
1621,92940,107,92940,4543,39,68,14.285714285714286,62.11
1622,432,2,432,66,2,0,33.333333333333336,59.06
1623,1716,23,1716,9,21,2,4.545454545454546,43.32
1624,9612,170,0,3352,90,80,3.571428571428572,0.0
1625,50640,30,144,1720,28,2,3.8461538461538463,37.65
1626,40080,49,0,3163,38,11,100.0,0.0
1627,571968,77,600,9849,48,29,2.7777777777777777,0.0
1628,588,3,588,212,2,1,50.0,99.98
1629,519648,1862,0,8794,1079,783,1.0,0.0
1630,585228,11,585228,6559,10,1,9.090909090909092,77.51
1631,53472,191,0,1834,97,94,5.555555555555555,0.0
1632,112728,3,112728,7332,2,1,1.851851851851852,41.67
1633,300960,586,0,10034,313,273,1.492537313432836,0.0
1634,3792,53,3792,1521,32,21,20.0,33.17
1635,156,53,156,50,29,24,5.2631578947368425,1.06
1636,348,141,348,108,84,57,2.857142857142857,72.46
1637,4920,11,4920,566,11,0,7.6923076923076925,26.52
1638,456,261,444,251,140,121,1.0,25.86
1639,11172,84,11172,1111,57,27,1.7543859649122806,21.64
1640,0,0,0,0,0,0,100.0,0.0
1641,84,0,84,0,0,0,50.0,64.72
1642,0,0,0,0,0,0,100.0,0.0
1643,1140,10,1140,560,7,3,9.090909090909092,52.74
1644,23712,48,0,804,37,11,3.333333333333333,0.0
1645,204,2,204,78,1,1,50.0,75.16
1646,587280,783,0,170007,393,390,1.0,0.0
1647,563124,949,0,3426,493,456,1.0,0.0
1648,692940,693,0,178839,493,200,1.0,0.0
1649,174696,253,876,888,126,127,2.5641025641025643,78.01
1650,517332,39,517332,92705,39,0,100.0,100.0
1651,304032,386,0,1400,258,128,1.0,0.0
1652,74352,118,0,2536,54,64,7.6923076923076925,0.0
1653,228,2,228,0,2,0,25.0,81.94
1654,216,5,216,31,5,0,12.5,80.0
1655,336996,49,0,15495,42,7,33.333333333333336,0.0
1656,693864,1028,0,13254,553,475,1.1235955056179776,0.0
1657,696096,2409,0,91657,1366,1043,1.0,0.0
1658,473760,106,0,105942,60,46,7.142857142857143,0.0
1659,0,0,0,0,0,0,100.0,0.0
1660,37380,49,0,1733,44,5,50.0,0.0
1661,72,0,72,0,0,0,50.0,64.0
1662,8628,148,0,350,127,21,100.0,0.0
1663,63996,51,0,3848,44,7,50.0,0.0
1664,572688,298,0,4852,203,95,1.0,0.0
1665,144,19,144,32,11,8,11.11111111111111,54.75
1666,289620,267,0,3019,127,140,2.380952380952381,0.0
1667,204,53,204,59,24,29,9.090909090909092,2.0
1668,216,51,216,53,35,16,3.4482758620689653,37.45
1669,458196,343,0,24170,187,156,1.3888888888888888,0.0
1670,124932,0,124932,0,0,0,50.0,85.0
1671,204,13,204,0,13,0,6.666666666666667,43.2
1672,492,153,492,51,125,28,1.0,19.2
1673,182184,295,0,1787,199,96,1.0,0.0
1674,34836,81,34836,1915,39,42,5.555555555555555,71.28
1675,685908,9724,19632,41979,5497,4227,1.0,0.0
1676,612408,557,118492,42252,269,288,2.5,0.0
1677,8076,272,0,1260,128,144,4.545454545454546,0.0
1678,485688,71,0,10856,35,36,5.0,2.0
1679,2280,418,0,666,295,123,1.0,0.0
1680,288,30,288,48,30,0,4.545454545454546,36.0
1681,9936,154,0,1496,107,47,1.492537313432836,0.0
1682,706476,128,0,399054,108,20,3.703703703703704,0.0
1683,15564,5,15564,15468,5,0,14.285714285714286,72.0
1684,72168,52,0,7701,45,7,50.0,0.0
1685,214308,195,0,1747,94,101,3.703703703703704,5.0
1686,669672,248,323490,333250,248,0,1.694915254237288,39.78
1687,71568,7,71568,658,7,0,16.666666666666668,96.64
1688,675804,862,0,161584,461,401,1.1235955056179776,0.0
1689,10944,23,10944,471,20,3,6.25,87.76
1690,22800,9,22800,1290,7,2,12.5,0.0
1691,10656,107,0,864,64,43,100.0,0.0
1692,53256,56,53256,1937,47,9,2.5641025641025643,14.6
1693,2220,100,0,598,72,28,100.0,0.0
1694,120,14,120,17,11,3,10.0,58.56
1695,710460,1989,0,258429,951,1038,1.0,0.0
1696,1332,5,1332,580,5,0,16.666666666666668,96.18
1697,408,73,288,90,53,20,2.7777777777777777,33.48
1698,664356,1438,0,12933,784,654,1.0,0.0
1699,4512,319,0,2094,162,157,5.0,0.0
1700,590652,285,0,44791,153,132,4.0,0.0
1701,87060,4,87060,15843,4,0,16.666666666666668,82.43
1702,697536,995,536184,248717,940,55,1.0309278350515465,11.87
1703,225720,74,0,5707,35,39,12.5,0.0
1704,582828,26,71820,44026,23,3,5.0,74.95
1705,28128,114,28128,1590,85,29,1.2820512820512822,19.44
1706,0,1,0,0,1,0,33.333333333333336,69.28
1707,370704,112,211074,86134,104,8,25.0,99.83
1708,21888,1,0,21888,0,1,100.0,0.0
1709,54732,49,0,3332,46,3,50.0,0.0
1710,1728,36,0,484,30,6,33.333333333333336,0.0
1711,3828,168,0,1078,106,62,100.0,0.0
1712,85524,14,0,10197,12,2,50.0,0.0
1713,3420,8,3420,852,8,0,12.5,95.45
1714,528,38,528,120,38,0,2.5,69.27
1715,414828,1396,0,4295,840,556,1.0,0.0
1716,456,26,456,8,24,2,4.0,56.63
1717,8412,167,0,1821,106,61,1.4285714285714286,0.0
1718,7656,136,0,364,116,20,100.0,0.0
1719,39624,28,39624,778,25,3,4.3478260869565215,66.11
1720,1248,50,1248,9,40,10,2.702702702702702,12.86
1721,12012,40,0,1264,25,15,100.0,0.0
1722,28812,60,0,2094,55,5,50.0,0.0
1723,34272,10,34272,32640,6,4,16.666666666666668,78.67
1724,9516,18,9288,1221,15,3,7.142857142857143,86.92
1725,6252,9,0,2072,7,2,14.285714285714286,0.0
1726,31572,264,0,3051,133,131,4.3478260869565215,0.48
1727,840,133,840,146,98,35,1.2820512820512822,61.77
1728,684576,309,109410,193158,284,25,100.0,100.0
1729,394860,137,0,5926,105,32,100.0,0.0
1730,192,24,192,29,18,6,7.142857142857143,15.17
1731,218460,16,111138,37854,10,6,20.0,0.0
1732,2412,115,2256,1109,58,57,2.9411764705882355,48.8
1733,126024,43,126024,2757,27,16,8.333333333333334,88.37
1734,607608,194,0,50863,97,97,2.9411764705882355,4.75
1735,569508,1035,1836,30095,525,510,1.0,3.19
1736,3168,128,3168,378,90,38,1.408450704225352,41.1
1737,725376,6441,6156,41092,3646,2795,1.0,5.0
1738,127944,308,0,22230,117,191,7.6923076923076925,0.0
1739,623532,469,0,40728,250,219,1.851851851851852,0.0
1740,436452,768,0,27014,404,364,1.6129032258064515,0.0
1741,456,28,456,135,28,0,4.0,38.56
1742,688008,41,0,68784,31,10,33.333333333333336,0.0
1743,600912,54,0,87221,39,15,12.5,0.0
1744,2172,381,2088,344,198,183,1.7241379310344829,42.53
1745,96,14,96,6,14,0,6.25,15.29
1746,504288,592,0,27959,312,280,1.25,0.0
1747,1320,33,0,121,26,7,50.0,0.0
1748,41268,48,0,4458,43,5,50.0,0.0
1749,12012,43,0,1178,29,14,100.0,0.0
1750,4452,244,0,1558,88,156,10.0,0.0
1751,23448,59,0,3270,42,17,50.0,0.0
1752,39528,53,0,4077,42,11,100.0,0.0
1753,480,76,480,43,58,18,2.0,26.65
1754,1284,118,1224,640,69,49,5.0,70.79
1755,756,182,756,287,180,2,2.380952380952381,8.4
1756,1740,29,1740,142,25,4,4.3478260869565215,46.65
1757,725712,6889,0,102996,3860,3029,1.0,0.0
1758,216,31,216,12,21,10,5.555555555555555,53.42
1759,72,24,72,16,15,9,12.5,51.03
1760,69132,15,0,14755,8,7,16.666666666666668,0.0
1761,756,55,756,277,40,15,3.703703703703704,51.16
1762,408,39,72,41,32,7,3.125,12.31
1763,120,14,120,33,11,3,10.0,59.14
1764,7644,16,7644,974,15,1,7.6923076923076925,55.61
1765,659964,84,0,96940,64,20,14.285714285714286,0.0
1766,1044,22,1044,398,18,4,5.555555555555555,72.35
1767,2268,15,2268,722,13,2,11.11111111111111,88.97
1768,695676,1594,0,5010,999,595,1.0,0.0
1769,84984,56,0,6609,44,12,100.0,0.0
1770,192,13,192,108,13,0,6.666666666666667,61.52
1771,4464,27,4464,698,18,9,9.090909090909092,0.0
1772,265764,419,0,7669,239,180,3.703703703703704,4.92
1773,1668,8,1668,111,8,0,11.11111111111111,0.0
1774,372,116,372,183,66,50,2.3255813953488373,51.67
1775,509316,861,0,9080,458,403,1.0,0.89
1776,6612,7,6612,423,6,1,20.0,66.07
1777,132816,45,0,6615,38,7,100.0,100.0
1778,34320,34,0,2845,32,2,50.0,0.0
1779,143436,77,26100,5525,66,11,1.7857142857142858,11.07
1780,336,4,336,24,3,1,25.0,72.19
1781,324804,624,0,1848,321,303,1.4285714285714286,0.0
1782,1212,26,0,361,21,5,100.0,0.0
1783,12012,45,0,1199,30,15,100.0,0.0
1784,24312,192,0,1408,119,73,100.0,0.0
1785,348,1,348,132,1,0,33.333333333333336,89.6
1786,145800,40,0,16193,33,7,50.0,0.0
1787,396,2,396,72,1,1,50.0,62.83
1788,713316,1853,17970,13806,1024,829,1.0,0.0
1789,26604,101,0,3311,91,10,50.0,0.0
1790,4272,14,4272,1195,12,2,12.5,76.39
1791,2100,56,0,734,51,5,50.0,0.0
1792,1344,36,0,449,28,8,50.0,90.0
1793,153672,740,0,3664,360,380,1.6666666666666667,0.0
1794,540,103,540,169,87,16,1.7857142857142858,36.8
1795,12960,128,0,1215,83,45,1.9230769230769231,3.0
1796,28092,33,0,1806,31,2,50.0,0.0
1797,552,6,552,380,2,4,50.0,94.8
1798,693960,615,0,14883,336,279,1.3888888888888888,2.0
1799,10896,40,0,2071,32,8,100.0,0.0
1800,274980,119,0,16181,95,24,25.0,0.0
1801,4668,40,4668,976,29,11,6.25,67.36
1802,76596,183,0,4674,95,88,4.0,5.0
1803,3120,115,3120,2427,101,14,1.0869565217391304,35.94
1804,277572,210,0,12343,102,108,6.666666666666667,0.0
1805,84,5,84,21,3,2,25.0,74.25
1806,192,15,168,59,13,2,7.142857142857143,16.74
1807,144,14,144,51,13,1,7.142857142857143,63.9
1808,432,49,432,204,39,10,2.7777777777777777,50.48
1809,68016,124,68016,3813,95,29,4.166666666666667,20.33
1810,2640,7,0,1848,3,4,50.0,0.0
1811,180,12,120,65,8,4,16.666666666666668,56.09
1812,86700,13,0,7539,9,4,20.0,5.0
1813,972,0,972,0,0,0,50.0,10.2
1814,1092,26,0,84,24,2,100.0,0.0
1815,622164,669,0,20536,372,297,1.9230769230769231,0.0
1816,752136,440,0,91817,251,189,1.3157894736842106,0.0
1817,1248,61,0,117,58,3,1.694915254237288,0.0
1818,2508,37,0,294,20,17,14.285714285714286,3.0
1819,100092,268,0,3539,146,122,3.333333333333333,3.0
1820,742188,1298,0,23810,709,589,1.0,0.0
1821,729528,45,0,24949,34,11,20.0,0.0
1822,1188,124,1188,243,108,16,1.020408163265306,22.77
1823,45552,17,0,5526,15,2,100.0,100.0
1824,80760,37,80760,965,34,3,2.857142857142857,25.78
1825,412992,1,412992,18312,0,1,100.0,0.0
1826,756432,401,260947,185886,401,0,1.0,16.87
1827,2604,28,2604,920,22,6,11.11111111111111,91.82
1828,12588,151,0,1948,106,45,100.0,0.0
1829,2568,4,0,774,2,2,33.333333333333336,0.0
1830,96,0,96,0,0,0,50.0,64.0
1831,18756,23,18756,3789,17,6,10.0,0.0
1832,263688,24,263688,1257,21,3,7.6923076923076925,32.25
1833,756420,7471,0,263900,4476,2995,1.0,0.0
1834,153540,17,153540,624,7,10,25.0,86.15
1835,648,4,648,114,2,2,33.333333333333336,76.14
1836,372,105,372,147,68,37,3.125,0.5
1837,745812,774,0,8524,421,353,1.25,3.0
1838,734136,1007,0,13559,578,429,1.2195121951219512,0.0
1839,78456,30,7344,13758,24,6,4.545454545454546,75.86
1840,77652,11,0,7588,8,3,11.11111111111111,0.0
1841,876,43,876,54,39,4,2.5641025641025643,18.37
1842,14688,141,0,1224,89,52,2.4390243902439024,2.0
1843,180,0,180,0,0,0,50.0,64.0
1844,169092,24,169092,1458,21,3,7.6923076923076925,71.38
1845,39540,0,39540,0,0,0,100.0,100.0
1846,588,11,588,138,8,3,14.285714285714286,52.76
1847,168,9,168,25,6,3,20.0,21.55
1848,624,1,624,444,1,0,33.333333333333336,75.46
1849,3336,47,3336,31,43,4,2.3255813953488373,11.43
1850,55992,9,55992,313,9,0,14.285714285714286,40.03
1851,45408,128,0,1686,83,45,100.0,0.0
1852,156,1,156,0,1,0,33.333333333333336,63.2
1853,482220,104,0,253032,80,24,2.3255813953488373,0.0
1854,764556,2259,0,155021,1386,873,1.3888888888888888,85.92
1855,600,1,600,468,1,0,100.0,100.0
1856,612,15,612,286,14,1,7.6923076923076925,34.74
1857,55416,26,55416,14,22,4,4.545454545454546,37.79
1858,55764,20,55764,1,20,0,4.545454545454546,36.48
1859,726720,742,0,28946,399,343,1.7857142857142858,0.0
1860,972,81,972,197,55,26,2.380952380952381,51.04
1861,596376,187,0,36849,75,112,4.545454545454546,0.0
1862,6756,38,6756,51,30,8,3.571428571428572,41.08
1863,2304,6,2304,2190,6,0,9.090909090909092,74.01
1864,544476,215,0,4224,120,95,3.703703703703704,0.0
1865,1512,15,612,238,11,4,10.0,56.56
1866,336,38,336,14,36,2,2.702702702702702,59.27
1867,245808,397,0,2013,267,130,1.0,0.0
1868,749868,1735,0,83741,974,761,1.0,0.0
1869,672708,1004,0,8818,529,475,1.4705882352941178,4.47
1870,336636,457,0,2893,244,213,2.1739130434782608,4.0
1871,4968,15,4968,2215,7,8,20.0,71.4
1872,492,2,492,0,2,0,33.333333333333336,97.57
1873,3084,158,0,493,99,59,100.0,0.0
1874,6216,15,6216,702,15,0,7.6923076923076925,93.27
1875,65688,20,65688,670,12,8,20.0,99.15
1876,548256,869,0,6655,481,388,1.162790697674419,2.5
1877,1008,16,1008,562,12,4,7.6923076923076925,59.09
1878,1464,2,1464,36,1,1,50.0,26.7
1879,996,3,996,444,2,1,50.0,0.0
1880,43884,156,0,1706,86,70,4.3478260869565215,0.0
1881,240,2,216,138,1,1,50.0,59.29
1882,1680,3,1680,1112,1,2,50.0,99.84
1883,576,21,576,135,21,0,4.545454545454546,55.31
1884,512460,672,0,5023,379,293,1.098901098901099,0.0
1885,2052,92,1908,1864,82,10,1.2658227848101269,58.25
1886,426972,424,0,5156,240,184,1.5384615384615383,2.0
1887,648,5,648,88,5,0,14.285714285714286,68.33
1888,2796,58,2796,1408,45,13,3.703703703703704,42.92
1889,1656,67,1584,316,50,17,2.702702702702702,36.26
1890,1536,6,1536,312,6,0,12.5,88.08
1891,80040,9,41538,1104,9,0,10.0,29.95
1892,47400,23,0,23028,21,2,50.0,0.0
1893,204,5,132,60,3,2,25.0,59.26
1894,432,25,432,50,22,3,4.545454545454546,46.29
1895,455436,59,0,18576,31,28,5.0,10.0
1896,240,0,240,0,0,0,50.0,86.0
1897,592980,909,0,30123,453,456,1.2048192771084338,0.0
1898,747348,1144,0,118318,669,475,1.0,0.0
1899,727776,894,0,35391,515,379,1.0309278350515465,0.0
1900,46164,15,0,4232,14,1,50.0,0.0
1901,774960,735,0,210758,416,319,1.2195121951219512,0.0
1902,108,26,108,25,20,6,6.25,39.43
1903,578616,344,0,8267,178,166,1.7543859649122806,2.0
1904,11868,2,11868,282,1,1,100.0,1.74
1905,121344,8,121344,4777,8,0,9.090909090909092,55.0
1906,4440,0,4440,0,0,0,100.0,100.0
1907,19752,27,19752,447,25,2,4.0,68.21
1908,6504,2,6504,648,2,0,25.0,89.25
1909,9180,18,9180,3030,9,9,50.0,56.97
1910,4692,5,4692,1250,4,1,20.0,86.17
1911,236484,21,0,45124,18,3,16.666666666666668,0.0
1912,192,29,192,55,15,14,9.090909090909092,46.2
1913,1008,16,1008,509,8,8,16.666666666666668,74.57
1914,769548,1595,502644,246597,784,811,1.0,0.96
1915,746472,262,0,3231,186,76,1.0,0.0
1916,456,1,456,48,1,0,33.333333333333336,76.44
1917,348,32,348,5,30,2,3.225806451612903,34.18
1918,192,79,192,39,55,24,2.272727272727273,11.74
1919,573384,28,573384,5838,25,3,4.0,21.22
1920,708,3,708,100,3,0,20.0,77.3
1921,678588,1258,0,15319,674,584,1.0,0.0
1922,778956,936,0,130435,620,316,1.0,0.0
1923,124068,32,124068,6423,32,0,3.571428571428572,64.37
1924,8256,62,8256,7597,38,24,3.225806451612903,2.0
1925,748056,132,748056,940,66,66,4.3478260869565215,0.0
1926,8688,4,8688,3063,4,0,16.666666666666668,82.4
1927,639480,757,0,12553,409,348,1.408450704225352,0.34
1928,6420,11,6420,6375,8,3,8.333333333333334,41.91
1929,16488,14,16488,1839,11,3,10.0,74.57
1930,7956,150,0,414,64,86,7.6923076923076925,0.0
1931,96,98,96,13,86,12,1.25,25.6
1932,104508,65,0,7226,54,11,50.0,0.0
1933,629628,264,0,6677,155,109,1.408450704225352,0.0
1934,152700,180,0,2518,86,94,11.11111111111111,0.0
1935,5112,288,0,223,147,141,2.0408163265306123,0.0
1936,16524,13,16524,14681,9,4,11.11111111111111,97.42
1937,30672,0,30672,0,0,0,50.0,75.0
1938,711660,2311,0,8359,1265,1046,1.0,1.6
1939,864,27,864,533,24,3,4.545454545454546,80.95
1940,40032,50,0,2677,40,10,50.0,0.0
1941,732936,1047,0,19521,574,473,1.0,0.0
1942,1656,5,1656,590,5,0,16.666666666666668,0.0
1943,276,3,156,108,3,0,25.0,74.2
1944,1668,77,1668,250,38,39,5.882352941176471,5.0
1945,87840,45,0,2773,40,5,50.0,0.0
1946,272196,486,0,2259,262,224,2.0,0.0
1947,13764,21,13740,1953,18,3,6.25,86.98
1948,701172,940,0,4901,488,452,1.0,1.45
1949,10980,10,10980,48,10,0,8.333333333333334,73.0
1950,53940,21,35540,28013,21,0,7.142857142857143,98.29
1951,134880,269,0,1870,141,128,2.7777777777777777,0.0
1952,787212,2804,0,194501,1617,1187,1.0,0.0
1953,10104,1,10104,2460,1,0,100.0,100.0
1954,9984,75,9984,53,43,32,3.4482758620689653,77.15
1955,78264,40,78264,12,28,12,4.166666666666667,41.53
1956,41664,45,0,2308,40,5,50.0,0.0
1957,420,78,96,41,57,21,2.083333333333333,9.61
1958,67764,124,0,1273,106,18,100.0,0.0
1959,334980,46,0,10963,38,8,100.0,0.0
1960,4176,149,0,1028,106,43,2.3255813953488373,0.0
1961,749376,6583,0,50707,3603,2980,1.0,0.0
1962,22308,150,0,1785,89,61,100.0,0.0
1963,350016,273,0,2841,149,124,2.857142857142857,4.0
1964,852,358,636,152,212,146,1.020408163265306,33.32
1965,50664,44,0,2546,38,6,100.0,0.0
1966,0,0,0,0,0,0,50.0,26.8
1967,14052,33,14052,7,29,4,3.4482758620689653,49.63
1968,10596,14,0,4319,14,0,6.666666666666667,22.0
1969,336,20,336,76,20,0,4.545454545454546,58.7
1970,364140,83,0,5630,64,19,50.0,90.0
1971,717552,4107,337104,386120,2369,1738,1.0,0.0
1972,21792,184,0,1212,121,63,100.0,0.0
1973,28884,169,0,1475,109,60,2.1739130434782608,2.0
1974,34824,104,34824,1649,83,21,1.2345679012345678,33.63
1975,311748,297,0,3346,160,137,3.4482758620689653,5.0
1976,2052,26,2052,355,23,3,6.666666666666667,39.36
1977,3960,130,3960,468,70,60,3.8461538461538463,0.0
1978,240,27,240,58,15,12,9.090909090909092,54.28
1979,1164,282,1164,749,161,121,1.7241379310344829,71.88
1980,387132,313,0,59694,111,202,100.0,100.0
1981,784224,8,1314,304054,6,2,33.333333333333336,99.83
1982,34620,93,0,1025,62,31,3.0303030303030303,0.0
1983,7620,193,0,2034,140,53,1.639344262295082,0.0
1984,78228,165,0,6191,138,27,100.0,0.0
1985,299964,37,0,15062,33,4,20.0,0.0
1986,936,53,936,20,47,6,2.1739130434782608,10.24
1987,2184,32,2184,814,29,3,4.166666666666667,44.75
1988,768072,1197,0,13943,658,539,1.0,0.0
1989,36084,3,36084,792,3,0,20.0,92.51
1990,102816,45,0,3245,41,4,50.0,0.0
1991,2052,31,2052,250,27,4,3.703703703703704,76.38
1992,108,3,108,12,3,0,20.0,21.3
1993,103116,50,0,3150,42,8,50.0,0.0
1994,228,63,228,15,51,12,2.083333333333333,27.67
1995,766776,562,0,6552,356,206,1.0,0.0
1996,48,4,48,0,4,0,16.666666666666668,23.12
1997,108,0,108,0,0,0,50.0,51.2
1998,93732,37,93732,34,33,4,3.333333333333333,31.44
1999,105252,54,0,3013,47,7,50.0,0.0
2000,1284,14,0,220,10,4,33.333333333333336,25.0
2001,216,1,216,0,1,0,33.333333333333336,60.4
2002,57408,25,0,3492,24,1,50.0,0.0
2003,684,1,684,588,1,0,33.333333333333336,78.44
2004,16008,37,0,1579,32,5,50.0,0.0
2005,21792,0,21792,0,0,0,50.0,59.29
2006,2136,37,2136,711,27,10,5.882352941176471,0.0
2007,679320,479,0,34077,242,237,1.818181818181818,0.0
2008,668160,131,0,11644,79,52,50.0,0.0
2009,797592,2716,267936,134364,1589,1127,1.0,0.0
2010,433596,276,0,4240,138,138,2.857142857142857,4.62
2011,852,3,852,72,3,0,25.0,0.0
2012,252,6,252,124,4,2,25.0,73.09
2013,31176,49,31176,18,37,12,3.0303030303030303,35.3
2014,34512,30,34512,170,29,1,3.4482758620689653,53.28
2015,144600,135,0,5474,96,39,20.0,0.0
2016,679608,900,52020,34906,496,404,1.5873015873015872,0.0
2017,691200,929,0,15925,494,435,1.0869565217391304,0.0
2018,425916,0,425916,0,0,0,100.0,100.0
2019,683676,538,0,31027,295,243,1.818181818181818,2.9
2020,1692,31,1692,908,20,11,10.0,12.94
2021,307032,118,0,3920,86,32,100.0,0.0
2022,10032,35,0,1595,31,4,50.0,0.0
2023,8532,119,972,266,91,28,1.25,22.6
2024,252,49,252,41,42,7,2.857142857142857,73.69
2025,672,19,672,248,17,2,5.882352941176471,46.76
2026,96168,23,96168,1725,21,2,7.6923076923076925,99.37
2027,372,17,372,282,7,10,33.333333333333336,94.68
2028,244584,7,244584,382,7,0,12.5,35.91
2029,22164,23,22068,1484,18,5,6.666666666666667,87.7
2030,317052,178,0,12191,58,120,1.0,0.0
2031,803544,4495,0,40955,2545,1950,1.0,0.0
2032,3540,25,3336,2037,20,5,10.0,33.8
2033,504,16,504,18,13,3,8.333333333333334,54.59
2034,705288,9,0,235392,6,3,14.285714285714286,2.5
2035,415872,241,0,9105,107,134,3.8461538461538463,0.0
2036,23964,15,23964,2520,13,2,10.0,18.95
2037,243912,16,243912,791,14,2,11.11111111111111,17.77
2038,732012,502,0,5057,266,236,1.492537313432836,0.0
2039,614556,1019,0,17789,525,494,1.4705882352941178,0.0
2040,360,23,360,33,11,12,14.285714285714286,74.86
2041,10044,30,252,382,19,11,10.0,60.46
2042,0,2,0,0,2,0,25.0,35.0
2043,2184,25,2184,118,18,7,7.6923076923076925,51.42
2044,15816,56,0,1957,48,8,50.0,0.0
2045,801984,1276,0,21313,693,583,1.0,0.0
2046,80760,27,0,4454,24,3,100.0,0.0
2047,73020,39,0,17500,25,14,100.0,0.0
2048,775356,1206,0,8979,646,560,1.0,1.44
2049,139728,24,139728,4049,21,3,5.555555555555555,51.11
2050,4260,83,4260,38,57,26,2.1739130434782608,11.42
2051,81696,437,0,1375,241,196,1.0,0.0
2052,149700,613,0,2053,372,241,1.0,0.0
2053,276,3,276,56,3,0,25.0,96.72
2054,420,107,420,114,73,34,1.818181818181818,56.34
2055,62292,20,62292,742,16,4,6.666666666666667,0.0
2056,132,32,96,23,24,8,5.2631578947368425,46.54
2057,816,117,816,192,85,32,1.5873015873015872,38.33
2058,91272,162,0,2445,120,42,50.0,90.0
2059,72,15,72,22,8,7,33.333333333333336,79.21
2060,11532,39,11532,1174,34,5,5.882352941176471,99.38
2061,792,62,792,376,50,12,3.225806451612903,58.17
2062,117924,29,117924,804,26,3,5.2631578947368425,67.49
2063,3612,84,0,1411,67,17,50.0,90.0
2064,1632,116,1632,128,82,34,1.5625,47.74
2065,313020,336,0,7135,176,160,2.4390243902439024,5.0
2066,119208,28,119208,499,25,3,5.0,65.71
2067,300,122,300,65,67,55,2.702702702702702,73.14
2068,948,39,948,756,15,24,12.5,90.55
2069,30600,47,0,1558,34,13,50.0,0.0
2070,576,142,576,61,92,50,1.162790697674419,7.2
2071,29436,0,29436,0,0,0,100.0,100.0
2072,79428,89,79428,5728,72,17,4.0,9.82
2073,627444,349,0,6775,165,184,2.127659574468085,0.0
2074,240,24,240,33,19,5,5.882352941176471,10.67
2075,1188,10,1188,374,5,5,50.0,72.15
2076,12036,43,0,1436,29,14,100.0,0.0
2077,819036,3104,0,30636,1699,1405,1.0,0.0
2078,195408,10,195408,444,9,1,11.11111111111111,57.12
2079,36396,156,0,1239,97,59,100.0,0.0
2080,166800,40,0,86654,35,5,3.125,1.4
2081,34440,8,34440,3700,6,2,11.11111111111111,93.6
2082,170592,24,170592,35733,16,8,11.11111111111111,91.21
2083,10176,7,10176,2751,7,0,14.285714285714286,0.0
2084,156,1,156,0,1,0,33.333333333333336,82.0
2085,108,3,108,28,2,1,33.333333333333336,20.07
2086,88824,95,88824,3225,41,54,6.666666666666667,65.54
2087,1764,16,288,238,9,7,14.285714285714286,62.94
2088,83832,20,83832,4426,12,8,20.0,49.85
2089,22440,170,0,2013,116,54,100.0,0.0
2090,189804,17,189804,961,15,2,10.0,49.92
2091,468,59,468,253,41,18,2.9411764705882355,70.18
2092,396,4,396,123,4,0,20.0,99.2
2093,72,5,72,19,3,2,33.333333333333336,0.0
2094,221172,286,0,11611,182,104,2.2222222222222223,0.0
2095,827880,2252,0,48062,1270,982,1.0,0.0
2096,204,26,204,54,20,6,6.25,60.3
2097,1020,30,1020,747,30,0,3.571428571428572,77.61
2098,6396,31,6396,3303,31,0,3.571428571428572,0.0
2099,28476,40,28476,1964,26,14,14.285714285714286,47.02
2100,372,3,372,52,3,0,20.0,70.07
2101,1332,667,1080,924,622,45,2.0408163265306123,26.24
2102,612,0,612,0,0,0,50.0,75.0
2103,296184,82,0,13267,49,33,5.555555555555555,0.0
2104,1404,50,1404,572,39,11,3.125,94.66
2105,504,54,504,100,34,20,3.8461538461538463,59.25
2106,600,181,600,186,128,53,1.0,38.9
2107,48972,185,0,1315,151,34,100.0,0.0
2108,69684,10,69684,3015,5,5,50.0,58.24
2109,674496,1269,0,19488,663,606,1.0,0.0
2110,25632,104,0,2464,50,54,9.090909090909092,0.0
2111,432,4,432,216,2,2,20.0,70.97
2112,238944,86,238944,7933,63,23,2.9411764705882355,17.22
2113,127476,512,0,2249,265,247,1.7543859649122806,2.0
2114,900,57,0,121,54,3,1.818181818181818,0.0
2115,831732,1993,0,30395,1014,979,1.0,0.0
2116,68448,38,68448,27,30,8,4.0,37.14
2117,804012,22,0,259509,12,10,1.0,0.0
2118,228432,166,0,1849,74,92,5.555555555555555,1.0
2119,50640,1,50640,240,1,0,33.333333333333336,64.19
2120,117876,258,0,3402,125,133,3.571428571428572,0.0
2121,1824,153,0,139,96,57,1.5384615384615383,0.0
2122,540,0,540,0,0,0,50.0,80.0
2123,156,0,156,0,0,0,50.0,60.84
2124,1908,57,1908,70,51,6,1.9230769230769231,23.13
2125,2724,215,0,129,114,101,2.5641025641025643,0.0
2126,216,19,168,15,19,0,4.761904761904762,0.0
2127,848160,496,0,82191,236,260,1.1764705882352942,5.77
2128,3744,2,0,2232,2,0,25.0,0.0
2129,59352,6,0,11074,4,2,25.0,5.0
2130,56712,114,0,1251,49,65,10.0,0.0
2131,751080,1032,0,15098,531,501,1.7241379310344829,5.5
2132,44508,315,2136,668,204,111,1.0416666666666667,29.17
2133,264,1,264,36,1,0,50.0,99.96
2134,106884,174,0,1776,80,94,5.0,5.0
2135,1932,36,1932,1350,34,2,3.0303030303030303,44.85
2136,264,1,264,12,1,0,33.333333333333336,54.75
2137,308280,158,308280,2058,71,87,6.666666666666667,90.84
2138,792,4,792,129,3,1,33.333333333333336,99.55
2139,128004,263,0,2507,135,128,2.631578947368421,0.1
2140,149292,153,0,3184,82,71,4.761904761904762,0.0
2141,108,70,108,33,40,30,3.8461538461538463,50.52
2142,156,5,156,12,4,1,20.0,78.49
2143,380988,80,888,5050,50,30,2.5641025641025643,14.0
2144,62724,24,62724,1802,21,3,5.882352941176471,27.03
2145,84,5,84,26,3,2,33.333333333333336,22.01
2146,843516,725,0,20440,385,340,1.7543859649122806,0.0
2147,204,4,204,42,3,1,25.0,25.37
2148,857280,7091,0,295140,4151,2940,1.0,0.0
2149,30636,180,0,2907,95,85,3.333333333333333,0.0
2150,435492,237,0,28846,96,141,3.571428571428572,0.0
2151,252,2,252,174,1,1,50.0,22.24
2152,144,21,144,7,20,1,4.761904761904762,37.44
2153,684,0,684,0,0,0,50.0,89.2
2154,89196,211,89196,3104,78,133,2.9411764705882355,67.62
2155,85632,73,85632,5306,64,9,1.5384615384615383,19.18
2156,816,18,0,411,18,0,4.761904761904762,7.17
2157,228,44,228,42,33,11,3.4482758620689653,34.37
2158,228,20,228,44,20,0,4.761904761904762,59.22
2159,635484,507,0,46502,264,243,1.7857142857142858,0.0
2160,624096,1063,0,8320,584,479,1.0638297872340423,0.0
2161,58080,111,0,19032,60,51,12.5,0.0
2162,408,4,408,177,4,0,16.666666666666668,88.69
2163,374208,504,0,12774,263,241,2.272727272727273,0.0
2164,247884,2,247884,648,2,0,100.0,100.0
2165,3108,147,3108,1148,87,60,1.639344262295082,33.47
2166,480,37,480,182,15,22,16.666666666666668,78.56
2167,334068,130,0,6366,61,69,3.703703703703704,2.38
2168,472344,114,0,14477,60,54,9.090909090909092,0.0
2169,657156,56,657156,1909,32,24,4.545454545454546,34.46
2170,76536,66,0,6418,33,33,5.882352941176471,0.0
2171,765084,379,0,13318,211,168,2.272727272727273,1.96
2172,64572,255,0,1576,118,137,3.571428571428572,4.75
2173,140052,185,0,6705,90,95,4.0,0.0
2174,129132,21,0,6754,16,5,7.6923076923076925,0.0
2175,747828,1011,0,90532,526,485,1.1904761904761905,1.76
2176,577344,865,0,69660,483,382,1.2658227848101269,0.91
2177,360,28,360,87,26,2,3.703703703703704,68.4
2178,2868,201,2868,139,118,83,1.851851851851852,71.19
2179,4188,4,4188,57,3,1,25.0,78.7
2180,276,14,84,48,12,2,9.090909090909092,17.47
2181,22380,131,0,475,112,19,100.0,0.0
2182,252,96,252,59,54,42,2.857142857142857,54.3
2183,168,2,168,0,2,0,20.0,22.39
2184,312,64,312,36,36,28,4.166666666666667,67.86
2185,758820,1399,0,14086,757,642,1.0,0.0
2186,25680,20,25680,207,18,2,5.882352941176471,79.06
2187,601704,450,272946,84563,416,34,1.0,32.47
2188,13140,59,0,740,40,19,50.0,99.0
2189,216636,499,0,55057,264,235,1.0,14.7
2190,32676,90,0,1394,69,21,100.0,0.0
2191,716208,51,0,127639,41,10,25.0,0.0
2192,774552,1973,0,40696,1110,863,1.0,0.0
2193,867456,595,0,44570,345,250,1.0,16.89
2194,468,94,60,45,67,27,1.7857142857142858,7.88
2195,2304,44,0,703,37,7,100.0,0.0
2196,11148,75,10218,3282,69,6,3.4482758620689653,17.89
2197,408,32,408,27,29,3,3.4482758620689653,73.6
2198,708,5,708,168,4,1,20.0,82.24
2199,432660,56,432660,246,31,25,7.6923076923076925,58.15
2200,528,0,528,0,0,0,50.0,81.25
2201,4608,257,0,987,159,98,100.0,0.0
2202,294780,52,0,12081,44,8,50.0,90.0
2203,813540,882,0,4291,484,398,1.0,4.94
2204,852,37,0,175,28,9,100.0,0.0
2205,856116,55,0,143056,36,19,16.666666666666668,0.0
2206,274068,100,220638,88965,100,0,100.0,100.0
2207,872352,1349,0,15048,742,607,1.0,0.0
2208,624,22,624,247,22,0,4.3478260869565215,46.58
2209,522324,23,0,45712,15,8,10.0,3.57
2210,822060,1040,0,25786,561,479,1.0,0.0
2211,743640,1075,0,110968,596,479,1.0,0.0
2212,150816,124,0,12978,62,62,3.333333333333333,10.0
2213,883956,14477,274800,184563,8352,6125,1.0,0.0
2214,780,38,780,23,35,3,3.0303030303030303,12.41
2215,77640,131,0,1128,82,49,2.127659574468085,0.0
2216,2820,0,2820,0,0,0,100.0,0.0
2217,251868,46,251868,3065,39,7,2.631578947368421,12.27
2218,746364,295,0,5108,142,153,4.3478260869565215,0.0
2219,636,29,288,86,25,4,4.3478260869565215,55.21
2220,84228,11,0,14397,8,3,2.083333333333333,0.0
2221,180,36,180,6,30,6,3.4482758620689653,55.47
2222,439668,494,0,5525,265,229,2.5641025641025643,0.0
2223,885516,3129,86412,129335,1775,1354,1.0,0.0
2224,2352,27,2352,197,21,6,5.882352941176471,47.24
2225,65820,43,0,3248,38,5,50.0,0.0
2226,88860,103,88860,53,75,28,1.5873015873015872,7.43
2227,139224,2,139224,4176,1,1,100.0,100.0
2228,5280,213,0,1432,131,82,100.0,0.0
2229,89220,35,89220,14,27,8,4.166666666666667,59.62
2230,855336,1888,0,7990,1028,860,1.0,0.0
2231,94692,158,94692,9150,79,79,7.142857142857143,82.49
2232,65808,19,0,5912,15,4,100.0,0.0
2233,876,13,876,21,12,1,7.6923076923076925,16.8
2234,1296,19,1296,342,11,8,9.090909090909092,47.43
2235,6144,80,6144,5206,78,2,1.3157894736842106,22.64
2236,171672,162,171672,5795,112,50,1.0,17.68
2237,92544,33,0,7678,29,4,5.2631578947368425,27.73
2238,168,19,168,18,16,3,6.666666666666667,52.82
2239,86220,170,0,3378,99,71,2.857142857142857,2.0
2240,668844,378,0,11805,185,193,1.5151515151515151,6.26
2241,132,80,132,36,56,24,2.127659574468085,22.6
2242,12120,24,12120,458,19,5,6.25,85.42
2243,17748,37,0,2563,29,8,100.0,0.0
2244,9624,8,5814,5782,7,1,33.333333333333336,99.94
2245,1884,47,1884,32,31,16,4.0,57.46
2246,20892,148,0,524,125,23,100.0,0.0
2247,12000,45,0,1200,29,16,100.0,0.0
2248,891936,4602,0,211789,2851,1751,1.0,0.0
2249,711168,1590,0,6140,1261,329,1.0,0.0
2250,576,36,576,449,14,22,16.666666666666668,0.0
2251,70740,294,0,1177,148,146,2.5,0.0
2252,780012,968,0,5313,515,453,1.2195121951219512,2.0
2253,2556,92,2556,843,55,37,10.0,89.8
2254,180,21,180,18,19,2,5.2631578947368425,44.78
2255,831120,1222,0,13688,668,554,1.0,0.0
2256,14976,22,6096,1125,18,4,5.882352941176471,87.76
2257,897372,7703,359859,203767,3801,3902,1.0,2.17
2258,216,2,216,96,2,0,25.0,58.14
2259,140112,19,140112,4697,17,2,6.666666666666667,38.24
2260,180,8,180,93,8,0,10.0,85.7
2261,598344,1295,0,6447,685,610,1.0,0.0
2262,12672,13,12672,942,10,3,11.11111111111111,79.29
2263,8772,19,8772,526,18,1,5.555555555555555,83.39
2264,180,31,180,4,27,4,3.703703703703704,55.43
2265,888,33,888,276,22,11,6.666666666666667,68.21
2266,288588,407,0,4922,218,189,1.96078431372549,0.0
2267,741804,49,0,51289,32,17,33.333333333333336,0.0
2268,144,18,144,15,16,2,6.25,49.94
2269,10776,16,732,820,14,2,6.666666666666667,56.01
2270,492,4,492,228,3,1,33.333333333333336,60.49
2271,384,16,84,89,13,3,8.333333333333334,19.55
2272,859104,1039,0,9433,585,454,1.0,0.0
2273,60,17,60,17,13,4,9.090909090909092,63.81
2274,4632,28,4632,11,19,9,8.333333333333334,53.61
2275,163824,32,0,6541,25,7,100.0,0.0
2276,5952,21,5952,1065,19,2,6.666666666666667,39.27
2277,910224,14310,0,115632,8179,6131,1.0,0.0
2278,569796,47,0,17960,41,6,50.0,0.0
2279,912,15,912,280,13,2,14.285714285714286,92.94
2280,108,64,108,39,38,26,3.703703703703704,13.25
2281,6096,15,6096,312,13,2,10.0,71.68
2282,771216,1029,0,3328,705,324,1.0,0.0
2283,403956,114,0,13922,49,65,5.882352941176471,2.0
2284,3360,81,0,975,67,14,100.0,0.0
2285,168252,499,0,1606,238,261,1.7543859649122806,2.38
2286,700404,1079,0,13175,586,493,1.0,0.0
2287,21984,53,21984,1561,42,11,3.225806451612903,76.46
2288,39636,27,0,3387,24,3,50.0,0.0
2289,1968,47,0,686,38,9,50.0,50.0
2290,46104,136,46104,1894,133,3,1.5384615384615383,26.92
2291,85896,58,85896,1316,47,11,3.333333333333333,51.96
2292,863520,3676,0,18629,2045,1631,1.0,1.27
2293,19752,206,19752,472,107,99,4.166666666666667,45.71
2294,78864,48,78864,2528,44,4,14.285714285714286,20.02
2295,12012,44,0,1205,28,16,100.0,0.0
2296,268140,20,174546,20200,14,6,3.571428571428572,92.02
2297,78084,2,5304,216,2,0,100.0,100.0
2298,48,27,48,17,24,3,4.3478260869565215,12.04
2299,372,52,372,112,42,10,2.631578947368421,45.79
2300,6828,21,6828,542,19,2,7.6923076923076925,68.77
2301,3048,95,0,1301,71,24,50.0,90.0
2302,27192,2,0,26856,2,0,100.0,100.0
2303,154416,10,154416,1024,10,0,10.0,0.73
2304,492,54,492,209,52,2,3.0303030303030303,33.6
2305,904788,117,494685,415974,117,0,12.5,99.85
2306,752160,800,0,7014,444,356,1.1904761904761905,0.0
2307,240,6,240,116,2,4,50.0,99.58
2308,98064,33,98064,437,28,5,4.545454545454546,70.74
2309,2916,8,2916,508,7,1,2.272727272727273,89.67
2310,756,3,756,296,3,0,20.0,75.26
2311,804,4,804,372,4,0,33.333333333333336,0.0
2312,684,158,684,350,82,76,2.857142857142857,73.59
2313,86904,23,86904,552,19,4,10.0,50.74
2314,20640,197,0,2082,126,71,100.0,0.0
2315,90516,47,90516,731,38,9,3.8461538461538463,69.4
2316,269364,48,1296,15015,35,13,1.3157894736842106,63.88
2317,504,41,504,216,39,2,4.3478260869565215,52.07
2318,879780,16,879780,54876,15,1,6.25,73.89
2319,408,29,408,43,24,5,4.545454545454546,41.67
2320,169932,47,0,7273,41,6,100.0,0.0
2321,612,42,612,43,34,8,3.125,58.65
2322,756,30,0,85,25,5,100.0,0.0
2323,2472,46,2472,661,40,6,3.4482758620689653,62.01
2324,1164,45,1164,15,37,8,2.857142857142857,12.51
2325,144,9,144,32,6,3,20.0,70.69
2326,29208,156,0,809,132,24,100.0,0.0
2327,396,9,396,112,7,2,12.5,72.31
2328,234240,13,1188,23615,11,2,9.090909090909092,89.81
2329,396,59,396,99,39,20,3.0303030303030303,28.8
2330,3192,35,3192,5,31,4,3.225806451612903,43.97
2331,776988,632,0,6821,354,278,1.408450704225352,2.0
2332,125952,48,0,3288,36,12,50.0,0.0
2333,576,10,576,9,8,2,12.5,73.31
2334,492,18,60,42,10,8,20.0,21.66
2335,909804,119,0,145526,64,55,2.380952380952381,0.0
2336,33576,9,33576,456,5,4,33.333333333333336,21.67
2337,126288,50,0,3436,36,14,50.0,0.0
2338,19128,31,156,630,28,3,7.6923076923076925,53.03
2339,4260,21,4260,0,21,0,4.3478260869565215,58.33
2340,12036,40,0,1295,25,15,100.0,0.0
2341,125724,52,0,3097,40,12,50.0,0.0
2342,95892,51,0,2644,38,13,50.0,0.0
2343,87024,13,87024,237,12,1,16.666666666666668,76.75
2344,852,30,852,221,30,0,3.125,45.0
2345,1896,3,1896,536,2,1,33.333333333333336,22.36
2346,198132,81,173136,113790,80,1,100.0,0.0
2347,422832,326,0,7187,180,146,2.272727272727273,0.0
2348,4488,46,132,137,34,12,3.4482758620689653,38.04
2349,148944,17,148944,47479,11,6,14.285714285714286,89.52
2350,1740,19,1740,396,16,3,6.666666666666667,47.03
2351,13860,51,13860,2278,47,4,10.0,12.25
2352,16536,100,16536,901,99,1,2.083333333333333,62.99
2353,77160,1,77160,60,1,0,25.0,9.0
2354,408,28,408,147,12,16,16.666666666666668,70.57
2355,726912,1445,0,13966,778,667,1.0,0.0
2356,87576,62,87576,3559,36,26,3.8461538461538463,37.78
2357,17976,37,17976,1253,33,4,3.8461538461538463,53.98
2358,264,2,264,114,2,0,25.0,0.0
2359,57912,0,57912,0,0,0,100.0,100.0
2360,398064,190,0,5410,88,102,3.571428571428572,2.07
2361,408,47,408,168,38,9,2.857142857142857,34.5
2362,926700,152,821096,497274,152,0,5.0,99.65
2363,919644,1491,0,42917,851,640,1.0,0.0
2364,325716,7,325716,149960,6,1,14.285714285714286,96.38
2365,228,0,228,0,0,0,50.0,88.0
2366,2700,0,2700,0,0,0,50.0,77.0
2367,400356,201,154437,164022,195,6,20.0,0.0
2368,9972,112,0,1605,76,36,100.0,0.0
2369,136752,133,136752,209,55,78,5.882352941176471,83.02
2370,936816,2048,0,81048,1148,900,1.0,3.2
2371,9384,16,0,843,13,3,100.0,0.0
2372,5736,144,5736,2008,143,1,1.3333333333333333,24.7
2373,11340,17,0,1495,14,3,100.0,0.0
2374,729636,1288,0,8347,715,573,1.0,0.0
2375,552,12,552,170,10,2,10.0,27.18
2376,1692,1,1692,1332,1,0,33.333333333333336,83.44
2377,672,60,672,214,59,1,2.127659574468085,43.8
2378,12348,146,0,1562,81,65,4.545454545454546,0.0
2379,564768,360,0,12964,245,115,1.0,0.0
2380,672,10,72,82,6,4,33.333333333333336,35.87
2381,1668,33,720,546,31,2,3.0303030303030303,37.97
2382,2100,9,2100,493,9,0,16.666666666666668,93.91
2383,22584,57,15066,1931,53,4,10.0,17.8
2384,15084,31,15084,971,27,4,4.3478260869565215,53.78
2385,179352,30,179352,1379,25,5,4.761904761904762,66.21
2386,344976,47,0,23392,30,17,33.333333333333336,0.0
2387,336,28,336,69,26,2,3.333333333333333,32.72
2388,247776,751,0,3004,418,333,1.2987012987012987,1.0
2389,8556,23,8556,685,21,2,14.285714285714286,65.14
2390,141156,8,141156,214,6,2,16.666666666666668,94.24
2391,933480,849,0,14778,461,388,1.351351351351351,0.0
2392,141672,10,141672,2788,4,6,33.333333333333336,99.47
2393,61740,323,0,618,199,124,1.0,0.0
2394,11664,9,11664,1481,9,0,20.0,93.65
2395,312,6,312,112,6,0,20.0,93.97
2396,492,4,456,150,4,0,14.285714285714286,4.94
2397,756,63,756,203,47,16,2.9411764705882355,27.01
2398,73788,43,0,2707,33,10,50.0,99.0
2399,533820,169,0,19934,86,83,5.2631578947368425,0.0
2400,240,12,240,62,6,6,50.0,22.73
2401,120,1,120,0,1,0,33.333333333333336,77.0
2402,353076,197,353076,5646,83,114,4.545454545454546,5.22
2403,696,119,696,164,78,41,2.9411764705882355,15.46
2404,504768,3,384,168376,3,0,25.0,97.15
2405,1248,3,1248,904,2,1,33.333333333333336,43.89
2406,741300,37,741300,4471,28,9,4.0,28.58
2407,384,182,384,88,94,88,1.96078431372549,75.72
2408,192,2,192,78,1,1,50.0,46.26
2409,636216,184,0,7696,86,98,7.142857142857143,4.0
2410,922740,255,0,8101,119,136,2.857142857142857,0.0
2411,492,3,492,120,3,0,20.0,81.17
2412,662976,216,0,5066,93,123,5.555555555555555,0.0
2413,37512,143,0,2389,100,43,1.96078431372549,0.0
2414,204,34,204,53,26,8,4.166666666666667,57.53
2415,372372,248,0,2499,133,115,2.631578947368421,0.0
2416,62388,493,0,2117,356,137,1.0416666666666667,0.0
2417,312,1,312,0,1,0,33.333333333333336,45.55
2418,865836,341,77100,40407,173,168,3.333333333333333,0.0
2419,82752,272,0,1858,133,139,4.761904761904762,0.0
2420,731280,1532,0,17709,849,683,1.0,0.0
2421,458448,290,408,10420,144,146,4.761904761904762,0.0
2422,10212,203,0,471,93,110,4.3478260869565215,5.0
2423,61572,18,0,9523,16,2,100.0,0.0
2424,168,153,168,72,89,64,1.7857142857142858,50.89
2425,858660,757,0,142955,429,328,1.0,0.09
2426,768096,917,0,8879,503,414,1.2048192771084338,0.0
2427,317988,369,0,16583,224,145,1.4705882352941178,0.0
2428,337176,35,0,15473,30,5,100.0,0.0
2429,48,14,48,18,13,1,7.142857142857143,52.69
2430,162936,392,0,1087,207,185,1.5151515151515151,0.1
2431,924,28,924,226,26,2,7.142857142857143,40.9
2432,769008,981,0,14712,556,425,1.4285714285714286,0.0
2433,14520,117,14520,4443,116,1,2.0,53.8
2434,19236,89,0,1828,44,45,9.090909090909092,0.0
2435,492,22,492,19,12,10,25.0,66.53
2436,33024,40,0,1724,35,5,50.0,0.0
2437,958116,10072,0,116327,5623,4449,1.0,0.0
2438,957504,3536,0,210337,2014,1522,1.0,4.14
2439,13416,43,0,1449,29,14,100.0,0.0
2440,230436,787,0,12811,436,351,2.380952380952381,0.0
2441,368748,7,996,53168,6,1,20.0,77.31
2442,40368,37,0,2141,31,6,50.0,0.0
2443,45120,18,45120,3872,16,2,6.666666666666667,58.01
2444,180,31,180,10,28,3,7.6923076923076925,68.68
2445,3156,37,3156,1073,34,3,4.3478260869565215,0.0
2446,917448,1397,0,9125,787,610,1.0526315789473684,0.0
2447,195036,25,195036,1370,21,4,5.2631578947368425,39.11
2448,192,1,192,60,1,0,33.333333333333336,76.24
2449,456,1,456,60,1,0,33.333333333333336,78.06
2450,1092,17,1092,346,15,2,7.142857142857143,81.06
2451,8784,29,8784,1254,22,7,8.333333333333334,50.08
2452,12972,18,0,1185,9,9,33.333333333333336,0.1
2453,828,43,48,33,37,6,2.857142857142857,23.18
2454,2340,33,48,86,24,9,4.545454545454546,11.9
2455,1992,35,1992,909,31,4,4.3478260869565215,41.48
2456,26616,23,26616,1138,20,3,5.555555555555555,78.59
2457,288,39,288,41,29,10,3.8461538461538463,41.12
2458,911100,1307,0,34064,725,582,1.075268817204301,2.85
2459,959016,2028,127866,154049,1143,885,1.0,0.0
2460,8964,41,0,1612,35,6,100.0,0.0
2461,1380,34,0,507,29,5,100.0,0.0
2462,48516,66,0,5362,57,9,25.0,0.0
2463,489384,290,221381,128843,290,0,1.0,71.7
2464,6744,140,0,1259,93,47,1.9230769230769231,0.0
2465,284232,121,0,32039,86,35,100.0,0.0
2466,23964,170,0,1467,110,60,100.0,0.0
2467,34308,51,0,1435,38,13,50.0,0.0
2468,6216,14,6216,1116,13,1,12.5,92.75
2469,7992,181,0,2021,125,56,100.0,0.0
2470,34812,45,0,1426,36,9,50.0,0.0
2471,913248,2217,0,10246,1226,991,1.0,0.0
2472,3456,37,0,707,31,6,100.0,0.0
2473,35064,51,0,1507,39,12,50.0,0.0
2474,564,0,564,0,0,0,50.0,45.65
2475,83136,9,804,9454,9,0,14.285714285714286,96.27
2476,35436,48,0,1872,37,11,50.0,0.0
2477,343800,749,0,55616,420,329,3.125,0.0
2478,4452,68,4452,1650,64,4,20.0,17.44
2479,12000,43,0,1208,27,16,100.0,0.0
2480,1356,2,1356,246,2,0,33.333333333333336,42.02
2481,13224,248,0,1107,180,68,1.1235955056179776,0.0
2482,18756,39,0,969,30,9,100.0,0.0
2483,516,19,372,68,18,1,5.0,51.41
2484,707424,719,707424,134482,657,62,1.4492753623188406,0.0
2485,362088,139,308718,94699,139,0,100.0,100.0
2486,26196,37,26196,1220,32,5,4.166666666666667,54.98
2487,108,5,108,14,5,0,12.5,4.75
2488,535392,6,0,94498,5,1,20.0,19.7
2489,216,0,216,0,0,0,100.0,100.0
2490,336,0,336,0,0,0,100.0,100.0
2491,2292,12,2292,445,11,1,12.5,94.79
2492,3144,151,0,951,92,59,100.0,0.0
2493,108,4,108,0,4,0,16.666666666666668,22.2
2494,922500,1393,7068,13497,760,633,1.0869565217391304,0.0
2495,2292,28,2292,11,24,4,4.166666666666667,62.19
2496,3720,95,180,102,74,21,1.5384615384615383,11.31
2497,54432,54,0,3412,45,9,50.0,0.0
2498,3600,39,3600,112,31,8,3.4482758620689653,62.53
2499,15000,12,0,2067,11,1,9.090909090909092,0.0
2500,6012,33,6012,35,31,2,3.125,52.73
2501,74340,19,74340,1320,18,1,5.0,29.61
2502,15336,22,15336,1899,18,4,20.0,92.5
2503,6972,0,6972,0,0,0,50.0,75.0
2504,192,2,192,48,2,0,20.0,58.4
2505,7920,27,7920,15,27,0,3.4482758620689653,51.19
2506,891696,1345,9804,10415,721,624,1.0638297872340423,0.0
2507,8016,395,0,2411,278,117,1.0,0.0
2508,13056,21,13056,395,18,3,5.882352941176471,83.29
2509,2880,31,96,143,21,10,7.6923076923076925,20.71
2510,108,5,108,19,3,2,33.333333333333336,23.84
2511,480,20,480,76,20,0,5.0,34.21
2512,32220,21,0,6141,17,4,3.0303030303030303,0.0
2513,12012,46,0,1248,31,15,100.0,0.0
2514,948792,1668,0,19000,927,741,1.0,0.0
2515,10692,61,10692,1495,58,3,33.333333333333336,13.21
2516,81336,23,81336,1446,22,1,4.166666666666667,0.0
2517,14724,48,0,1179,38,10,50.0,0.0
2518,504,18,504,284,14,4,7.142857142857143,76.67
2519,854664,2332,0,11985,1266,1066,1.0,3.04
2520,66060,14,66060,905,14,0,7.142857142857143,53.09
2521,432,7,432,209,5,2,16.666666666666668,67.78
2522,16284,48,0,1102,35,13,50.0,0.0
2523,27924,46,0,2194,39,7,50.0,0.0
2524,37056,1,37056,108,1,0,50.0,99.96
2525,1380,29,1380,273,27,2,4.0,57.11
2526,96,3,96,32,3,0,20.0,59.36
2527,163500,14,163500,458,12,2,9.090909090909092,40.54
2528,677028,75,677028,73042,64,11,1.96078431372549,20.86
2529,709404,7,0,162130,6,1,25.0,92.43
2530,276,3,276,8,2,1,33.333333333333336,74.19
2531,18456,51,0,1221,40,11,50.0,0.0
2532,840444,1040,0,11629,593,447,1.2658227848101269,0.0
2533,785040,60,0,268937,45,15,33.333333333333336,0.0
2534,18864,49,0,1150,35,14,50.0,0.0
2535,17232,21,17232,1618,17,4,25.0,86.28
2536,30420,50,0,2571,45,5,50.0,0.0
2537,1092,8,1092,450,8,0,11.11111111111111,83.38
2538,5124,55,5124,1339,52,3,33.333333333333336,0.0
2539,70188,23,70188,5064,19,4,7.6923076923076925,46.24
2540,156,0,156,0,0,0,50.0,98.05
2541,45672,50,45672,1997,46,4,14.285714285714286,18.95
2542,14004,11,14004,1902,11,0,25.0,89.02
2543,4740,27,4740,1144,21,6,7.142857142857143,85.79
2544,87528,133,87528,2489,53,80,2.9411764705882355,65.3
2545,990924,22613,92075,145657,12985,9628,1.0,0.0
2546,69504,20,69504,2748,17,3,6.25,1.51
2547,348,2,348,0,2,0,25.0,23.48
2548,288,7,288,186,5,2,16.666666666666668,71.85
2549,39132,28,33744,8223,22,6,10.0,90.62
2550,75108,45,0,2879,28,17,50.0,0.0
2551,3888,61,3888,1400,55,6,14.285714285714286,12.9
2552,38628,86,38628,2203,84,2,1.851851851851852,66.02
2553,936936,40,0,72133,35,5,25.0,0.0
2554,413136,397,0,58265,238,159,1.1764705882352942,0.0
2555,94800,16,94800,652,13,3,7.6923076923076925,42.13
2556,14964,5,444,3134,5,0,16.666666666666668,73.16
2557,1680,91,1680,592,89,2,2.380952380952381,30.37
2558,2628,2,1542,936,2,0,25.0,64.37
2559,1512,64,1512,777,63,1,2.3255813953488373,27.62
2560,1560,0,1560,0,0,0,50.0,56.25
2561,16692,24,0,939,19,5,50.0,0.0
2562,22992,31,60,1491,18,13,14.285714285714286,52.25
2563,35712,79,35712,1152,69,10,2.272727272727273,36.35
2564,840132,25,0,35949,22,3,9.090909090909092,0.0
2565,38748,162,0,2486,121,41,33.333333333333336,0.0
2566,181416,17,122428,5242,11,6,14.285714285714286,0.0
2567,444,11,444,108,7,4,14.285714285714286,71.68
2568,0,0,0,0,0,0,50.0,0.0
2569,19224,51,0,1681,39,12,25.0,0.0
2570,2124,36,0,507,30,6,50.0,0.0
2571,13884,179,0,1657,127,52,100.0,0.0
2572,20880,54,0,2528,40,14,25.0,0.0
2573,12012,46,0,1244,29,17,100.0,0.0
2574,20748,51,0,2226,36,15,25.0,0.0
2575,4032,21,0,515,18,3,100.0,100.0
2576,14628,49,14628,2075,43,6,16.666666666666668,20.79
2577,18000,52,0,1052,39,13,50.0,0.0
2578,787884,812,0,16502,392,420,1.639344262295082,0.0
2579,684,1,0,684,1,0,33.333333333333336,99.98
2580,54072,126,8628,1629,125,1,1.5873015873015872,22.85
2581,10560,3,10560,9920,3,0,20.0,95.91
2582,14172,28,0,1516,24,4,100.0,0.0
2583,805968,1064,0,35740,587,477,1.4705882352941178,0.0
2584,28848,312,0,2199,226,86,1.0638297872340423,0.0
2585,1010604,1398,655908,414637,718,680,1.0,0.0
2586,96,5,96,24,5,0,14.285714285714286,67.88
2587,36180,2,36168,18282,1,1,33.333333333333336,71.15
2588,11940,24,11940,355,22,2,5.2631578947368425,70.85
2589,840,8,840,16,6,2,14.285714285714286,65.81
2590,797304,150,0,78720,109,41,2.631578947368421,44.49
2591,144,85,144,54,65,20,1.694915254237288,24.45
2592,3396,87,3396,1242,86,1,1.7241379310344829,42.32
2593,1860,99,0,181,98,1,100.0,0.0
2594,51936,1,51936,51348,1,0,33.333333333333336,20.0
2595,322860,257,235074,121422,253,4,50.0,0.0
2596,787356,64,787356,28317,56,8,2.127659574468085,26.36
2597,43344,57,43344,720,48,9,2.7777777777777777,61.72
2598,89712,11,89712,533,9,2,14.285714285714286,61.85
2599,13188,84,2184,1050,77,7,2.127659574468085,32.99
2600,276,12,276,68,6,6,20.0,74.37
2601,168,15,168,20,13,2,7.6923076923076925,69.13
2602,436332,748,0,17963,335,413,1.818181818181818,0.0
2603,6816,189,0,1829,130,59,100.0,0.0
2604,18012,164,0,766,97,67,100.0,0.0
2605,1044,20,1044,88,14,6,7.6923076923076925,57.54
2606,1680,2,1680,354,2,0,33.333333333333336,65.16
2607,28020,53,0,2866,37,16,33.333333333333336,0.0
2608,850392,104,0,624343,30,74,1.2345679012345678,0.0
2609,2532,3,2532,148,3,0,20.0,49.96
2610,122232,4,122232,822,4,0,50.0,0.0
2611,243336,52,24852,5628,44,8,3.4482758620689653,60.62
2612,492,16,0,45,15,1,5.882352941176471,5.0
2613,3888,126,0,284,110,16,100.0,0.0
2614,3996,141,3996,2098,138,3,1.098901098901099,19.83
2615,614088,6,73716,140602,3,3,50.0,0.0
2616,769200,161,85236,9946,110,51,2.380952380952381,4.07
2617,44016,47,0,3390,35,12,4.0,0.0
2618,831468,1186,0,27250,681,505,1.2195121951219512,0.0
2619,23016,244,0,953,165,79,100.0,0.0
2620,764928,131,0,66577,71,60,4.166666666666667,0.0
2621,30960,16,30960,1634,14,2,25.0,83.44
2622,35532,10,35532,576,9,1,12.5,65.75
2623,1008900,643,0,259740,478,165,1.0,0.0
2624,18468,385,0,1874,180,205,2.857142857142857,0.0
2625,2268,77,2268,1218,75,2,2.631578947368421,13.19
2626,84,0,84,0,0,0,50.0,80.0
2627,557364,154,0,14182,89,65,6.25,0.0
2628,622692,77,888,8177,61,16,1.818181818181818,40.07
2629,48,11,48,0,11,0,7.6923076923076925,45.76
2630,1014000,1231,452520,115934,687,544,1.0,2.0
2631,36444,16,36444,1358,14,2,10.0,44.66
2632,1164,321,1164,617,180,141,1.0,28.29
2633,0,0,0,0,0,0,100.0,0.0
2634,180,1,180,0,1,0,33.333333333333336,79.03
2635,19320,48,19320,1706,44,4,10.0,23.75
2636,252,11,252,13,7,4,14.285714285714286,56.56
2637,836064,6,0,170014,5,1,14.285714285714286,71.44
2638,56004,35,0,3105,32,3,50.0,0.0
2639,14364,29,14364,900,25,4,4.761904761904762,57.0
2640,180660,49,0,4826,32,17,50.0,0.0
2641,504,16,504,132,16,0,5.555555555555555,39.38
2642,1000200,3059,0,21843,1709,1350,1.0,0.0
2643,103140,172,0,1199,82,90,5.555555555555555,0.0
2644,15684,56,15684,30,50,6,2.0408163265306123,28.46
2645,5616,34,5616,1194,34,0,3.571428571428572,25.37
2646,240072,14,240072,15405,14,0,6.666666666666667,29.54
2647,38940,41,0,2112,35,6,50.0,0.0
2648,84,0,84,0,0,0,50.0,64.72
2649,841260,1090,0,8927,610,480,1.36986301369863,1.0
2650,255036,113,82140,7284,86,27,1.2345679012345678,20.51
2651,33852,39,33852,1314,34,5,33.333333333333336,25.4
2652,65052,2,0,32952,1,1,100.0,0.0
2653,11964,17,11748,4951,15,2,25.0,83.54
2654,4836,9,4836,172,9,0,20.0,90.52
2655,39624,54,0,3160,48,6,50.0,0.0
2656,2736,31,2736,722,28,3,25.0,0.45
2657,600,1,0,600,1,0,50.0,0.0
2658,41364,23,0,2802,22,1,50.0,0.0
2659,2892,10,2892,892,10,0,20.0,83.77
2660,3552,21,3552,468,19,2,6.25,62.93
2661,660,14,660,352,13,1,9.090909090909092,92.4
2662,192,35,192,30,27,8,4.761904761904762,47.9
2663,5556,239,0,2055,161,78,100.0,0.0
2664,32076,55,21786,2198,50,5,11.11111111111111,13.16
2665,180,47,180,44,35,12,3.225806451612903,56.68
2666,485904,1203,11016,8456,749,454,1.0,0.0
2667,1200,7,1200,546,7,0,14.285714285714286,68.77
2668,636,46,636,9,34,12,3.333333333333333,51.63
2669,93156,45,0,5363,30,15,50.0,0.0
2670,12564,106,0,3468,96,10,50.0,0.0
2671,99252,21,99252,838,17,4,6.25,61.19
2672,12168,16,12168,2193,14,2,16.666666666666668,93.04
2673,6348,47,6348,1151,44,3,5.882352941176471,33.91
2674,1044228,4483,242880,37055,2473,2010,1.0,0.0
2675,53568,21,53568,399,19,2,5.555555555555555,66.0
2676,516,14,516,176,12,2,12.5,93.11
2677,300,33,300,65,20,13,8.333333333333334,65.82
2678,2028,28,0,162,21,7,50.0,99.0
2679,504,52,504,297,40,12,3.0303030303030303,51.92
2680,1704,15,1704,601,13,2,12.5,91.95
2681,26856,43,26856,1707,39,4,4.0,55.55
2682,53976,39,53976,1160,32,7,4.3478260869565215,30.0
2683,21708,131,0,703,75,56,100.0,0.0
2684,52164,24,52164,1582,19,5,7.142857142857143,44.89
2685,180,30,144,51,28,2,3.703703703703704,22.66
2686,19764,26,19764,2,24,2,4.0,55.28
2687,4668,224,0,1554,133,91,100.0,0.0
2688,10116,14,10116,1716,14,0,12.5,93.43
2689,389076,1832,0,9759,1024,808,1.0,0.0
2690,420,8,420,150,8,0,12.5,96.53
2691,5484,84,0,1250,63,21,50.0,99.97
2692,173496,111,0,3372,63,48,4.545454545454546,0.0
2693,66456,8,66456,94,7,1,20.0,15.32
2694,84,36,84,21,28,8,3.8461538461538463,30.22
2695,156,0,156,0,0,0,50.0,60.45
2696,828,14,828,423,13,1,11.11111111111111,92.46
2697,96,19,96,25,13,6,11.11111111111111,43.65
2698,1015236,391,0,6366,198,193,2.9411764705882355,0.0
2699,67716,9,67716,224,9,0,10.0,19.32
2700,489480,303,0,6783,160,143,3.8461538461538463,0.0
2701,960,1,960,108,1,0,33.333333333333336,22.79
2702,27504,25,0,2241,21,4,100.0,0.0
2703,4296,77,4296,109,63,14,1.851851851851852,9.27
2704,1092,145,1092,310,63,82,4.166666666666667,55.84
2705,69096,18,69096,1256,18,0,5.555555555555555,25.84
2706,11172,66,11172,1042,30,36,4.545454545454546,0.07
2707,68916,3,68916,220,3,0,20.0,72.61
2708,13296,20,13296,1000,16,4,7.6923076923076925,76.97
2709,12024,41,0,1288,26,15,100.0,0.0
2710,23964,31,23964,886,27,4,4.545454545454546,76.81
2711,5520,272,0,880,180,92,100.0,0.0
2712,1656,18,1590,528,18,0,4.761904761904762,0.6
2713,3552,115,0,1341,85,30,100.0,0.0
2714,2052,7,2052,744,6,1,16.666666666666668,0.0
2715,71652,7,71652,1357,6,1,20.0,21.81
2716,72720,15,72720,1480,10,5,16.666666666666668,13.16
2717,410904,0,399876,0,0,0,12.5,0.0
2718,527796,443,0,4587,235,208,2.4390243902439024,5.0
2719,1042512,7332,0,51637,4224,3108,1.0,0.0
2720,11388,33,11388,1209,29,4,4.761904761904762,66.17
2721,103908,22,103908,101721,22,0,12.5,99.93
2722,32508,7,32508,980,7,0,14.285714285714286,73.11
2723,1056,7,1056,416,6,1,20.0,11.75
2724,340944,26,340944,21677,21,5,7.6923076923076925,38.93
2725,1068,0,1068,0,0,0,100.0,100.0
2726,32280,48,32280,165,46,2,3.225806451612903,0.0
2727,77604,10,0,9849,6,4,100.0,0.0
2728,52224,41,0,3864,35,6,100.0,0.0
2729,10236,36,8004,1305,32,4,4.166666666666667,62.05
2730,814176,337,0,6319,166,171,2.857142857142857,3.97
2731,79428,7,79428,250,6,1,20.0,21.26
2732,35112,26,35112,4,26,0,3.571428571428572,50.55
2733,1028988,3857,0,30575,2250,1607,1.0,4.0
2734,45228,42,45228,1087,33,9,3.0303030303030303,20.35
2735,336,4,336,12,3,1,25.0,72.7
2736,808296,12,0,279908,12,0,25.0,50.92
2737,12012,48,0,1484,32,16,100.0,0.0
2738,31596,400,0,597,168,232,3.8461538461538463,0.0
2739,643812,53,0,14686,46,7,33.333333333333336,0.0
2740,16356,9,16356,2276,9,0,20.0,98.11
2741,9252,21,9252,760,18,3,6.666666666666667,74.43
2742,160164,214,160164,24896,110,104,10.0,94.04
2743,30360,42,0,2002,39,3,50.0,0.0
2744,8340,29,8340,1182,25,4,5.2631578947368425,67.08
2745,94896,44,94896,2780,40,4,3.0303030303030303,18.87
2746,738132,59,738132,96434,55,4,1.96078431372549,23.07
2747,29076,53,29076,2408,48,5,9.090909090909092,13.17
2748,450228,2,0,235740,2,0,20.0,95.13
2749,368160,83,176706,85837,82,1,1.818181818181818,93.19
2750,121464,49,0,24428,40,9,20.0,0.58
2751,48444,18,48444,892,15,3,9.090909090909092,49.71
2752,406176,211,0,8111,102,109,5.555555555555555,0.0
2753,120,56,120,22,35,21,4.166666666666667,49.33
2754,3120,9,3120,333,9,0,16.666666666666668,97.71
2755,6204,22,6204,677,19,3,6.25,66.97
2756,12012,45,0,1384,30,15,100.0,0.0
2757,9408,7,0,1472,5,2,20.0,0.0
2758,11724,22,11724,1065,19,3,6.666666666666667,71.22
2759,516,4,516,24,2,2,50.0,59.51
2760,76872,48,0,2351,35,13,50.0,0.0
2761,468,26,468,22,16,10,7.6923076923076925,58.1
2762,77196,54,0,2116,40,14,50.0,0.0
2763,13932,43,0,1829,42,1,50.0,0.0
2764,756,0,756,0,0,0,33.333333333333336,0.96
2765,335700,25,335700,11064,20,5,6.25,45.53
2766,6696,15,6696,1450,14,1,14.285714285714286,96.54
2767,1920,39,0,646,34,5,100.0,100.0
2768,3288,17,0,391,15,2,100.0,0.0
2769,1088196,7941,0,340708,4487,3454,1.0,0.0
2770,77580,123,0,1518,54,69,12.5,2.38
2771,1033692,84,593019,590774,83,1,100.0,100.0
2772,12012,42,0,1222,27,15,100.0,0.0
2773,3612,111,0,1201,81,30,100.0,0.0
2774,252,1,252,12,1,0,50.0,90.01
2775,768,17,0,251,14,3,100.0,0.0
2776,333240,84,0,10352,72,12,20.0,0.0
2777,46128,34,46128,730,30,4,3.8461538461538463,71.64
2778,49980,41,49980,1025,38,3,7.6923076923076925,16.62
2779,69576,7,69576,713,5,2,14.285714285714286,87.08
2780,931512,11,76536,174272,8,3,4.761904761904762,0.0
2781,39960,46,39960,619,37,9,100.0,0.0
2782,53580,9,53580,50,8,1,11.11111111111111,68.51
2783,38124,19,38124,2146,16,3,9.090909090909092,53.35
2784,88164,97,88164,6146,43,54,5.555555555555555,56.18
2785,120,13,120,14,13,0,6.666666666666667,56.11
2786,15960,181,0,2419,114,67,100.0,0.0
2787,912,143,912,91,135,8,1.0,41.55
2788,887160,388,0,7620,197,191,3.571428571428572,0.0
2789,79812,24,120,3399,18,6,6.25,38.26
2790,93792,55,0,2798,43,12,50.0,0.0
2791,94344,51,0,2721,40,11,50.0,0.0
2792,17364,48,0,1170,38,10,50.0,0.0
2793,18420,186,0,2342,122,64,100.0,0.0
2794,12000,38,0,1330,25,13,100.0,0.0
2795,17772,46,0,1501,37,9,50.0,0.0
2796,324,3,324,104,3,0,20.0,68.79
2797,8760,57,8760,1670,56,1,2.631578947368421,20.83
2798,1094760,2498,827724,106170,1704,794,1.0,0.0
2799,1440,4,0,390,4,0,20.0,0.0
2800,17712,294,708,452,164,130,1.098901098901099,0.0
2801,29784,46,29784,1874,43,3,16.666666666666668,13.37
2802,20580,15,20580,4579,13,2,20.0,97.61
2803,36,2,0,36,2,0,33.333333333333336,0.0
2804,3252,89,3252,144,51,38,2.857142857142857,77.57
2805,165492,20,165492,152434,19,1,7.142857142857143,94.49
2806,21828,21,21828,455,19,2,5.555555555555555,71.14
2807,4428,133,4428,771,109,24,1.3888888888888888,30.33
2808,180,0,180,0,0,0,50.0,58.4
2809,3216,142,0,956,85,57,100.0,0.0
2810,372,46,372,98,44,2,2.380952380952381,54.15
2811,1096932,4745,0,163124,2631,2114,1.0,0.27
2812,111396,28,111396,937,23,5,5.882352941176471,67.28
2813,5268,26,5268,640,25,1,8.333333333333334,47.35
2814,900180,152,0,42536,82,70,3.571428571428572,20.0
2815,26508,31,0,1816,26,5,100.0,0.0
2816,1050684,2113,0,61340,1192,921,1.0,0.0
2817,4956,186,0,1352,116,70,100.0,0.0
2818,57840,21,57840,836,17,4,7.142857142857143,35.85
2819,64128,142,0,2894,90,52,2.0408163265306123,4.0
2820,5436,15,5436,1194,13,2,12.5,97.96
2821,23568,6,23568,114,6,0,12.5,0.0
2822,921948,22,17844,82696,19,3,6.666666666666667,80.44
2823,647724,337,0,16763,168,169,5.0,0.0
2824,260952,127,260952,7493,39,88,7.6923076923076925,0.0
2825,12012,39,0,1293,24,15,100.0,0.0
2826,266952,14,266952,21557,6,8,16.666666666666668,87.91
2827,144,6,144,74,6,0,12.5,62.42
2828,828,0,828,0,0,0,50.0,77.0
2829,5160,31,5160,1306,31,0,14.285714285714286,11.2
2830,3576,12,3576,607,12,0,7.142857142857143,56.54
2831,995856,1586,0,16143,801,785,1.0,0.0
2832,900,5,900,223,5,0,14.285714285714286,20.38
2833,161112,108,0,4713,42,66,9.090909090909092,2.0
2834,2124,3,0,1484,2,1,25.0,97.79
2835,108,6,108,0,6,0,12.5,71.85
2836,1272,1,1272,984,1,0,20.0,70.02
2837,264,4,264,9,4,0,16.666666666666668,53.49
2838,6492,4,6492,4122,2,2,50.0,69.74
2839,4272,7,4272,1899,6,1,14.285714285714286,67.94
2840,94656,105,0,1071,94,11,100.0,0.0
2841,1116396,2286,433226,304638,1227,1059,1.0,21.52
2842,15588,2,15588,1260,2,0,20.0,93.95
2843,135684,12,0,12779,10,2,100.0,0.0
2844,8616,37,8616,1182,33,4,3.703703703703704,60.41
2845,252552,0,252552,0,0,0,100.0,100.0
2846,156,5,0,115,4,1,100.0,0.0
2847,2052,52,2052,470,38,14,2.631578947368421,26.47
2848,1121892,687,0,109127,369,318,1.0,5.58
2849,84,12,84,14,10,2,10.0,51.83
2850,132,49,120,26,45,4,2.272727272727273,33.48
2851,504,4,0,273,3,1,100.0,0.0
2852,480,11,480,122,10,1,9.090909090909092,17.74
2853,339348,5,76776,206323,4,1,33.333333333333336,70.0
2854,918912,15,3024,62003,14,1,14.285714285714286,96.06
2855,45564,45,29298,1962,41,4,12.5,23.81
2856,552,30,552,101,30,0,3.125,73.01
2857,936216,1513,0,19785,821,692,1.1494252873563218,0.28
2858,276,10,0,64,6,4,100.0,0.0
2859,9432,139,0,1719,81,58,33.333333333333336,98.0
2860,914844,40,914844,18655,28,12,4.166666666666667,32.95
2861,7080,43,7080,1113,41,2,6.25,26.8
2862,1123668,9653,44106,64122,5426,4227,1.0,0.0
2863,11988,5,11988,6278,5,0,14.285714285714286,91.48
2864,22416,5,22416,6184,3,2,25.0,99.11
2865,137100,38,0,15663,19,19,100.0,0.0
2866,1908,2,192,1002,2,0,33.333333333333336,79.6
2867,252,1,252,60,1,0,33.333333333333336,78.67
2868,768,26,768,188,24,2,4.166666666666667,55.21
2869,1021884,812,0,5013,458,354,1.408450704225352,0.0
2870,372,12,372,77,12,0,7.142857142857143,10.0
2871,13992,1,13992,0,1,0,33.333333333333336,99.51
2872,588,34,588,13,26,8,4.166666666666667,61.46
2873,247284,335,0,4531,187,148,1.851851851851852,4.0
2874,1114716,1262,0,10375,702,560,1.0101010101010102,0.0
2875,660,92,660,46,68,24,1.7241379310344829,10.92
2876,1104,47,1104,28,35,12,3.225806451612903,51.37
2877,376752,357,0,1844,196,161,2.1739130434782608,0.0
2878,180,3,180,124,3,0,20.0,56.03
2879,11724,28,192,444,24,4,4.3478260869565215,27.74
2880,1344,19,0,322,11,8,16.666666666666668,0.0
2881,1024536,37,385404,477572,19,18,2.631578947368421,0.0
2882,0,0,0,0,0,0,20.0,0.0
2883,14316,41,0,1596,27,14,100.0,0.0
2884,1872,1,0,1872,1,0,16.666666666666668,0.0
2885,5700,32,5700,1530,31,1,3.333333333333333,40.16
2886,59172,49,0,2869,44,5,50.0,0.0
2887,0,0,0,0,0,0,50.0,7.0
2888,832236,322,0,9459,175,147,2.380952380952381,0.0
2889,1015656,118,0,30253,52,66,4.545454545454546,5.0
2890,34968,34,34968,994,31,3,3.8461538461538463,72.8
2891,1452,73,1452,1267,53,20,2.2222222222222223,60.64
2892,432,8,432,82,4,4,25.0,77.92
2893,268692,3,268692,59088,3,0,25.0,99.9
2894,805644,157,0,20746,69,88,12.5,0.0
2895,8928,138,0,534,115,23,100.0,0.0
2896,96,0,96,0,0,0,50.0,64.0
2897,72,13,72,6,12,1,7.6923076923076925,45.82
2898,2616,24,2616,424,20,4,5.555555555555555,70.55
2899,1073292,0,1073292,0,0,0,100.0,100.0
2900,509976,616,0,9489,353,263,1.9230769230769231,0.0
2901,368520,5,368520,60064,4,1,16.666666666666668,64.61
2902,702276,357,0,9622,195,162,2.5,0.0
2903,4632,144,0,1365,92,52,100.0,0.0
2904,51432,22,21048,3780,18,4,6.25,88.24
2905,2580,19,0,630,14,5,100.0,0.0
2906,65616,47,0,3640,43,4,50.0,0.0
2907,80448,10,80448,0,10,0,8.333333333333334,70.13
2908,1133592,641,0,88041,385,256,1.0,2.97
2909,1536,36,0,559,30,6,100.0,0.0
2910,658104,453,0,4697,221,232,2.4390243902439024,0.0
2911,35148,47,0,1371,35,12,50.0,0.0
2912,276,12,276,104,8,4,16.666666666666668,20.29
2913,400524,2,0,400488,1,1,20.0,0.0
2914,35736,48,0,1356,34,14,50.0,0.0
2915,192,2,192,102,2,0,33.333333333333336,25.94
2916,36156,50,0,1427,36,14,50.0,0.0
2917,192024,55,0,6324,42,13,50.0,0.0
2918,13188,17,13188,2465,17,0,12.5,94.08
2919,87408,26,87408,2026,21,5,6.666666666666667,42.29
2920,85908,0,85908,0,0,0,12.5,0.0
2921,240,1,240,120,1,0,33.333333333333336,66.0
2922,4476,2,4476,1362,2,0,33.333333333333336,66.22
2923,23580,55,23580,2282,50,5,2.380952380952381,58.5
2924,12000,49,0,1391,34,15,100.0,0.0
2925,2592,56,0,964,46,10,50.0,99.0
2926,39672,41,0,1527,33,8,100.0,0.0
2927,612,4,612,39,3,1,25.0,31.7
2928,6048,48,6048,1185,41,7,5.0,25.73
2929,132,0,132,0,0,0,50.0,64.0
2930,516,29,516,182,26,3,4.761904761904762,75.59
2931,196776,161,0,3478,83,78,3.8461538461538463,1.5
2932,26928,4,26928,177,2,2,25.0,88.64
2933,3744,15,3744,864,13,2,16.666666666666668,91.95
2934,72,2,72,0,2,0,25.0,62.61
2935,900,77,900,18,77,0,2.3255813953488373,58.54
2936,1080,108,0,162,96,12,100.0,0.0
2937,402156,219,0,5085,98,121,3.125,0.0
2938,228,5,228,60,3,2,33.333333333333336,23.31
2939,69948,13,69948,1076,12,1,9.090909090909092,55.06
2940,1152,0,1152,0,0,0,50.0,91.5
2941,204,20,204,28,17,3,6.25,17.96
2942,1404,1,1404,108,1,0,50.0,99.98
2943,139692,11,0,19604,8,3,11.11111111111111,5.0
2944,2484,12,2484,727,12,0,20.0,93.94
2945,372,2,372,0,2,0,33.333333333333336,62.75
2946,264,17,264,8,16,1,5.882352941176471,89.32
2947,21756,27,21756,11,25,2,3.8461538461538463,54.42
2948,37824,492,0,6235,263,229,50.0,0.0
2949,576696,46,0,24914,35,11,50.0,0.0
2950,1068,12,1068,304,11,1,12.5,93.55
2951,363060,250,0,2781,118,132,3.125,4.0
2952,25740,140,25740,2609,67,73,9.090909090909092,85.77
2953,72,37,72,6,33,4,3.0303030303030303,29.9
2954,678144,200,0,4089,93,107,7.6923076923076925,3.0
2955,2580,11,2580,676,5,6,16.666666666666668,0.0
2956,1008,10,1008,295,10,0,11.11111111111111,92.81
2957,1144644,7294,256530,225077,4529,2765,1.0,0.0
2958,72,6,72,12,4,2,25.0,22.15
2959,19668,82,0,2806,53,29,7.6923076923076925,0.0
2960,636,0,636,0,0,0,50.0,59.29
2961,30300,174,0,1027,77,97,3.703703703703704,0.0
2962,855396,198,0,5676,99,99,4.0,11.74
2963,927552,277,0,12007,132,145,3.8461538461538463,0.0
2964,720,0,720,0,0,0,50.0,87.25
2965,66912,202,0,1115,95,107,3.703703703703704,0.0
2966,108,0,108,0,0,0,100.0,100.0
2967,216,49,216,22,29,20,4.761904761904762,59.93
2968,1716,2,1716,0,2,0,16.666666666666668,73.6
2969,12468,43,0,1474,28,15,100.0,0.0
2970,1080,120,1080,187,58,62,3.571428571428572,27.6
2971,492,1,492,108,1,0,33.333333333333336,99.4
2972,963432,1038,0,87974,545,493,1.3157894736842106,0.0
2973,2988,16,2988,1427,15,1,12.5,92.11
2974,1082064,289,0,237649,137,152,2.702702702702702,0.0
2975,29328,36,29328,113,32,4,3.225806451612903,50.13
2976,844368,2232,0,7152,1632,600,1.0,0.0
2977,957084,1828,0,10833,1014,814,1.0,2.0
2978,9600,20,9600,1032,20,0,4.545454545454546,58.72
2979,2568,14,2568,899,9,5,10.0,60.0
2980,264,7,264,87,6,1,25.0,63.44
2981,881616,126,881616,7686,62,64,14.285714285714286,0.0
2982,20904,18,20904,410,15,3,7.142857142857143,86.89
2983,860508,114,0,18618,50,64,7.142857142857143,0.0
2984,588,38,588,16,30,8,3.571428571428572,52.05
2985,1146336,11372,95604,89881,6581,4791,1.0,0.0
2986,4224,19,0,353,16,3,100.0,100.0
2987,1156080,1326,0,77425,733,593,1.408450704225352,0.0
2988,420,6,420,20,3,3,50.0,74.56
2989,1036200,439,0,20903,223,216,2.5641025641025643,0.0
2990,733368,623,0,7037,316,307,2.272727272727273,4.23
2991,128448,54,0,3868,45,9,50.0,0.0
2992,375060,444,0,2044,225,219,1.7543859649122806,2.0
2993,85164,46,0,1991,25,21,14.285714285714286,0.0
2994,204,13,156,66,10,3,9.090909090909092,21.69
2995,26424,22,26424,535,19,3,5.882352941176471,85.88
2996,756,0,756,0,0,0,100.0,100.0
2997,1512,14,1512,503,14,0,11.11111111111111,86.79
2998,10212,38,0,1262,24,14,100.0,0.0
2999,1272,126,780,52,106,20,1.0309278350515465,5.34
3000,29424,79,29424,1377,67,12,2.1739130434782608,58.44
3001,1137756,3261,0,139243,1744,1517,1.0,0.0
3002,11064,21,0,1218,17,4,100.0,0.0
3003,80292,38,0,5525,36,2,50.0,0.0
3004,76356,196,65654,12279,84,112,3.703703703703704,0.0
3005,1116,9,1116,252,6,3,20.0,88.24
3006,106092,19,106092,1498,17,2,6.25,46.35
3007,50136,0,50136,0,0,0,50.0,85.0
3008,396,18,396,20,10,8,25.0,67.84
3009,708,22,708,164,18,4,14.285714285714286,87.35
3010,38124,31,38124,608,30,1,10.0,31.64
3011,888,12,888,416,10,2,12.5,90.06
3012,811716,63,811716,18358,56,7,2.9411764705882355,24.4
3013,132,84,132,10,72,12,1.492537313432836,25.57
3014,241824,30,241824,20486,24,6,5.2631578947368425,44.09
3015,516,83,516,127,56,27,2.3255813953488373,64.19
3016,852,13,852,397,11,2,16.666666666666668,89.58
3017,408,6,408,68,5,1,16.666666666666668,25.33
3018,5736,15,5736,2002,4,11,33.333333333333336,99.98
3019,258240,54,0,13159,45,9,100.0,0.0
3020,1572,10,612,457,9,1,14.285714285714286,90.06
3021,133452,112,0,4466,58,54,4.166666666666667,3.5
3022,9876,210,0,1327,119,91,100.0,0.0
3023,2856,83,0,1061,64,19,100.0,0.0
3024,791208,191,0,8992,93,98,3.703703703703704,0.0
3025,1644,33,0,699,16,17,50.0,0.0
3026,3132,12,3132,68,12,0,12.5,71.54
3027,91512,660,0,2007,379,281,1.0,0.0
3028,708,1,708,300,1,0,50.0,47.14
3029,50976,142,50976,7720,68,74,5.882352941176471,76.64
3030,120,4,120,42,2,2,50.0,22.61
3031,1932,40,0,691,33,7,100.0,0.0
3032,1177500,17449,0,479020,9890,7559,1.0,0.0
3033,1056,3,1056,104,2,1,33.333333333333336,37.8
3034,236856,2,236856,118512,1,1,50.0,79.72
3035,791244,2273,10296,6381,1378,895,1.0,0.0
3036,2028,0,2028,0,0,0,100.0,100.0
3037,77676,20,77676,4049,17,3,8.333333333333334,43.39
3038,4380,16,132,346,15,1,6.25,67.14
3039,39732,42,0,2152,28,14,50.0,0.0
3040,192,17,192,110,5,12,33.333333333333336,77.9
3041,336,20,336,123,20,0,6.666666666666667,77.66
3042,3096,67,0,981,55,12,50.0,0.0
3043,36972,108,36972,1886,89,19,1.7241379310344829,40.42
3044,41256,17,0,3307,16,1,50.0,0.0
3045,660,0,660,0,0,0,50.0,64.0
3046,580080,82,580080,17927,50,32,7.142857142857143,0.0
3047,84,15,84,12,15,0,5.882352941176471,49.36
3048,427596,289,371064,29868,133,156,2.857142857142857,0.0
3049,106488,21,106488,4406,20,1,4.761904761904762,35.2
3050,2016,6,2016,1440,2,4,50.0,99.7
3051,1002876,46,0,68985,40,6,25.0,0.0
3052,96,56,84,33,34,22,3.8461538461538463,51.22
3053,1182240,4852,0,252330,2743,2109,1.0,0.0
3054,4704,207,0,1576,114,93,100.0,0.0
3055,947472,701,0,9210,364,337,1.8867924528301887,0.0
3056,192,17,192,5,16,1,5.882352941176471,55.69
3057,12264,49,12264,1717,48,1,11.11111111111111,11.94
3058,240,116,216,21,98,18,1.1111111111111112,14.17
3059,1128,104,1128,145,94,10,1.1764705882352942,0.0
3060,468,41,468,123,35,6,3.225806451612903,81.42
3061,108,34,108,26,23,11,7.142857142857143,32.22
3062,29316,32,29316,883,30,2,4.0,72.85
3063,192,9,192,42,8,1,11.11111111111111,18.24
3064,5232,30,5232,632,28,2,3.8461538461538463,88.34
3065,1968,27,1968,567,26,1,12.5,62.73
3066,264,19,264,50,19,0,4.545454545454546,23.73
3067,1069812,397,0,66406,153,244,2.3255813953488373,0.0
3068,38868,19,38868,1018,16,3,8.333333333333334,50.28
3069,20124,225,0,2199,156,69,100.0,0.0
3070,276480,112,170172,22915,77,35,1.8867924528301887,11.85
3071,77280,194,77280,6444,192,2,3.0303030303030303,18.48
3072,144,272,144,41,168,104,1.075268817204301,28.78
3073,346620,2435,0,54461,1305,1130,1.0,2.66
3074,54360,41,46224,10005,39,2,2.5641025641025643,17.95
3075,364104,3102,302172,31738,1632,1470,1.0,0.0
3076,72468,281,72468,5466,273,8,1.162790697674419,23.78
3077,10632,343,10632,5769,340,3,1.0,25.5
3078,6072,218,0,2133,148,70,1.5384615384615383,0.0
3079,106500,260,12132,2948,257,3,1.0,18.46
3080,386064,1217,386064,54144,927,290,1.0,7.59
3081,4920,11,4920,566,11,0,7.6923076923076925,26.52
3082,492,153,492,51,125,28,1.0,19.2
3083,80760,37,80760,965,34,3,2.857142857142857,25.78
3084,85632,73,85632,5306,64,9,1.5384615384615383,19.18
3085,600,1,0,600,1,0,50.0,0.0
3086,38676,15,0,3298,12,3,100.0,0.0
3087,367332,33,0,21944,27,6,33.333333333333336,0.0
3088,75300,9,75300,218,7,2,12.5,52.99
3089,692880,120,0,10857,66,54,3.8461538461538463,0.0
3090,29280,12,29280,330,10,2,9.090909090909092,84.69
3091,352068,403,0,19985,206,197,2.702702702702702,10.0
3092,10212,45,0,1650,29,16,100.0,0.0
3093,96,11,96,24,11,0,7.6923076923076925,47.26
3094,909408,9,0,303470,4,5,33.333333333333336,99.18
3095,264,2,264,30,1,1,50.0,58.62
3096,3156,31,3156,677,30,1,5.882352941176471,18.65
3097,0,0,0,0,0,0,50.0,99.17
3098,434796,182,0,8583,83,99,9.090909090909092,3.0
3099,1190448,697,0,21261,401,296,1.0,0.0
3100,226392,377,0,3077,201,176,1.4492753623188406,3.0
3101,636,2,636,60,2,0,25.0,24.37
3102,777768,615,0,7044,329,286,1.6129032258064515,0.0
3103,31236,54,31236,76,52,2,1.8867924528301887,0.0
3104,72,11,72,5,10,1,9.090909090909092,49.02
3105,230016,133,0,11482,70,63,6.666666666666667,0.0
3106,1488,127,1488,263,106,21,1.1235955056179776,18.3
3107,108,0,108,0,0,0,50.0,57.76
3108,1036644,353,0,12792,214,139,1.3157894736842106,3.0
3109,324,15,324,118,15,0,5.882352941176471,60.8
3110,180,4,180,66,3,1,33.333333333333336,96.09
3111,144,52,132,39,44,8,2.4390243902439024,11.19
3112,46452,39,0,4431,20,19,20.0,5.0
3113,475212,15,0,55595,8,7,33.333333333333336,0.0
3114,120,7,120,32,4,3,33.333333333333336,29.03
3115,41484,252,0,739,129,123,1.96078431372549,0.0
3116,34296,4,34296,96,2,2,50.0,57.56
3117,43344,136,0,983,122,14,100.0,0.0
3118,240,39,240,62,23,16,5.882352941176471,1.02
3119,68640,33,68640,8060,32,1,10.0,14.07
3120,420,7,420,252,7,0,11.11111111111111,97.2
3121,144,5,144,0,5,0,14.285714285714286,62.0
3122,1056,0,768,0,0,0,100.0,100.0
3123,1584,212,1584,220,163,49,1.0,20.05
3124,1131096,848,0,91517,423,425,1.0309278350515465,5.0
3125,902856,2125,0,189349,980,1145,1.0,0.0
3126,2640,137,2640,765,124,13,1.1235955056179776,70.88
3127,204,13,204,15,13,0,6.666666666666667,0.0
3128,733644,552,0,93529,264,288,1.25,0.01
3129,60,16,60,6,14,2,7.142857142857143,45.67
3130,492,43,492,11,41,2,2.380952380952381,42.62
3131,312,0,312,0,0,0,50.0,96.04
3132,180,2,180,72,1,1,33.333333333333336,26.46
3133,636,77,636,28,65,12,1.639344262295082,28.12
3134,53628,221,0,2818,121,100,2.0408163265306123,0.0
3135,840,43,840,6,39,4,2.5641025641025643,39.91
3136,432,4,432,300,4,0,16.666666666666668,70.32
3137,307188,5,0,91416,4,1,14.285714285714286,0.0
3138,1112016,1198,0,8633,650,548,1.1111111111111112,3.57
3139,1428,52,1428,31,46,6,2.2222222222222223,33.99
3140,6924,19,6924,3153,18,1,5.2631578947368425,75.46
3141,814068,302,0,5221,194,108,1.0,0.0
3142,624,37,624,6,31,6,3.333333333333333,60.57
3143,84,47,48,9,45,2,2.0,19.67
3144,14832,2,14832,474,1,1,50.0,99.99
3145,55428,88,55428,2143,70,18,1.492537313432836,21.75
3146,636,42,636,106,36,6,3.0303030303030303,46.65
3147,120,10,120,31,8,2,12.5,19.14
3148,701280,605,0,7917,329,276,1.7543859649122806,2.0
3149,86532,5,86532,1389,5,0,14.285714285714286,82.09
3150,2976,1,2124,252,1,0,33.333333333333336,99.71
3151,8232,11,8232,2031,11,0,7.6923076923076925,0.0
3152,732924,52,0,78249,35,17,5.555555555555555,0.0
3153,1203276,2834,0,93922,1619,1215,1.0,2.0
3154,50820,11,50820,22346,10,1,10.0,34.11
3155,360,138,336,97,102,36,1.639344262295082,49.71
3156,5436,156,324,120,129,27,1.020408163265306,26.4
3157,432,20,432,310,13,7,11.11111111111111,41.86
3158,180,0,180,0,0,0,50.0,56.25
3159,18480,19,18480,1030,18,1,6.25,83.76
3160,8124,166,0,625,137,29,100.0,0.0
3161,278748,6,60,46478,6,0,16.666666666666668,88.99
3162,984,1,984,576,1,0,50.0,80.13
3163,11160,25,11160,452,24,1,5.555555555555555,72.37
3164,1158504,50,0,92040,33,17,25.0,0.0
3165,1201944,115,0,585002,53,62,1.0,0.0
3166,9984,2,9984,3144,1,1,100.0,100.0
3167,1206456,812,355818,251675,811,1,1.0,13.25
3168,4776,37,4776,114,33,4,3.0303030303030303,45.99
3169,1200,195,408,182,125,70,1.0416666666666667,30.1
3170,5220,47,5220,37,36,11,3.125,55.61
3171,5976,36,5976,359,34,2,2.857142857142857,68.48
3172,1056,9,948,512,8,1,14.285714285714286,21.23
3173,3996,5,3996,698,5,0,25.0,88.05
3174,424932,350,0,4798,192,158,1.8867924528301887,0.0
3175,540720,359,0,14041,197,162,1.8867924528301887,0.31
3176,2220,4,2220,1764,2,2,33.333333333333336,90.12
3177,48,11,48,13,8,3,14.285714285714286,32.28
3178,4368,32,0,382,25,7,100.0,0.0
3179,497712,311,0,11278,161,150,2.4390243902439024,0.0
3180,2328,9,2328,856,7,2,16.666666666666668,91.94
3181,241788,415,0,2345,269,146,1.0,0.0
3182,312960,96,312720,10970,55,41,25.0,8.62
3183,1211472,2824,0,438091,1580,1244,1.0,0.0
3184,2952,143,0,426,119,24,100.0,0.0
3185,3000,34,3000,559,34,0,3.225806451612903,80.4
3186,345348,43,345348,2863,30,13,4.0,23.69
3187,10080,57,10080,13,47,10,2.272727272727273,60.37
3188,72,13,72,31,7,6,100.0,100.0
3189,85320,18,85320,30440,7,11,16.666666666666668,83.18
3190,11928,63,0,2134,39,24,16.666666666666668,0.0
3191,324,66,288,159,40,26,3.4482758620689653,57.3
3192,18456,41,17964,3701,30,11,4.545454545454546,0.0
3193,1548,7,1548,147,7,0,16.666666666666668,91.88
3194,60,10,60,34,5,5,100.0,100.0
3195,240,0,240,0,0,0,100.0,100.0
3196,5004,16,5004,795,13,3,9.090909090909092,19.37
3197,28716,33,0,2303,31,2,50.0,0.0
3198,6204,32,6204,1367,32,0,3.571428571428572,35.53
3199,48,22,48,25,13,9,20.0,85.42
3200,108,5,108,60,3,2,33.333333333333336,98.97
3201,913080,226,0,7712,113,113,2.7777777777777777,0.0
3202,900,4,900,531,2,2,100.0,100.0
3203,60,21,60,38,16,5,6.666666666666667,85.75
3204,986196,390,0,42470,156,234,1.818181818181818,0.0
3205,1210596,506,0,19181,287,219,2.702702702702702,0.0
3206,564,78,108,108,55,23,3.333333333333333,71.55
3207,1177632,678,0,5405,385,293,1.2820512820512822,0.0
3208,648,1,0,648,0,1,50.0,0.0
3209,145704,807,0,2636,467,340,1.0,0.0
3210,320580,502,0,3820,268,234,1.1764705882352942,0.0
3211,1207428,226,0,372383,158,68,1.25,0.0
3212,1028460,332,0,172287,191,141,1.5151515151515151,0.0
3213,1212,22,1212,882,22,0,3.8461538461538463,2.29
3214,1284,83,612,192,79,4,1.408450704225352,69.07
3215,538044,14,274326,79248,14,0,6.25,0.0
3216,111708,0,111708,0,0,0,50.0,72.81
3217,876408,17,0,110631,8,9,9.090909090909092,0.0
3218,993144,728,0,18525,391,337,1.25,3.0
3219,240,65,240,86,44,21,2.857142857142857,41.52
3220,348,21,240,141,21,0,4.545454545454546,54.95
3221,42000,110,0,3281,44,66,8.333333333333334,0.0
3222,812928,154,0,12743,66,88,7.142857142857143,0.0
3223,6252,30,6252,10,28,2,3.4482758620689653,70.51
3224,1020744,921,0,16941,501,420,1.162790697674419,1.3
3225,808068,286,0,9486,143,143,2.857142857142857,4.0
3226,1632,5,1632,664,4,1,20.0,68.27
3227,364032,93,0,32505,46,47,4.761904761904762,0.0
3228,379608,436,0,3635,224,212,1.4285714285714286,0.0
3229,862356,7,862356,5249,6,1,14.285714285714286,33.57
3230,867264,327,0,19728,181,146,2.4390243902439024,2.0
3231,9348,24,9348,1689,24,0,4.166666666666667,37.79
3232,552,0,552,0,0,0,33.333333333333336,55.46
3233,264,13,264,7,11,2,9.090909090909092,59.87
3234,757440,1343,0,9106,724,619,1.0,0.0
3235,1632,68,1632,251,60,8,1.96078431372549,26.19
3236,180,27,180,24,15,12,20.0,25.12
3237,588,3,588,236,2,1,33.333333333333336,78.09
3238,186792,13,23424,36040,12,1,7.6923076923076925,0.0
3239,12228,26,11928,8304,17,9,10.0,76.06
3240,1188,0,1188,0,0,0,50.0,83.33
3241,2796,12,240,384,11,1,8.333333333333334,38.28
3242,55572,69,0,1769,55,14,50.0,0.0
3243,180,0,180,0,0,0,100.0,100.0
3244,121200,338,0,1695,180,158,2.127659574468085,0.0
3245,2892,24,2892,1425,15,9,9.090909090909092,87.06
3246,52632,21,0,6750,18,3,100.0,0.0
3247,17268,81,0,936,54,27,100.0,0.0
3248,996,104,996,12,92,12,1.1363636363636365,18.13
3249,54408,19,54408,1376,15,4,12.5,94.92
3250,876,17,0,412,16,1,50.0,0.0
3251,9324,155,0,586,69,86,5.555555555555555,3.0
3252,14940,5,14940,192,5,0,14.285714285714286,85.77
3253,696,18,696,138,14,4,25.0,42.91
3254,2040,52,0,678,42,10,100.0,0.0
3255,426768,233,0,8687,187,46,100.0,0.0
3256,31800,41,31800,2087,38,3,12.5,14.3
3257,492,61,492,130,43,18,3.571428571428572,9.72
3258,3852,89,3852,868,81,8,1.4492753623188406,27.15
3259,47172,32,0,3878,28,4,50.0,0.0
3260,948,1,948,600,1,0,33.333333333333336,63.09
3261,456,15,0,124,13,2,100.0,0.0
3262,3060,9,3060,749,9,0,25.0,95.3
3263,64296,34,64296,1147,29,5,4.3478260869565215,65.54
3264,1016256,1044,0,8053,580,464,1.0,0.0
3265,3756,131,0,736,75,56,100.0,0.0
3266,879396,174,879396,1616,91,83,4.545454545454546,89.28
3267,180,67,180,13,61,6,1.6666666666666667,24.65
3268,1202952,14,1668,156761,12,2,14.285714285714286,86.69
3269,123468,26,123468,1107,21,5,6.25,39.23
3270,896844,530,293520,211292,481,49,1.0,55.69
3271,1536,11,1536,745,10,1,16.666666666666668,78.26
3272,29652,4,7224,8037,3,1,16.666666666666668,78.34
3273,1199136,1904,0,201079,1152,752,1.0,1.07
3274,773904,18,0,65328,14,4,100.0,0.0
3275,1159284,111,162438,444287,81,30,1.0,0.0
3276,1056,5,1056,912,5,0,14.285714285714286,75.5
3277,1156176,2559,0,26482,1414,1145,1.0,1.68
3278,891852,26,658092,306185,25,1,100.0,0.0
3279,31608,27,31608,798,24,3,5.555555555555555,81.75
3280,36636,19,0,2708,16,3,100.0,0.0
3281,892464,384,289922,140856,383,1,100.0,0.0
3282,12000,46,0,1156,31,15,100.0,0.0
3283,492,77,492,33,55,22,2.127659574468085,36.61
3284,1104,4,1104,402,4,0,25.0,95.62
3285,1584,88,1584,44,64,24,1.851851851851852,51.39
3286,3228,10,3228,393,9,1,20.0,93.87
3287,1776,15,0,352,11,4,100.0,0.0
3288,228,19,228,8,17,2,5.882352941176471,51.27
3289,1404,52,1404,9,50,2,1.96078431372549,29.36
3290,2496,25,2496,4,25,0,3.703703703703704,52.93
3291,1237440,226,0,9344,120,106,6.25,4.75
3292,420,12,420,24,12,0,7.142857142857143,49.56
3293,528156,70,528156,30,46,24,2.7777777777777777,31.78
3294,3996,36,0,863,28,8,100.0,0.0
3295,1164,18,720,130,16,2,6.666666666666667,82.16
3296,1848,8,1848,39,6,2,14.285714285714286,89.75
3297,1224108,5621,33312,58913,3209,2412,1.0,3.0
3298,97224,27,97224,1936,27,0,3.571428571428572,23.79
3299,1031208,92,1031208,319924,83,9,1.5873015873015872,11.69
3300,65004,9,65004,1372,8,1,16.666666666666668,59.09
3301,188136,8,0,119509,5,3,33.333333333333336,0.0
3302,1132956,953,0,11251,508,445,1.0,0.0
3303,365976,813,0,4859,452,361,1.2345679012345678,5.94
3304,876,2,0,438,1,1,100.0,100.0
3305,105396,35,105396,3747,28,7,5.2631578947368425,31.27
3306,62628,56,0,3830,52,4,50.0,0.0
3307,124356,39,124356,3032,33,6,4.166666666666667,45.51
3308,38424,18,38424,37971,8,10,20.0,0.0
3309,1244916,4189,0,347186,2537,1652,1.0,0.0
3310,1223136,1286,4992,8278,694,592,1.0,0.0
3311,413064,70,0,109803,56,14,100.0,0.0
3312,32340,45,0,2331,40,5,50.0,0.0
3313,240,1,240,156,1,0,33.333333333333336,99.02
3314,956772,25,1572,38464,18,7,9.090909090909092,31.93
3315,67824,22,67824,1973,22,0,4.761904761904762,23.85
3316,408,50,408,12,44,6,2.3255813953488373,26.45
3317,456,5,456,232,3,2,33.333333333333336,63.24
3318,125184,56,0,4964,46,10,33.333333333333336,0.0
3319,64404,21,64404,1010,17,4,7.6923076923076925,47.85
3320,110256,50,0,2842,38,12,50.0,0.0
3321,252,16,252,63,12,4,10.0,61.77
3322,887280,96,0,55065,58,38,3.8461538461538463,0.0
3323,464568,59,0,71369,38,21,20.0,0.0
3324,58404,24,58404,38004,23,1,5.0,84.14
3325,669396,33,669396,609124,29,4,3.571428571428572,56.18
3326,172980,51,87576,7188,43,8,2.631578947368421,46.18
3327,636,69,636,225,67,2,1.96078431372549,49.73
3328,115464,49,0,3425,37,12,50.0,0.0
3329,286980,224,0,10785,103,121,3.4482758620689653,2.02
3330,100932,14,100932,71450,14,0,7.142857142857143,81.03
3331,64512,371,0,938,187,184,1.0,0.0
3332,116316,48,0,3848,37,11,50.0,0.0
3333,1225512,1007,0,44055,524,483,2.0,0.0
3334,20400,68,0,4785,56,12,100.0,0.0
3335,1063116,220,0,9984,113,107,2.1739130434782608,0.59
3336,48,38,48,17,23,15,9.090909090909092,15.44
3337,26616,42,0,1221,36,6,50.0,0.0
3338,13452,18,13452,898,16,2,6.25,20.0
3339,21132,38,0,3530,26,12,10.0,0.0
3340,552,3,552,84,3,0,20.0,80.2
3341,216,24,216,158,16,8,7.142857142857143,72.55
3342,267060,31,18288,16130,27,4,4.166666666666667,62.64
3343,1240992,80,0,194828,52,28,9.090909090909092,0.0
3344,1232076,1604,3156,17138,898,706,1.0,0.0
3345,636,62,0,134,57,5,1.851851851851852,0.0
3346,3276,95,0,1195,70,25,100.0,100.0
3347,1177032,104,0,80425,78,26,2.2222222222222223,1.47
3348,372,0,372,0,0,0,100.0,100.0
3349,540,1,0,540,1,0,2.380952380952381,0.0
3350,108,0,108,0,0,0,100.0,0.0
3351,91536,45,91536,7333,37,8,2.857142857142857,49.98
3352,1251204,678,0,72056,359,319,1.351351351351351,0.0
3353,1140,7,0,306,4,3,25.0,0.0
3354,520548,50,0,31235,34,16,50.0,0.0
3355,113808,172,0,3292,96,76,2.3255813953488373,1.0
3356,2004,0,2004,0,0,0,100.0,100.0
3357,3864,34,0,667,26,8,50.0,0.0
3358,660,75,660,53,67,8,1.5384615384615383,44.43
3359,1254180,1226,0,118354,692,534,2.5,0.0
3360,2496,20,2496,1025,19,1,5.2631578947368425,0.0
3361,84,1,84,12,1,0,25.0,10.95
3362,192,0,192,0,0,0,50.0,64.0
3363,492,48,492,112,39,9,2.702702702702702,20.35
3364,612,21,612,161,17,4,5.882352941176471,73.54
3365,43332,31,43332,1559,30,1,11.11111111111111,24.33
3366,108,23,108,27,20,3,5.0,12.07
3367,2868,10,2868,830,10,0,20.0,93.79
3368,42312,2,42312,30,1,1,50.0,26.76
3369,1234596,1088,0,34833,681,407,1.0,0.0
3370,1272108,17517,763710,289077,9779,7738,1.0,0.0
3371,468,55,468,59,49,6,2.127659574468085,43.25
3372,576,7,576,147,7,0,16.666666666666668,94.09
3373,9156,45,9156,1348,36,9,3.703703703703704,20.0
3374,420,16,420,55,14,2,7.142857142857143,50.89
3375,132,4,132,33,3,1,25.0,57.11
3376,1242300,1446,0,62803,796,650,1.0,0.0
3377,33444,26,33444,2706,20,6,8.333333333333334,73.37
3378,312,2,312,12,2,0,25.0,86.4
3379,300,4,300,27,4,0,16.666666666666668,60.82
3380,1008,17,1008,518,15,2,11.11111111111111,82.74
3381,39396,49,39396,2770,46,3,12.5,12.98
3382,756,0,756,0,0,0,100.0,100.0
3383,1265028,2791,0,41261,1634,1157,1.0,0.0
3384,20064,47,0,1161,37,10,50.0,0.0
3385,2976,29,2976,520,28,1,3.8461538461538463,57.11
3386,222864,323,0,5316,167,156,2.3255813953488373,0.0
3387,66336,22,66336,384,18,4,6.666666666666667,75.1
3388,56796,44,0,3498,41,3,50.0,0.0
3389,480,20,480,179,14,6,7.6923076923076925,78.81
3390,4872,7,4872,1510,5,2,50.0,85.82
3391,708,90,708,95,78,12,2.0,12.12
3392,36480,1,36480,1056,1,0,33.333333333333336,22.46
3393,1270944,2197,0,44908,1211,986,1.0,2.0
3394,30540,24,30540,1031,21,3,6.666666666666667,41.97
3395,1944,26,1944,709,25,1,4.166666666666667,37.68
3396,22344,45,0,1090,32,13,50.0,0.0
3397,218688,51,0,14042,39,12,25.0,0.0
3398,192,16,156,82,15,1,5.882352941176471,40.29
3399,2952,5,108,590,5,0,16.666666666666668,96.08
3400,180,78,180,26,66,12,1.6129032258064515,20.37
3401,17208,47,0,1063,37,10,50.0,0.0
3402,1233264,409,0,9924,216,193,1.694915254237288,0.0
3403,34476,32,0,4105,25,7,100.0,0.0
3404,809040,597,0,58587,330,267,1.4285714285714286,1.42
3405,164136,118,164136,5478,85,33,2.083333333333333,15.98
3406,1240152,930,0,22172,506,424,1.3157894736842106,5.94
3407,456,55,456,161,35,20,3.8461538461538463,78.69
3408,144,0,144,0,0,0,50.0,65.08
3409,720,22,720,14,21,1,4.545454545454546,35.84
3410,408,40,72,30,30,10,4.166666666666667,0.0
3411,1296,28,1296,55,24,4,4.166666666666667,59.25
3412,156,119,108,36,87,32,1.36986301369863,10.74
3413,31188,25,31188,18,20,5,6.25,47.04
3414,288,13,288,35,9,4,14.285714285714286,72.9
3415,372,2,0,276,1,1,50.0,99.99
3416,607836,100,0,30732,46,54,14.285714285714286,0.0
3417,3144,37,3144,938,35,2,3.4482758620689653,49.53
3418,2232,41,2232,61,27,14,4.3478260869565215,66.57
3419,156,0,156,0,0,0,50.0,80.0
3420,348,25,348,137,25,0,3.8461538461538463,56.84
3421,1968,1,1968,936,1,0,25.0,20.0
3422,156,52,156,13,46,6,2.2222222222222223,5.47
3423,216,8,216,60,8,0,11.11111111111111,19.61
3424,1320,37,1320,276,31,6,2.9411764705882355,34.93
3425,480,0,480,0,0,0,50.0,84.0
3426,1276944,1251,0,369171,689,562,1.0,0.0
3427,504,17,504,368,15,2,6.25,54.29
3428,5460,43,5460,55,39,4,2.5,43.67
3429,35976,3,35976,480,3,0,20.0,91.73
3430,27192,206,0,3106,144,62,1.4285714285714286,0.0
3431,1054992,414,0,57949,216,198,1.694915254237288,3.0
3432,144,103,96,41,93,10,1.1494252873563218,18.18
3433,108,5,108,31,5,0,14.285714285714286,20.11
3434,252,9,252,74,6,3,20.0,74.82
3435,588,8,588,171,8,0,10.0,94.78
3436,300,2,300,84,2,0,25.0,90.41
3437,634812,51,6600,12474,37,14,3.225806451612903,46.17
3438,250512,101,250512,40012,100,1,1.0,70.98
3439,797580,97,0,24195,51,46,4.761904761904762,17.1
3440,54132,149,0,2748,119,30,100.0,0.0
3441,111264,42,0,16030,21,21,33.333333333333336,0.0
3442,1072584,2223,0,26140,1141,1082,1.0,0.0
3443,350124,120,0,8199,45,75,14.285714285714286,0.0
3444,608988,143,0,12151,79,64,5.2631578947368425,0.0
3445,8328,10,8328,229,9,1,10.0,26.02
3446,1269276,3233,0,86961,1895,1338,1.0,0.58
3447,197940,177,0,3854,69,108,4.545454545454546,0.0
3448,51228,9,51228,6932,8,1,11.11111111111111,49.62
3449,798972,63,0,103024,31,32,10.0,2.0
3450,1020924,1,649428,852,1,0,100.0,0.0
3451,228,1,228,72,1,0,33.333333333333336,82.93
3452,30612,3,30612,840,3,0,20.0,96.95
3453,7740,39,7740,991,38,1,12.5,20.24
3454,132,30,132,56,12,18,20.0,67.0
3455,276,68,276,63,61,7,1.694915254237288,26.33
3456,7224,47,7224,11,47,0,2.0408163265306123,31.6
3457,157512,12,113664,1769,12,0,9.090909090909092,58.9
3458,25764,22,25764,747,20,2,5.2631578947368425,80.93
3459,528,19,516,97,14,5,8.333333333333334,42.94
3460,0,0,0,0,0,0,50.0,0.0
3461,339228,233,0,2870,108,125,10.0,0.0
3462,416304,57,416304,7709,33,24,4.3478260869565215,46.04
3463,1052652,1458,0,11369,791,667,1.0,0.0
3464,168,1,0,168,0,1,100.0,0.0
3465,540,108,0,85,83,25,1.36986301369863,0.0
3466,4740,87,0,552,56,31,100.0,0.0
3467,1060632,558,0,19475,307,251,1.8867924528301887,3.6
3468,1293000,9711,657564,796568,5554,4157,1.0,0.0
3469,545628,76,0,10305,28,48,20.0,0.0
3470,912,5,0,388,3,2,100.0,0.0
3471,851772,39,0,46443,20,19,9.090909090909092,5.0
3472,1271700,3654,0,71061,1927,1727,1.0,3.0
3473,1244304,716,0,11354,397,319,1.3157894736842106,1.11
3474,22008,640,0,2052,421,219,1.0,0.0
3475,1204344,805,0,7412,465,340,1.2658227848101269,2.0
3476,108,4,0,66,2,2,100.0,0.0
3477,129372,112,0,2363,52,60,5.2631578947368425,2.0
3478,123792,26,123792,1191,22,4,5.2631578947368425,67.52
3479,334404,238,0,18029,135,103,6.666666666666667,0.0
3480,132,15,0,74,10,5,100.0,0.0
3481,5664,44,5664,1300,42,2,8.333333333333334,19.13
3482,468,119,468,295,77,42,1.492537313432836,27.51
3483,980028,800,0,14913,428,372,1.1494252873563218,0.0
3484,204,20,0,44,12,8,100.0,0.0
3485,264,2,264,48,1,1,50.0,97.82
3486,696,111,696,462,77,34,1.6666666666666667,59.94
3487,901476,383,0,18485,238,145,1.3157894736842106,0.0
3488,120,16,72,22,15,1,5.882352941176471,14.81
3489,63372,35,0,7768,17,18,14.285714285714286,0.0
3490,104412,153,0,6140,62,91,5.0,0.0
3491,9072,35,9072,19,33,2,2.9411764705882355,39.66
3492,792,210,792,274,126,84,1.2048192771084338,68.2
3493,7944,57,0,354,37,20,4.166666666666667,0.0
3494,164832,27,0,80379,23,4,4.545454545454546,0.0
3495,1260,0,1260,0,0,0,100.0,100.0
3496,146100,8,146100,474,6,2,14.285714285714286,0.0
3497,1132200,1744,0,82413,916,828,1.0,0.26
3498,114960,45,114960,3697,39,6,2.631578947368421,35.63
3499,2592,15,2592,114,15,0,5.882352941176471,71.4
3500,2472,24,2472,791,19,5,6.25,39.97
3501,14448,5,14448,5061,5,0,16.666666666666668,90.83
3502,716076,805,0,23376,428,377,1.1111111111111112,0.0
3503,1298856,4055,0,632829,2279,1776,1.0,0.0
3504,432,38,432,356,34,4,2.9411764705882355,34.84
3505,341520,81,341520,4840,44,37,3.703703703703704,31.91
3506,576,162,576,162,112,50,1.5625,73.59
3507,264,84,264,85,64,20,1.7857142857142858,37.75
3508,948,121,948,298,47,74,8.333333333333334,70.67
3509,425484,134,0,30050,71,63,3.703703703703704,0.82
3510,696,3,696,152,3,0,20.0,61.16
3511,18840,66,0,3892,34,32,10.0,5.0
3512,1145760,136,0,135537,73,63,2.5,10.8
3513,796632,240,0,19553,150,90,3.703703703703704,0.0
3514,1344,5,0,722,3,2,100.0,0.0
3515,39324,4,39324,132,3,1,25.0,0.0
3516,4848,25,4848,11,25,0,3.703703703703704,52.75
3517,1192788,510,0,341433,265,245,1.9230769230769231,0.0
3518,5136,44,5136,34,30,14,4.0,56.32
3519,85032,74,85032,1183,42,32,3.571428571428572,32.13
3520,480,54,480,19,44,10,2.4390243902439024,42.77
3521,495528,46,0,36971,38,8,100.0,0.0
3522,1077384,304,0,7917,147,157,3.571428571428572,0.0
3523,588,3,588,272,3,0,25.0,92.52
3524,828,53,828,118,45,8,2.3255813953488373,32.59
3525,3624,13,3624,696,13,0,6.666666666666667,83.68
3526,228,0,228,0,0,0,100.0,100.0
3527,96,0,96,0,0,0,50.0,59.29
3528,8268,25,0,386,24,1,100.0,0.0
3529,1296516,2847,0,26017,1583,1264,1.0,0.0
3530,432,99,432,128,51,48,3.571428571428572,65.64
3531,255648,81,0,12844,40,41,7.6923076923076925,3.47
3532,295452,56,0,6281,25,31,14.285714285714286,0.0
3533,1308,88,1248,681,59,29,3.225806451612903,80.78
3534,876,14,840,282,12,2,8.333333333333334,19.6
3535,8448,24,8448,273,24,0,3.8461538461538463,56.73
3536,216,11,144,28,10,1,9.090909090909092,51.61
3537,81912,182,0,717,158,24,100.0,0.0
3538,10776,261,0,4435,115,146,7.142857142857143,3.0
3539,1306668,6630,83986,434912,3774,2856,1.0,0.0
3540,852,39,852,22,33,6,3.125,49.4
3541,1080,17,1080,174,11,6,10.0,37.13
3542,82320,145,0,992,64,81,6.25,0.0
3543,120,10,120,0,10,0,8.333333333333334,49.77
3544,612804,126,0,52596,53,73,4.166666666666667,0.0
3545,1305672,761,0,151502,354,407,1.694915254237288,0.0
3546,84636,374,0,1144,185,189,1.96078431372549,0.0
3547,937776,576,0,23011,304,272,3.125,0.0
3548,1258788,1889,0,11399,1015,874,1.0,0.52
3549,2904,55,0,154,46,9,100.0,0.0
3550,194316,11,0,58985,8,3,100.0,0.0
3551,1255512,360,339696,69973,171,189,4.545454545454546,0.0
3552,1306740,2031,0,16020,1098,933,1.0,0.0
3553,73104,114,0,6764,63,51,6.666666666666667,0.0
3554,636,20,636,70,18,2,5.2631578947368425,62.29
3555,156,25,120,48,17,8,9.090909090909092,49.08
3556,1136952,189,0,27862,88,101,4.545454545454546,0.0
3557,5400,4,0,1533,3,1,100.0,0.0
3558,1164,23,1164,377,21,2,4.761904761904762,74.81
3559,1305444,2108,414204,151470,1242,866,1.0,0.0
3560,1287576,481,0,35853,261,220,1.5384615384615383,0.0
3561,1428,27,1428,5,25,2,3.8461538461538463,26.56
3562,2664,69,0,941,52,17,100.0,0.0
3563,204,5,204,74,5,0,14.285714285714286,91.42
3564,576,44,576,7,36,8,2.9411764705882355,23.23
3565,5568,40,5568,1167,39,1,16.666666666666668,24.53
3566,45012,33,0,1885,24,9,100.0,0.0
3567,672,37,672,27,36,1,2.631578947368421,52.63
3568,927036,1295,0,6872,686,609,1.0,0.0
3569,2268,14,2268,706,13,1,12.5,91.88
3570,66240,45,66240,15,37,8,2.857142857142857,24.85
3571,291216,19,0,34993,16,3,20.0,0.0
3572,39048,23,39048,1891,19,4,7.142857142857143,62.72
3573,636,0,636,0,0,0,50.0,99.69
3574,72,26,72,27,14,12,25.0,50.98
3575,13104,45,13104,12999,35,10,3.125,34.02
3576,1296,12,1296,320,11,1,11.11111111111111,92.13
3577,900,5,900,168,5,0,20.0,21.48
3578,396,0,396,0,0,0,100.0,100.0
3579,150660,25,0,11733,11,14,14.285714285714286,0.0
3580,2184,0,1662,0,0,0,25.0,96.49
3581,600,84,600,26,58,26,2.127659574468085,18.32
3582,1164,85,1164,80,65,20,1.7543859649122806,14.91
3583,288,32,288,78,19,13,12.5,34.82
3584,1193712,5,0,537895,2,3,1.0,0.0
3585,5520,160,0,839,93,67,100.0,0.0
3586,4380,135,0,1620,100,35,100.0,0.0
3587,5604,141,0,437,121,20,100.0,0.0
3588,966852,558,0,29872,213,345,2.2222222222222223,0.0
3589,4080,41,4080,3816,34,7,3.571428571428572,78.83
3590,1298832,2767,9504,11576,1555,1212,1.0,0.0
3591,14664,4,0,7362,2,2,25.0,12.8
3592,1152,82,1152,69,64,18,1.7241379310344829,30.9
3593,3132,11,3132,652,10,1,20.0,91.99
3594,780,9,0,297,5,4,33.333333333333336,0.0
3595,816,35,816,17,33,2,2.9411764705882355,71.48
3596,1011204,63,1011204,123779,54,9,2.380952380952381,15.43
3597,1215528,1843,0,9090,999,844,1.0,3.72
3598,3216,47,3216,2986,35,12,4.166666666666667,75.0
3599,48,5,48,0,5,0,14.285714285714286,53.6
3600,108,11,108,39,6,5,33.333333333333336,53.09
3601,2976,53,0,812,38,15,100.0,0.0
3602,73548,158,0,10625,143,15,50.0,0.0
3603,1752,7,1752,351,7,0,20.0,94.06
3604,1128,10,792,447,9,1,14.285714285714286,90.83
3605,7188,2,7188,2028,1,1,100.0,0.0
3606,51900,708,0,1765,399,309,1.0,0.0
3607,312,10,312,62,9,1,11.11111111111111,57.33
3608,34380,23,34380,686,21,2,5.0,79.58
3609,1140,8,1140,316,8,0,25.0,80.05
3610,1317960,2022,582156,463952,1116,906,1.0,0.0
3611,880668,250,0,11798,125,125,6.25,0.0
3612,25536,0,25536,0,0,0,50.0,85.0
3613,12024,40,0,1284,25,15,100.0,0.0
3614,276,16,276,20,10,6,16.666666666666668,65.21
3615,76128,7,76128,11742,7,0,12.5,69.29
3616,671640,282,0,15118,218,64,20.0,0.0
3617,41904,10,41904,3766,9,1,10.0,55.2
3618,864,7,864,255,7,0,16.666666666666668,88.43
3619,2568,11,2568,862,10,1,10.0,63.04
3620,153072,39,0,13232,37,2,100.0,0.0
3621,3648,8,3528,492,6,2,11.11111111111111,73.71
3622,516,49,516,33,41,8,2.380952380952381,46.8
3623,1330236,50830,539172,451556,28380,22450,1.0,0.0
3624,938484,59,938484,294361,53,6,2.3255813953488373,18.77
3625,56904,22,56904,777,19,3,5.882352941176471,59.45
3626,90216,24,90216,1699,22,2,25.0,25.29
3627,119688,206,0,1394,130,76,4.761904761904762,0.0
3628,1584,1,1584,12,1,0,33.333333333333336,97.38
3629,28884,1,28884,240,1,0,100.0,0.0
3630,17532,606,0,1285,374,232,1.0,0.0
3631,170232,9,170232,101825,9,0,9.090909090909092,82.21
3632,528,40,528,8,40,0,2.380952380952381,60.25
3633,576,43,576,7,39,4,2.5641025641025643,41.43
3634,414264,313,0,4947,199,114,7.142857142857143,0.07
3635,54888,50,0,2201,40,10,50.0,0.0
3636,56748,14,56748,765,13,1,10.0,48.13
3637,432,7,432,132,4,3,25.0,50.64
3638,269868,41,0,12909,27,14,25.0,0.0
3639,1138200,53,0,34442,42,11,20.0,0.0
3640,852,2,852,90,1,1,50.0,65.22
3641,1264752,315,0,10776,161,154,2.4390243902439024,0.0
3642,56520,50,0,1899,37,13,50.0,0.0
3643,2196,4,2196,426,3,1,25.0,96.16
3644,960,33,960,512,28,5,4.0,58.68
3645,47832,63,0,3175,52,11,25.0,0.0
3646,1277916,763,0,10943,415,348,1.408450704225352,2.38
3647,480,12,468,253,12,0,8.333333333333334,52.53
3648,94116,26,13392,4107,20,6,6.666666666666667,87.92
3649,90288,30,90288,1210,27,3,5.2631578947368425,32.38
3650,468,8,348,226,7,1,12.5,47.86
3651,108,2,108,60,1,1,50.0,74.34
3652,339768,8,172920,168999,6,2,50.0,0.0
3653,154764,71,0,58358,40,31,3.4482758620689653,10.0
3654,6360,42,0,1158,27,15,100.0,0.0
3655,348,7,348,123,7,0,14.285714285714286,60.52
3656,32268,3,32268,1700,2,1,4.3478260869565215,36.54
3657,28416,41,0,2248,38,3,50.0,0.0
3658,63456,49,0,2291,35,14,50.0,0.0
3659,1159500,80,0,460680,59,21,1.4285714285714286,0.0
3660,96,26,96,40,14,12,10.0,85.49
3661,343332,316,0,3122,166,150,3.125,4.0
3662,666840,53,0,70358,38,15,11.11111111111111,0.0
3663,288,25,288,142,14,11,20.0,94.03
3664,48,20,48,12,15,5,8.333333333333334,19.76
3665,252,15,252,100,13,2,12.5,75.42
3666,900,8,900,135,6,2,14.285714285714286,70.85
3667,947040,420,0,3263,235,185,1.0,0.0
3668,540,191,504,301,108,83,1.5873015873015872,67.92
3669,1276704,1250,0,38865,688,562,1.4492753623188406,0.0
3670,228,33,60,38,25,8,4.545454545454546,12.66
3671,288,26,288,30,22,4,5.0,18.39
3672,2052,26,2052,873,23,3,4.761904761904762,72.58
3673,671508,43,671508,71071,38,5,3.0303030303030303,25.07
3674,25776,79,0,2401,71,8,50.0,0.0
3675,552,1,552,144,1,0,33.333333333333336,72.75
3676,1177152,1197,0,31217,675,522,1.3333333333333333,0.0
3677,2676,69,0,855,52,17,100.0,0.0
3678,228,28,228,72,28,0,3.333333333333333,64.09
3679,25752,20,1212,1365,18,2,5.555555555555555,42.89
3680,492,22,492,240,22,0,4.166666666666667,57.48
3681,943608,1329,0,5302,716,613,1.0,0.0
3682,1348584,2426,213966,398361,1232,1194,1.0,0.23
3683,780,160,0,142,134,26,1.0,0.0
3684,24912,134,0,997,81,53,100.0,0.0
3685,192,2,192,48,1,1,100.0,100.0
3686,1319364,21,1319364,1266,12,9,14.285714285714286,87.98
3687,18192,51,0,1159,37,14,50.0,0.0
3688,1152,32,0,395,28,4,100.0,0.0
3689,1255836,1280,0,52690,722,558,1.0,0.0
3690,660,3,660,104,3,0,20.0,94.06
3691,36,12,36,0,12,0,7.142857142857143,44.8
3692,252,48,156,116,41,7,2.5641025641025643,35.13
3693,29316,38,0,1836,36,2,50.0,0.0
3694,17688,47,0,1168,36,11,50.0,0.0
3695,1067376,2164,0,11725,1203,961,1.0,0.32
3696,6420,170,6420,195,79,91,4.761904761904762,80.02
3697,708,4,708,18,4,0,4.166666666666667,43.35
3698,17544,49,0,1187,35,14,50.0,0.0
3699,7500,282,552,270,163,119,1.0,11.51
3700,2532,68,0,967,57,11,100.0,0.0
3701,104196,30,0,4583,24,6,50.0,50.0
3702,13812,40,0,1314,25,15,100.0,0.0
3703,13464,39,0,1621,36,3,50.0,0.0
3704,2580,122,0,438,76,46,100.0,0.0
3705,15420,54,0,1018,43,11,50.0,0.0
3706,240,0,240,0,0,0,100.0,100.0
3707,288,18,288,31,15,3,5.555555555555555,83.57
3708,192,0,192,0,0,0,50.0,34.3
3709,25056,12,25056,576,10,2,12.5,55.33
3710,756,75,756,373,59,16,1.9230769230769231,28.88
3711,168,8,168,34,4,4,100.0,100.0
3712,60,5,60,7,4,1,20.0,28.07
3713,1392,33,1392,445,19,14,7.142857142857143,73.55
3714,1228596,4655,0,35167,2639,2016,1.0,0.0
3715,1353084,292,0,55439,147,145,2.9411764705882355,1.12
3716,216,23,216,42,9,14,33.333333333333336,0.0
3717,479448,4,479448,72,2,2,50.0,54.82
3718,432,3,0,224,2,1,33.333333333333336,0.0
3719,571536,527,0,13508,279,248,2.5,0.0
3720,120,8,120,22,7,1,14.285714285714286,86.89
3721,740400,61,0,34460,48,13,100.0,0.0
3722,204108,9,0,27998,8,1,11.11111111111111,74.53
3723,53124,48,53124,46,36,12,3.125,44.67
3724,87396,62,87396,5258,52,10,2.5,15.61
3725,35520,17,0,6878,7,10,25.0,0.0
3726,108660,14,108660,743,12,2,11.11111111111111,50.1
3727,96900,16,0,7144,13,3,8.333333333333334,0.0
3728,3456,1,3456,1728,1,0,33.333333333333336,67.48
3729,847200,411,0,10850,217,194,2.2222222222222223,0.0
3730,54516,44,54516,44,32,12,3.571428571428572,54.05
3731,1211724,1354,0,301364,763,591,1.0,0.0
3732,55320,77,55320,2414,33,44,7.6923076923076925,83.39
3733,42336,175,0,1116,144,31,100.0,0.0
3734,1302312,933,0,427877,459,474,2.5,0.0
3735,766320,472,0,9788,258,214,1.7857142857142858,0.0
3736,352680,258,0,6879,121,137,2.4390243902439024,0.0
3737,612,1,612,0,1,0,33.333333333333336,71.11
3738,129660,113,0,7094,63,50,9.090909090909092,5.0
3739,500760,36,500760,832,32,4,3.0303030303030303,22.88
3740,1032,11,1032,162,5,6,25.0,99.05
3741,80400,86,80400,7578,70,16,2.2222222222222223,15.33
3742,312,9,312,69,9,0,9.090909090909092,74.5
3743,65364,7,0,15123,4,3,50.0,0.0
3744,32088,16,32088,580,14,2,6.666666666666667,0.0
3745,48,10,48,12,10,0,8.333333333333334,80.01
3746,192,67,192,69,46,21,3.225806451612903,34.3
3747,554352,116,0,36531,62,54,10.0,0.0
3748,1113336,1455,0,93592,805,650,1.0,0.0
3749,204,6,108,60,5,1,16.666666666666668,43.58
3750,1152,90,1152,460,48,42,5.555555555555555,81.89
3751,607560,608,0,14958,326,282,1.96078431372549,0.0
3752,120,19,120,11,19,0,5.0,65.72
3753,1224444,803,0,14296,454,349,1.351351351351351,2.51
3754,2652,129,0,430,114,15,100.0,0.0
3755,5088,115,0,1199,79,36,2.380952380952381,0.0
3756,89556,27,89556,28,27,0,4.0,34.21
3757,1301832,659,0,7692,369,290,1.408450704225352,0.0
3758,1114932,418,0,159692,224,194,4.545454545454546,0.0
3759,648,70,648,233,41,29,5.882352941176471,17.54
3760,360,3,360,148,3,0,20.0,60.83
3761,2688,466,0,1190,307,159,1.0,0.0
3762,1302588,256,0,20648,123,133,4.545454545454546,0.0
3763,348660,200,0,5925,88,112,3.125,1.88
3764,396,23,396,165,21,2,4.545454545454546,56.39
3765,1220820,261,0,56453,129,132,1.9230769230769231,0.32
3766,39900,24,39900,1516,20,4,16.666666666666668,49.08
3767,1375416,24082,570240,421633,13647,10435,1.0,1.5
3768,23520,85,0,664,35,50,12.5,0.0
3769,117984,97,0,4454,51,46,11.11111111111111,0.92
3770,384,5,384,124,3,2,33.333333333333336,24.66
3771,828,3,828,72,1,2,12.5,0.0
3772,416820,265,0,23571,147,118,4.3478260869565215,0.0
3773,118572,127,0,2397,61,66,7.6923076923076925,0.0
3774,178728,48,133860,19966,36,12,100.0,0.0
3775,960,33,0,173,26,7,100.0,0.0
3776,1374804,3039,740340,533526,1764,1275,1.0,0.0
3777,4524,63,4524,85,45,18,2.631578947368421,32.84
3778,2208,35,2208,299,24,11,7.6923076923076925,18.02
3779,1326276,353,0,202041,241,112,1.3888888888888888,0.0
3780,672,0,672,0,0,0,100.0,100.0
3781,792,38,792,64,38,0,2.5,43.39
3782,38472,16,38472,1355,16,0,6.25,52.33
3783,864,6,864,12,6,0,12.5,79.64
3784,880752,322,0,9929,159,163,3.333333333333333,0.0
3785,312,49,312,96,47,2,2.083333333333333,61.07
3786,622632,144,377107,294357,143,1,5.555555555555555,99.65
3787,2232,40,2232,1413,36,4,2.7777777777777777,58.62
3788,1079076,122,0,9811,58,64,6.666666666666667,5.0
3789,15192,124,0,1049,48,76,7.6923076923076925,3.0
3790,66312,0,66312,0,0,0,100.0,98.0
3791,216,22,216,28,21,1,5.0,23.94
3792,9600,78,0,650,49,29,3.125,60.84
3793,132,12,132,2,12,0,7.6923076923076925,87.81
3794,57240,168,57240,14462,74,94,3.703703703703704,67.81
3795,1307700,618,0,15601,244,374,2.3255813953488373,0.0
3796,408,31,408,15,31,0,3.0303030303030303,68.34
3797,1181172,262,3492,21034,151,111,1.639344262295082,0.0
3798,150540,124,150540,7066,96,28,2.2222222222222223,54.75
3799,348,31,348,7,31,0,3.0303030303030303,65.62
3800,226596,294,0,2524,179,115,1.7543859649122806,0.0
3801,874212,121,0,28103,56,65,11.11111111111111,0.0
3802,32496,8,4224,24958,5,3,1.2820512820512822,0.0
3803,1201008,421,0,10404,165,256,1.408450704225352,0.1
3804,775260,8,0,408882,8,0,11.11111111111111,0.0
3805,1176,3,1176,920,2,1,50.0,84.07
3806,624,1,624,312,1,0,33.333333333333336,74.0
3807,6852,13,6852,6731,9,4,11.11111111111111,86.43
3808,8208,221,0,1623,118,103,50.0,99.0
3809,884352,383,0,8315,203,180,2.272727272727273,0.0
3810,768084,154,300,17774,85,69,3.8461538461538463,3.88
3811,84,0,84,0,0,0,50.0,49.0
3812,1383288,2881,748836,286076,1663,1218,1.0,0.0
3813,148572,36,0,4545,33,3,100.0,0.0
3814,3348,8,3348,879,6,2,16.666666666666668,98.38
3815,1265496,179,0,14445,92,87,4.761904761904762,0.0
3816,1013376,721,0,34588,321,400,1.5384615384615383,0.0
3817,1380036,4087,0,282644,2041,2046,1.0,2.0
3818,7740,1,7740,324,1,0,33.333333333333336,84.25
3819,648,15,648,617,14,1,20.0,99.64
3820,1296,62,1296,561,54,8,1.9230769230769231,33.17
3821,1206768,919,0,17064,517,402,1.0309278350515465,2.75
3822,312,5,312,108,3,2,33.333333333333336,78.7
3823,1020576,909,0,16112,480,429,1.0526315789473684,0.81
3824,272412,12,272412,158,8,4,12.5,90.08
3825,2100,7,2100,2036,5,2,11.11111111111111,69.9
3826,4188,10,4188,1828,10,0,7.6923076923076925,64.86
3827,19032,0,19032,0,0,0,100.0,100.0
3828,2712,89,2712,133,81,8,1.2987012987012987,36.84
3829,960204,927,0,20420,441,486,1.9230769230769231,0.0
3830,22692,8,22692,58,8,0,10.0,86.88
3831,1345356,3081,0,189024,1500,1581,1.0,15.8
3832,481392,3,0,186892,2,1,25.0,0.0
3833,2400,6,912,464,4,2,16.666666666666668,89.84
3834,5568,28,5568,368,27,1,3.4482758620689653,78.21
3835,32580,24,0,1862,15,9,100.0,0.0
3836,1344348,2538,0,197484,1594,944,1.0,0.0
3837,1259700,3363,0,77608,1975,1388,1.0,0.0
3838,267108,604,0,2550,462,142,1.0,0.0
3839,253812,73,187140,110238,73,0,2.272727272727273,79.9
3840,216,4,216,63,4,0,14.285714285714286,85.8
3841,5388,9,5388,882,6,3,16.666666666666668,72.18
3842,240,9,240,94,6,3,20.0,46.28
3843,4704,47,4704,1705,38,9,4.545454545454546,33.74
3844,1198836,1206,0,12938,648,558,1.0,0.0
3845,552,7,552,61,5,2,16.666666666666668,96.49
3846,1956,3,1956,312,3,0,20.0,60.88
3847,276,5,276,60,5,0,14.285714285714286,70.5
3848,708,1,708,540,1,0,33.333333333333336,25.94
3849,1160388,1303,0,18257,728,575,1.0,0.0
3850,1393872,927,0,718112,408,519,1.0,0.0
3851,34944,5,4776,16276,3,2,50.0,99.68
3852,33792,5,0,27141,3,2,33.333333333333336,0.0
3853,20532,106,0,381,92,14,100.0,0.0
3854,89376,133,0,5296,75,58,11.11111111111111,0.0
3855,128640,583,0,5997,317,266,1.6129032258064515,0.0
3856,552,16,552,111,16,0,5.555555555555555,73.52
3857,96,8,84,42,7,1,14.285714285714286,66.48
3858,534924,103,534924,14648,54,49,7.6923076923076925,89.16
3859,278544,3,183036,132168,3,0,25.0,86.08
3860,660,12,660,4,11,1,8.333333333333334,47.42
3861,151104,175,0,41628,77,98,2.9411764705882355,9.77
3862,180,5,180,36,5,0,14.285714285714286,20.34
3863,5004,0,5004,0,0,0,20.0,75.0
3864,60,3,60,0,3,0,20.0,57.91
3865,269832,44,0,12930,16,28,14.285714285714286,3.0
3866,661056,288,320484,233430,286,2,100.0,0.0
3867,12288,31,12288,12222,28,3,3.4482758620689653,54.79
3868,153612,180,0,1763,84,96,4.545454545454546,0.0
3869,1332,1,1332,1248,1,0,33.333333333333336,95.65
3870,96696,160,0,1045,90,70,6.666666666666667,0.0
3871,18168,5,18168,18024,5,0,14.285714285714286,76.5
3872,948,37,948,719,25,12,4.545454545454546,41.47
3873,1536,10,0,584,6,4,20.0,0.0
3874,4020,21,4020,44,11,10,33.333333333333336,20.42
3875,1395540,274,0,25812,138,136,3.225806451612903,0.0
3876,3204,2,3204,6,2,0,25.0,25.68
3877,88152,44,88152,2663,43,1,8.333333333333334,13.12
3878,0,0,0,0,0,0,50.0,0.0
3879,430560,260,0,8298,124,136,4.3478260869565215,0.0
3880,96,0,96,0,0,0,100.0,100.0
3881,48,18,48,12,13,5,10.0,23.33
3882,1144860,2,1144860,400674,2,0,33.333333333333336,95.79
3883,1337544,672,0,12941,347,325,1.639344262295082,3.0
3884,0,0,0,0,0,0,50.0,99.99
3885,7188,58,7188,40,44,14,2.5641025641025643,72.1
3886,396,6,396,174,6,0,16.666666666666668,85.31
3887,504,16,0,32,15,1,50.0,0.0
3888,32484,21,32484,1903,17,4,6.666666666666667,87.63
3889,8352,53,8352,11,43,10,2.5,38.54
3890,1203576,1055,0,168920,677,378,1.0,0.0
3891,276,3,276,172,3,0,33.333333333333336,97.99
3892,24,4,0,18,4,0,16.666666666666668,0.0
3893,816,9,816,216,9,0,9.090909090909092,90.94
3894,1292664,139,0,26416,65,74,5.0,0.0
3895,180,1,180,0,1,0,33.333333333333336,25.07
3896,341340,176,0,3480,104,72,100.0,0.0
3897,158796,28,158796,2085,25,3,5.0,37.3
3898,119856,156,2640,3259,129,27,1.0,52.27
3899,480,32,480,156,32,0,3.0303030303030303,38.76
3900,11652,48,11652,15,46,2,2.127659574468085,34.66
3901,314676,306,0,11466,164,142,2.631578947368421,0.0
3902,8808,42,8808,1245,33,9,4.0,40.33
3903,768,43,468,24,39,4,2.631578947368421,70.4
3904,105216,38,105216,102040,34,4,2.9411764705882355,54.46
3905,80868,22,80868,1231,19,3,6.25,77.03
3906,3072,57,684,261,49,8,2.083333333333333,35.2
3907,1339284,253,0,35392,130,123,2.5641025641025643,2.55
3908,22056,148,0,3072,116,32,100.0,0.0
3909,1384656,433,0,4561,263,170,1.0,0.0
3910,595092,999,0,10572,549,450,1.1111111111111112,0.0
3911,5568,35,5568,1536,29,6,4.761904761904762,35.85
3912,90420,6,90420,1026,4,2,100.0,100.0
3913,520908,41,520908,4667,34,7,3.0303030303030303,2.91
3914,456,35,456,30,33,2,2.9411764705882355,13.77
3915,504,9,504,206,8,1,12.5,52.86
3916,192,1,192,0,1,0,33.333333333333336,25.12
3917,1416,35,1416,40,35,0,2.702702702702702,13.35
3918,168,19,168,10,14,5,9.090909090909092,56.39
3919,948,66,948,88,58,8,1.7543859649122806,29.59
3920,42732,26,42732,1625,21,5,9.090909090909092,45.45
3921,120,17,120,17,13,4,7.6923076923076925,49.57
3922,178152,51,0,5291,38,13,33.333333333333336,0.0
3923,684,53,684,57,53,0,1.851851851851852,60.32
3924,1428,75,0,466,55,20,100.0,0.0
3925,54276,52,0,1941,37,15,50.0,0.0
3926,612,42,612,22,41,1,2.380952380952381,25.37
3927,3516,18,3516,636,15,3,7.6923076923076925,79.05
3928,204,1,204,12,1,0,33.333333333333336,75.0
3929,5280,11,5280,173,11,0,7.142857142857143,68.33
3930,420,3,420,240,3,0,25.0,99.6
3931,276,10,276,76,7,3,12.5,68.26
3932,33132,14,1104,3223,10,4,11.11111111111111,68.12
3933,300,5,300,122,4,1,25.0,96.61
3934,396,9,396,149,7,2,12.5,95.69
3935,96,0,96,0,0,0,100.0,100.0
3936,5160,70,5160,145,62,8,1.6666666666666667,7.81
3937,1992,39,1992,491,39,0,2.5,46.04
3938,169896,16,169896,73167,13,3,14.285714285714286,93.55
3939,180,10,180,0,10,0,8.333333333333334,58.7
3940,59676,39,0,2493,37,2,50.0,0.0
3941,264,15,264,12,12,3,9.090909090909092,57.79
3942,804,6,804,98,3,3,50.0,22.41
3943,102588,29,102588,6,27,2,3.571428571428572,34.71
3944,62220,37,0,3064,31,6,50.0,0.0
3945,900,64,840,66,54,10,2.0,37.8
3946,1239624,27,552,85424,25,2,4.545454545454546,69.31
3947,14100,22,14100,883,20,2,5.0,83.87
3948,21096,266,0,3302,217,49,100.0,0.0
3949,1380924,58,0,27370,53,5,25.0,0.0
3950,504,32,504,453,16,16,10.0,59.7
3951,278232,46,0,7684,30,16,50.0,0.0
3952,7932,81,7932,6972,79,2,1.2195121951219512,31.46
3953,1215384,108,0,19692,64,44,7.6923076923076925,0.0
3954,132,22,72,35,21,1,4.545454545454546,10.59
3955,3060,20,3060,585,10,10,20.0,93.5
3956,48,1,48,0,1,0,33.333333333333336,74.51
3957,576,0,576,0,0,0,100.0,100.0
3958,1068516,57,0,21119,46,11,25.0,0.0
3959,4536,24,4536,558,19,5,6.25,86.66
3960,12168,54,0,1163,41,13,50.0,0.0
3961,1078740,160,301548,9326,82,78,3.333333333333333,73.81
3962,8076,53,0,1872,49,4,50.0,0.0
3963,120,18,120,31,11,7,16.666666666666668,66.84
3964,53976,18,53976,1090,17,1,9.090909090909092,52.84
3965,516,67,96,43,36,31,4.3478260869565215,19.01
3966,312,6,312,76,6,0,14.285714285714286,92.61
3967,1410564,972,0,41028,542,430,1.2048192771084338,0.0
3968,60,9,60,2,9,0,9.090909090909092,20.12
3969,79332,14,79332,2636,12,2,8.333333333333334,90.67
3970,96,52,60,21,38,14,3.125,40.15
3971,32556,45,0,3490,29,16,50.0,0.0
3972,87144,34,0,3700,27,7,50.0,0.0
3973,1317852,1400,0,34121,769,631,1.0,0.54
3974,1263120,233,412764,20625,132,101,2.631578947368421,81.56
3975,75120,50,0,2354,35,15,50.0,0.0
3976,1035744,727,0,11947,535,192,1.0,0.0
3977,1413072,1931,0,26868,1075,856,1.0,0.0
3978,120528,16,120528,570,14,2,8.333333333333334,74.74
3979,9192,55,0,1885,50,5,50.0,0.0
3980,3672,102,0,1229,79,23,100.0,0.0
3981,73764,18,73764,954,16,2,9.090909090909092,55.16
3982,396,98,396,107,60,38,2.380952380952381,43.21
3983,1312080,1161,0,38322,641,520,1.0,0.0
3984,825744,94,0,9121,41,53,6.666666666666667,0.0
3985,83028,84,0,9334,39,45,20.0,0.0
3986,468,0,468,0,0,0,100.0,100.0
3987,26148,51,0,1389,35,16,50.0,0.0
3988,1435764,5632,19272,71566,3277,2355,1.0,0.58
3989,120,18,120,11,13,5,10.0,45.86
3990,52728,159,696,467,103,56,1.36986301369863,31.0
3991,13008,34,0,2878,31,3,50.0,0.0
3992,2928,47,0,728,37,10,100.0,0.0
3993,11292,73,0,1036,52,21,100.0,0.0
3994,1320372,1324,0,20802,723,601,1.0101010101010102,0.0
3995,596604,54,0,48954,44,10,25.0,0.0
3996,375456,68,0,7659,60,8,33.333333333333336,0.0
3997,20532,5,0,6784,4,1,50.0,0.0
3998,240,1,240,12,1,0,33.333333333333336,82.56
3999,12852,180,0,1584,106,74,100.0,0.0
4000,720,10,720,204,7,3,16.666666666666668,20.98
4001,372,54,0,70,33,21,100.0,0.0
4002,1260,13,1260,428,13,0,10.0,54.71
4003,732,49,672,210,35,14,4.166666666666667,54.98
4004,121212,14,121212,717,11,3,12.5,84.63
4005,5376,76,0,216,51,25,100.0,0.0
4006,108,10,108,0,10,0,8.333333333333334,48.0
4007,51420,32,0,6253,18,14,16.666666666666668,10.0
4008,1440780,776,0,57529,437,339,2.2222222222222223,0.0
4009,120,10,120,57,7,3,20.0,84.21
4010,87420,189,0,1954,96,93,4.3478260869565215,0.0
4011,960480,1177,0,7290,646,531,1.0,0.0
4012,120,0,120,0,0,0,50.0,72.25
4013,112440,16,112440,12885,12,4,12.5,76.02
4014,274452,364,0,16051,200,164,3.125,3.0
4015,552,11,552,87,9,2,10.0,66.81
4016,240,34,48,21,30,4,3.571428571428572,31.96
4017,34188,15,34188,43,12,3,9.090909090909092,59.82
4018,47784,30,828,2065,26,4,4.545454545454546,70.87
4019,1092,15,0,432,12,3,50.0,0.0
4020,1433664,572,327558,188700,572,0,1.0,68.18
4021,288,40,288,78,26,14,5.0,55.78
4022,1446120,3699,179352,301482,2073,1626,1.0,0.0
4023,1298916,177,0,11140,101,76,3.8461538461538463,0.0
4024,1419744,742,0,132729,409,333,1.5384615384615383,0.0
4025,925728,3,925728,308844,1,2,50.0,28.97
4026,192,5,192,12,5,0,14.285714285714286,72.5
4027,1358028,370,0,471768,171,199,1.694915254237288,0.0
4028,1080048,334,0,11238,170,164,2.5641025641025643,0.0
4029,612,20,612,249,18,2,5.555555555555555,77.92
4030,85980,48,85980,8859,42,6,2.4390243902439024,20.21
4031,75408,48,75408,8113,46,2,2.127659574468085,17.49
4032,216,0,216,0,0,0,50.0,56.25
4033,1411020,81,0,104599,41,40,4.166666666666667,3.0
4034,2724,109,2724,247,47,62,7.6923076923076925,84.47
4035,756,6,0,264,5,1,100.0,0.0
4036,1449960,3257,0,130760,2017,1240,1.0,0.0
4037,756,29,756,21,24,5,4.761904761904762,11.55
4038,1418364,4676,0,399819,2714,1962,1.0,0.0
4039,3996,60,3996,84,60,0,1.694915254237288,6.27
4040,864,0,864,0,0,0,50.0,61.33
4041,1400544,618,0,19847,336,282,1.5384615384615383,0.0
4042,252,44,252,93,27,17,5.0,54.99
4043,160884,249,0,6282,111,138,1.7857142857142858,3.0
4044,780,85,780,307,73,12,1.4492753623188406,39.6
4045,429984,45,0,22572,18,27,33.333333333333336,0.0
4046,96576,122,96576,10256,42,80,16.666666666666668,58.83
4047,95820,35,95820,33336,30,5,11.11111111111111,21.76
4048,1380,2,1380,102,2,0,25.0,74.94
4049,6972,30,6972,643,28,2,14.285714285714286,36.74
4050,1404,1,0,1404,1,0,33.333333333333336,0.0
4051,943260,313,0,30390,184,129,2.083333333333333,0.0
4052,714972,1203,0,7450,570,633,1.0,0.0
4053,552,5,552,302,3,2,25.0,98.17
4054,549312,81,0,15419,36,45,6.25,0.0
4055,31692,44,0,3185,29,15,100.0,0.0
4056,146196,2,146196,996,2,0,25.0,92.95
4057,3144,3,3144,1312,2,1,33.333333333333336,95.47
4058,8592,0,8592,0,0,0,50.0,61.73
4059,1968,10,1968,900,9,1,10.0,17.56
4060,1140,2,1140,630,2,0,50.0,82.85
4061,54024,6,54024,600,6,0,12.5,49.83
4062,1680,12,1680,1515,6,6,20.0,81.35
4063,48,1,48,0,1,0,100.0,100.0
4064,804,30,804,139,30,0,4.0,71.13
4065,1110972,524,0,17749,294,230,1.408450704225352,0.0
4066,9996,4,9996,825,2,2,50.0,60.48
4067,1410180,2367,0,111224,1433,934,1.0,1.5
4068,204,0,204,0,0,0,50.0,56.25
4069,60,15,60,18,8,7,33.333333333333336,56.23
4070,680964,279,0,12113,145,134,4.0,0.0
4071,811680,241,0,24070,125,116,3.333333333333333,0.0
4072,64620,6,64620,2500,6,0,16.666666666666668,61.5
4073,132,6,132,26,3,3,50.0,57.5
4074,65064,23,65064,4611,11,12,14.285714285714286,91.74
4075,1252920,1378,0,20398,749,629,1.0,0.0
4076,45180,131,0,774,111,20,100.0,0.0
4077,2808,50,2808,14,48,2,2.2222222222222223,35.85
4078,876,48,876,8,44,4,2.272727272727273,10.35
4079,1257264,1067,0,20604,584,483,1.0101010101010102,0.0
4080,2148,111,2136,353,48,63,7.142857142857143,80.63
4081,0,0,0,0,0,0,50.0,0.0
4082,103452,1590,0,2677,1201,389,1.0,0.0
4083,222588,23,222588,35,21,2,4.545454545454546,40.11
4084,216,4,216,66,2,2,50.0,30.15
4085,1140,40,1140,618,35,5,3.703703703703704,53.64
4086,1107588,320,0,42559,192,128,2.5641025641025643,4.0
4087,852,9,852,304,9,0,10.0,72.94
4088,4896,24,4896,1733,13,11,33.333333333333336,84.76
4089,1056,24,1056,668,18,6,5.555555555555555,37.23
4090,514644,219,0,31317,126,93,1.0,0.0
4091,1454208,2095,0,351487,1173,922,1.0,0.45
4092,1292460,1288,222984,14831,672,616,1.0,9.51
4093,6324,13,6324,208,12,1,7.6923076923076925,82.37
4094,456,31,456,213,22,9,6.666666666666667,95.8
4095,276,1,276,36,1,0,33.333333333333336,64.24
4096,1089120,1239,0,5539,798,441,1.0,0.0
4097,33924,29,0,2359,25,4,50.0,0.0
4098,316044,155,0,2729,68,87,4.761904761904762,0.0
4099,3420,184,0,337,154,30,100.0,0.0
4100,1079700,98,0,14381,52,46,2.2222222222222223,0.0
4101,336,10,336,235,6,4,16.666666666666668,79.82
4102,1352508,293,0,9423,150,143,3.703703703703704,0.0
4103,35112,43,0,3394,34,9,100.0,0.0
4104,144,65,144,42,39,26,3.571428571428572,19.24
4105,10908,5,10908,1082,5,0,14.285714285714286,64.13
4106,1944,73,672,53,59,14,1.8867924528301887,31.78
4107,1480236,3394,0,152791,2005,1389,1.0,0.0
4108,684,46,684,69,45,1,2.1739130434782608,33.66
4109,1320,20,1320,1063,18,2,5.0,33.88
4110,240,61,240,53,49,12,1.96078431372549,23.05
4111,2448,182,0,378,95,87,2.9411764705882355,2.0
4112,375540,539,0,8958,284,255,3.0303030303030303,0.0
4113,1288404,368,0,11358,198,170,2.5,0.0
4114,296568,38,0,13045,33,5,50.0,0.0
4115,2448,5,2448,578,4,1,16.666666666666668,82.03
4116,847056,566,0,33735,281,285,1.4705882352941178,0.0
4117,2460,3,0,1012,2,1,33.333333333333336,0.0
4118,877380,196,0,14613,89,107,6.666666666666667,0.0
4119,41712,29,41712,19295,25,4,3.8461538461538463,43.7
4120,1428840,4511,0,37330,2501,2010,1.0,0.0
4121,285036,6,224250,3944,5,1,12.5,23.99
4122,1474548,595,0,69472,276,319,2.9411764705882355,0.0
4123,1107876,429,0,12046,231,198,3.0303030303030303,0.0
4124,1069716,295,0,9002,148,147,3.125,4.0
4125,8304,40,0,329,33,7,50.0,0.0
4126,13812,43,0,1348,28,15,100.0,0.0
4127,4404,148,0,1748,108,40,100.0,0.0
4128,3264,28,3264,516,23,5,5.0,52.79
4129,5472,147,0,734,116,31,100.0,0.0
4130,310212,27,310212,1177,23,4,5.882352941176471,33.07
4131,502104,347,0,4081,176,171,2.7777777777777777,0.0
4132,288,0,288,0,0,0,50.0,57.16
4133,732,4,732,24,2,2,50.0,63.42
4134,67548,54,0,5184,47,7,100.0,0.0
4135,348,23,348,216,21,2,4.3478260869565215,25.07
4136,1134252,1284,0,11297,696,588,1.0869565217391304,0.0
4137,8292,189,0,895,102,87,100.0,0.0
4138,535224,540,0,4254,280,260,3.0303030303030303,0.0
4139,52944,23,52944,813,21,2,5.2631578947368425,60.17
4140,48564,38,0,2665,31,7,50.0,0.0
4141,38316,39,38316,999,38,1,5.882352941176471,19.19
4142,10044,24,0,506,19,5,100.0,0.0
4143,84,2,84,18,1,1,50.0,64.9
4144,8196,13,8196,612,12,1,9.090909090909092,82.12
4145,4284,141,0,1076,103,38,100.0,0.0
4146,408,13,120,72,9,4,11.11111111111111,21.44
4147,156,1,156,0,1,0,33.333333333333336,75.0
4148,1400508,280,0,175296,180,100,1.0,0.0
4149,360,0,360,0,0,0,100.0,100.0
4150,456,12,456,100,11,1,8.333333333333334,18.67
4151,636,1,636,288,1,0,50.0,99.84
4152,23460,64,23460,16,50,14,2.2222222222222223,10.09
4153,348,4,348,36,2,2,50.0,98.81
4154,900,3,900,676,3,0,25.0,90.03
4155,492,39,492,10,37,2,2.631578947368421,54.0
4156,3408,82,3408,2978,59,23,2.857142857142857,74.69
4157,65640,50,0,2074,39,11,50.0,0.0
4158,24168,54,24168,47,44,10,2.4390243902439024,70.57
4159,1358196,2141,0,13984,1197,944,1.0,0.0
4160,78552,28,78552,737,20,8,4.545454545454546,21.62
4161,1032,62,1032,30,50,12,2.083333333333333,39.75
4162,79680,64,79680,1386,54,10,1.818181818181818,8.06
4163,1374624,30,0,46882,18,12,12.5,0.0
4164,1473012,452,0,176746,280,172,1.1494252873563218,0.0
4165,0,0,0,0,0,0,100.0,0.0
4166,3504,150,0,812,87,63,100.0,0.0
4167,10200,40,0,1224,26,14,100.0,0.0
4168,1384392,1951,6264,159545,930,1021,2.9411764705882355,0.0
4169,4956,63,4926,1689,44,19,100.0,100.0
4170,27000,55,27000,18,47,8,2.2222222222222223,67.58
4171,460800,730,0,2902,541,189,1.0,0.0
4172,2892,1,2892,312,1,0,33.333333333333336,93.2
4173,11628,2,11628,414,2,0,20.0,95.29
4174,732,71,732,66,64,7,1.639344262295082,30.69
4175,1020,52,1020,441,37,15,3.571428571428572,46.44
4176,804,10,804,348,7,3,16.666666666666668,48.34
4177,384,4,384,66,2,2,100.0,100.0
4178,86388,285,0,12292,204,81,100.0,0.0
4179,228,6,228,8,6,0,12.5,55.3
4180,1492032,1849,0,47911,1092,757,1.0,0.0
4181,516,56,516,13,44,12,2.5,41.95
4182,267084,484,0,1834,303,181,1.0,0.0
4183,249240,36,249240,2648,27,9,5.2631578947368425,38.28
4184,624,43,624,3,39,4,2.5,39.07
4185,1199484,57,0,66808,43,14,25.0,0.0
4186,456,47,456,12,37,10,2.9411764705882355,13.92
4187,792,0,792,0,0,0,100.0,100.0
4188,1149216,176,0,276433,72,104,5.882352941176471,5.0
4189,99852,50,0,4531,39,11,25.0,0.0
4190,7032,23,7032,387,19,4,5.882352941176471,82.56
4191,1200,33,1200,66,31,2,3.0303030303030303,48.82
4192,59556,48,0,2473,38,10,50.0,0.0
4193,348,1,348,156,1,0,33.333333333333336,99.83
4194,1812,44,1812,12,36,8,2.9411764705882355,13.74
4195,1728,30,1728,801,24,6,5.2631578947368425,80.35
4196,420,4,420,204,4,0,25.0,99.28
4197,468,7,468,157,7,0,11.11111111111111,86.05
4198,552,82,552,29,64,18,1.7543859649122806,31.05
4199,564,73,564,26,53,20,2.2222222222222223,37.94
4200,12108,18,12108,675,17,1,5.882352941176471,81.5
4201,504,45,504,10,35,10,3.125,14.11
4202,5616,254,0,1749,148,106,100.0,0.0
4203,146880,35,0,5413,27,8,100.0,0.0
4204,1503516,20507,79178,217726,11649,8858,1.0,0.0
4205,5256,2,5256,228,2,0,25.0,87.01
4206,1326024,958,0,8451,533,425,1.7543859649122806,0.0
4207,80040,8,80040,573,7,1,12.5,57.27
4208,75420,17,75420,832,15,2,9.090909090909092,45.32
4209,60300,13,60300,477,10,3,11.11111111111111,83.34
4210,16296,227,0,1097,184,43,100.0,0.0
4211,10200,44,0,1159,28,16,100.0,0.0
4212,81168,23,81168,2201,21,2,5.0,36.12
4213,696,1,696,24,1,0,33.333333333333336,58.97
4214,59412,39,59412,1143,32,7,4.0,71.44
4215,6636,18,6636,420,15,3,7.142857142857143,88.53
4216,1488396,2349,0,327970,1344,1005,1.0,2.97
4217,504,34,504,100,22,12,9.090909090909092,84.75
4218,18420,32,18420,1314,28,4,4.166666666666667,40.13
4219,178140,47,178140,2798,44,3,2.380952380952381,22.19
4220,10116,23,10116,512,19,4,5.882352941176471,85.35
4221,28308,32,28308,28240,26,6,4.0,45.18
4222,12900,51,0,1002,38,13,50.0,0.0
4223,1136076,112,516336,148618,102,10,1.3333333333333333,9.18
4224,23040,36,23040,1217,31,5,4.166666666666667,59.89
4225,13248,48,0,1185,38,10,50.0,0.0
4226,252,114,252,53,54,60,3.8461538461538463,78.42
4227,60,2,60,0,2,0,25.0,0.84
4228,1680,8,1680,1117,6,2,14.285714285714286,91.66
4229,1106616,52,0,39287,40,12,33.333333333333336,0.0
4230,12540,34,0,1483,27,7,100.0,0.0
4231,384,53,0,86,39,14,100.0,0.0
4232,16944,47,0,1061,36,11,50.0,0.0
4233,12,3,0,12,3,0,20.0,0.0
4234,17328,45,0,1002,33,12,50.0,0.0
4235,12756,40,0,1349,25,15,100.0,0.0
4236,3864,26,3864,767,21,5,5.882352941176471,75.07
4237,8508,10,8508,2150,6,4,33.333333333333336,83.26
4238,1227240,104,30042,39497,73,31,7.142857142857143,14.08
4239,324,58,324,70,48,10,2.3255813953488373,31.02
4240,179640,29,179640,725,23,6,5.882352941176471,70.6
4241,1389576,1573,0,13947,858,715,1.0,0.0
4242,252768,90,0,70225,53,37,2.7777777777777777,0.0
4243,77544,28,0,4329,26,2,50.0,0.0
4244,1740,42,0,705,35,7,100.0,0.0
4245,12396,20,12396,230,16,4,7.6923076923076925,70.58
4246,31272,57,0,1648,49,8,50.0,0.0
4247,10200,39,10200,1980,23,16,10.0,76.85
4248,2292,5,2292,988,5,0,20.0,63.02
4249,1451664,1760,8784,16974,998,762,1.0638297872340423,2.8
4250,264,41,264,178,15,26,25.0,70.96
4251,33948,38,0,1989,30,8,50.0,0.0
4252,2916,73,0,971,55,18,100.0,0.0
4253,156,99,156,10,91,8,1.1235955056179776,16.68
4254,5640,39,0,1120,25,14,100.0,0.0
4255,1150656,48,0,123479,39,9,5.2631578947368425,0.0
4256,1337652,938,0,46938,511,427,1.2658227848101269,0.0
4257,1309056,66,175344,298638,36,30,2.5641025641025643,0.0
4258,1522356,534,0,650428,349,185,1.0,0.0
4259,7812,114,0,1505,88,26,100.0,0.0
4260,33312,124,0,1793,64,60,7.142857142857143,0.0
4261,437316,35,437316,396652,32,3,3.225806451612903,66.04
4262,857796,47,27156,19200,37,10,4.761904761904762,64.72
4263,1440,28,1440,319,26,2,9.090909090909092,36.31
4264,1526280,5433,0,240871,3026,2407,1.0,0.0
4265,18168,48,0,1082,35,13,50.0,0.0
4266,19080,49,0,1134,40,9,50.0,0.0
4267,706932,429,0,18095,229,200,2.631578947368421,0.0
4268,15300,48,0,1044,36,12,50.0,0.0
4269,25896,27,25896,347,23,4,5.2631578947368425,70.41
4270,444,50,444,66,34,16,3.571428571428572,67.59
4271,37620,8,24174,20326,7,1,50.0,99.96
4272,15708,51,0,1069,39,12,50.0,0.0
4273,840,45,840,372,33,12,5.555555555555555,67.64
4274,33120,79,33120,498,67,12,1.5873015873015872,7.71
4275,30084,18,30084,774,14,4,9.090909090909092,44.0
4276,14328,33,14328,452,28,5,5.0,73.65
4277,3552,12,3552,418,12,0,33.333333333333336,97.48
4278,924,2,924,540,2,0,50.0,99.8
4279,1528560,68,35256,23112,54,14,2.083333333333333,9.99
4280,2916,5,2916,1257,4,1,100.0,100.0
4281,354900,59,0,34586,42,17,33.333333333333336,0.0
4282,288,0,288,0,0,0,100.0,100.0
4283,101904,33,101904,1551,29,4,7.142857142857143,40.57
4284,45588,3,0,15244,2,1,12.5,0.0
4285,1092,10,1092,499,6,4,33.333333333333336,99.04
4286,1632,47,1632,687,39,8,3.333333333333333,68.39
4287,132,0,132,0,0,0,50.0,59.29
4288,264,7,264,56,5,2,20.0,20.85
4289,54576,41,54576,1436,36,5,4.0,33.97
4290,12780,136,8580,10971,88,48,3.571428571428572,46.46
4291,3588,0,3102,0,0,0,100.0,100.0
4292,1704,39,1704,698,31,8,3.8461538461538463,70.07
4293,115092,20,115092,1035,16,4,9.090909090909092,47.78
4294,719448,74,243027,105833,74,0,3.125,95.17
4295,40776,17,40776,686,14,3,7.6923076923076925,82.61
4296,8628,34,8628,881,29,5,4.545454545454546,74.07
4297,588,43,588,22,41,2,2.380952380952381,43.48
4298,678840,598,487227,348882,597,1,1.0,72.82
4299,7032,37,7032,969,35,2,6.25,16.61
4300,864,54,864,27,44,10,2.4390243902439024,61.67
4301,972,44,972,21,42,2,2.3255813953488373,40.2
4302,3888,0,3888,0,0,0,100.0,100.0
4303,126192,16,0,13212,15,1,50.0,0.0
4304,1367052,788,0,4961,526,262,1.0,0.0
4305,63624,19,0,29676,10,9,33.333333333333336,0.0
4306,1284,2,1284,18,1,1,50.0,69.11
4307,3408,3,0,2204,0,3,100.0,0.0
4308,12420,35,12420,1447,27,8,6.666666666666667,30.25
4309,42924,18,0,2750,11,7,14.285714285714286,0.0
4310,180,67,120,27,57,10,1.96078431372549,39.51
4311,168,12,168,0,12,0,7.142857142857143,33.6
4312,504,71,504,18,57,14,1.9230769230769231,34.97
4313,9300,10,9300,470,9,1,14.285714285714286,58.38
4314,1224,84,1224,40,72,12,1.4492753623188406,26.28
4315,63792,16,63792,1039,15,1,5.882352941176471,45.88
4316,7308,3,7308,276,3,0,25.0,92.98
4317,156,5,156,28,3,2,33.333333333333336,76.56
4318,16272,37,16272,1197,34,3,3.703703703703704,74.05
4319,1065912,49,0,31618,26,23,8.333333333333334,5.0
4320,2256,85,600,514,44,41,4.761904761904762,32.45
4321,57156,31,6276,2635,30,1,20.0,40.34
4322,5148,4,5148,174,4,0,16.666666666666668,95.73
4323,2004,37,1824,1710,26,11,6.25,83.08
4324,71028,9,71028,2073,9,0,10.0,45.72
4325,666300,532,0,9924,381,151,1.0,0.0
4326,580572,74,0,177102,49,25,33.333333333333336,0.0
4327,73440,242,0,2556,121,121,3.225806451612903,2.0
4328,1608,0,1608,0,0,0,50.0,95.0
4329,1548804,5651,0,55887,3394,2257,1.0,0.0
4330,180,44,180,61,25,19,12.5,91.24
4331,33696,29,33696,889,24,5,5.882352941176471,59.99
4332,1270056,1025,0,13362,567,458,1.7543859649122806,0.0
4333,28620,123,0,2380,63,60,5.555555555555555,5.0
4334,192,3,84,64,3,0,25.0,54.72
4335,1429344,377,2046,223777,236,141,1.2195121951219512,7.13
4336,528,54,528,30,50,4,2.0,38.47
4337,754068,0,754068,0,0,0,100.0,100.0
4338,9684,36,9684,1235,30,6,4.0,71.38
4339,948,40,948,4,40,0,2.380952380952381,58.3
4340,3864,18,3864,1166,12,6,12.5,94.44
4341,45360,54,45360,1479,42,12,2.380952380952381,14.45
4342,3216,24,3216,387,22,2,7.142857142857143,33.35
4343,636,31,636,64,31,0,3.225806451612903,30.72
4344,1287168,183,0,11717,99,84,7.6923076923076925,2.5
4345,912,34,912,4,30,4,3.333333333333333,14.75
4346,1079232,1478,0,22735,690,788,1.2987012987012987,0.0
4347,23256,7,192,3387,6,1,20.0,93.15
4348,540048,4,0,286008,2,2,1.0,0.0
4349,1003476,1544,0,4116,960,584,1.0,0.0
4350,564,61,564,26,53,8,1.96078431372549,38.84
4351,12240,22,12240,858,17,5,7.6923076923076925,86.89
4352,1416,0,1416,0,0,0,100.0,100.0
4353,36960,57,0,2320,52,5,50.0,0.0
4354,6744,33,6744,1634,28,5,4.761904761904762,58.31
4355,0,0,0,0,0,0,50.0,0.0
4356,67188,39,9144,4837,37,2,7.142857142857143,27.4
4357,56784,17,0,4905,13,4,7.6923076923076925,0.0
4358,41964,121,22656,2990,89,32,8.333333333333334,10.25
4359,39108,51,0,1607,41,10,50.0,0.0
4360,5988,38,5988,32,35,3,2.7777777777777777,50.02
4361,1170768,829,0,2933,574,255,1.0,0.0
4362,156,13,156,32,7,6,16.666666666666668,62.25
4363,693180,42,0,52031,32,10,33.333333333333336,0.0
4364,4176,25,4176,1264,21,4,5.882352941176471,64.42
4365,40488,64,0,10385,51,13,100.0,0.0
4366,13356,18,13356,1280,17,1,5.555555555555555,98.4
4367,6372,122,5460,2560,79,43,2.5,60.32
4368,132,6,132,16,4,2,25.0,57.01
4369,13800,40,0,1312,25,15,100.0,0.0
4370,13404,25,13404,981,22,3,5.0,72.99
4371,1656,9,1656,41,6,3,20.0,49.33
4372,1208016,1623,0,17732,783,840,1.0,0.0
4373,1584,16,1584,462,13,3,9.090909090909092,80.91
4374,1356,0,1356,0,0,0,50.0,85.0
4375,1388940,200,0,909618,120,80,2.5,0.0
4376,456,2,456,108,2,0,25.0,58.76
4377,33396,47,0,1381,37,10,50.0,0.0
4378,2148,21,1068,662,17,4,7.6923076923076925,78.64
4379,46992,76,46992,1278,45,31,7.142857142857143,82.43
4380,6900,43,6900,1422,42,1,3.125,26.27
4381,25476,11,25476,18173,10,1,10.0,21.95
4382,804,40,804,141,33,7,4.0,49.03
4383,228,13,228,49,12,1,8.333333333333334,67.01
4384,1032,14,1032,727,10,4,16.666666666666668,91.55
4385,173916,1,173916,396,1,0,100.0,100.0
4386,49692,50,0,3327,43,7,50.0,0.0
4387,686340,655,0,7339,350,305,2.631578947368421,0.0
4388,120432,268,0,22571,182,86,50.0,0.0
4389,7164,28,7164,766,25,3,4.545454545454546,66.05
4390,156,64,156,93,42,22,3.0303030303030303,45.19
4391,9540,5,9540,9384,5,0,16.666666666666668,90.0
4392,15852,31,15852,655,23,8,7.142857142857143,89.28
4393,7788,12,7788,298,10,2,12.5,80.69
4394,1488,11,1488,113,9,2,11.11111111111111,28.86
4395,168,77,168,34,63,14,2.5641025641025643,66.48
4396,27204,12,27204,552,10,2,14.285714285714286,58.63
4397,96,3,96,20,3,0,20.0,61.16
4398,57828,25,57828,1169,20,5,5.555555555555555,41.04
4399,8352,34,8352,922,28,6,4.761904761904762,54.65
4400,148884,69,288,2250,52,17,2.857142857142857,54.08
4401,10236,45,0,1213,29,16,100.0,0.0
4402,84,7,84,6,5,2,20.0,21.51
4403,44292,50,0,1676,39,11,50.0,0.0
4404,16296,49,16296,51,36,13,3.225806451612903,57.32
4405,3480,21,3480,412,17,4,7.6923076923076925,81.55
4406,44616,50,0,1738,37,13,50.0,0.0
4407,18072,37,18072,29,33,4,3.0303030303030303,14.09
4408,709632,10,0,71247,6,4,25.0,0.0
4409,2196,34,2196,180,30,4,5.2631578947368425,39.38
4410,47304,48,0,1640,35,13,50.0,0.0
4411,1560648,3233,651744,60242,1791,1442,1.0,0.0
4412,492,34,144,34,25,9,4.545454545454546,0.0
4413,318924,244,0,4645,117,127,3.4482758620689653,2.38
4414,180,1,180,0,1,0,33.333333333333336,30.2
4415,86016,340,0,12946,235,105,2.631578947368421,0.0
4416,119100,19,119100,116334,19,0,20.0,99.86
4417,5376,33,5376,1189,28,5,4.3478260869565215,54.82
4418,14304,48,0,1020,34,14,50.0,0.0
4419,192,7,192,6,6,1,14.285714285714286,56.71
4420,149904,28,0,12610,25,3,20.0,0.0
4421,108,3,108,36,3,0,25.0,91.16
4422,9324,21,7224,872,17,4,6.25,87.16
4423,3840,16,3840,530,14,2,7.142857142857143,0.0
4424,1564500,3904,711276,127240,2302,1602,1.0,0.0
4425,96,1,0,96,1,0,33.333333333333336,20.33
4426,168612,9,168612,83156,8,1,11.11111111111111,96.99
4427,1538256,15,0,392791,13,2,2.083333333333333,0.69
4428,792,70,792,89,40,30,3.571428571428572,58.04
4429,23628,57,0,2289,50,7,50.0,0.0
4430,724440,174,724440,6317,90,84,5.555555555555555,91.94
4431,17760,55,17760,1814,42,13,2.380952380952381,14.99
4432,21924,36,0,2531,29,7,100.0,0.0
4433,9492,35,9492,1276,28,7,4.761904761904762,44.71
4434,9012,10,9012,2475,9,1,100.0,99.99
4435,467928,177,0,54830,146,31,100.0,0.0
4436,1249836,451,0,57920,235,216,2.702702702702702,1.74
4437,1164,4,0,993,3,1,25.0,10.78
4438,12000,44,0,1266,29,15,100.0,0.0
4439,71628,28,71628,1108,23,5,5.555555555555555,93.62
4440,14364,22,14364,534,19,3,5.882352941176471,86.1
4441,18120,48,0,2960,40,8,50.0,0.0
4442,1445124,5359,23796,34781,3062,2297,1.0,0.0
4443,48,11,48,10,7,4,20.0,27.26
4444,10680,50,10680,1776,41,9,3.571428571428572,54.89
4445,528,51,528,11,51,0,1.9230769230769231,47.89
4446,12108,59,0,1332,53,6,50.0,0.0
4447,16644,48,0,1102,37,11,50.0,0.0
4448,14400,53,0,1063,39,14,50.0,0.0
4449,132,24,132,28,17,7,8.333333333333334,55.57
4450,11784,52,0,1485,43,9,50.0,0.0
4451,710412,46,0,29724,30,16,50.0,0.0
4452,7872,48,7872,1686,40,8,3.225806451612903,63.86
4453,132,0,132,0,0,0,25.0,49.71
4454,696,25,696,193,25,0,6.25,83.53
4455,83460,32,83460,2856,27,5,5.0,37.44
4456,1332,1,0,1332,0,1,100.0,0.0
4457,25560,50,0,1172,37,13,50.0,0.0
4458,1575972,694,0,65700,410,284,1.5384615384615383,0.0
4459,408,3,0,292,2,1,50.0,0.0
4460,51060,86,51060,1927,72,14,2.127659574468085,55.98
4461,648,2,648,264,1,1,50.0,90.0
4462,25332,51,0,1393,37,14,50.0,0.0
4463,1548,1,0,1548,0,1,100.0,0.0
4464,12468,48,0,1034,39,9,50.0,0.0
4465,28632,19,0,2235,17,2,100.0,0.0
4466,20640,31,0,2540,24,7,100.0,0.0
4467,10200,42,0,1200,27,15,100.0,0.0
4468,1068,27,1068,447,27,0,4.3478260869565215,82.57
4469,11916,48,0,958,38,10,50.0,0.0
4470,74904,6,74904,2676,5,1,16.666666666666668,76.74
4471,1292196,532,0,25517,298,234,1.96078431372549,2.0
4472,1558680,1719,9858,16441,973,746,1.1494252873563218,0.0
4473,34236,57,34236,1553,46,11,4.3478260869565215,65.64
4474,34152,381,0,4120,275,106,33.333333333333336,90.0
4475,1128624,3033,0,16641,1683,1350,1.0,0.0
4476,1551144,5657,14644,39222,3274,2383,1.0,0.0
4477,1284468,1273,0,67411,831,442,1.2658227848101269,0.0
4478,26436,32,26436,54,31,1,3.571428571428572,33.11
4479,1437372,740,0,11931,411,329,1.6666666666666667,0.0
4480,732,0,732,0,0,0,50.0,59.29
4481,852,1,852,636,1,0,50.0,70.1
4482,74952,13,74952,706,11,2,12.5,66.18
4483,46212,26,30636,2832,20,6,7.6923076923076925,83.72
4484,112488,149,0,1093,124,25,100.0,0.0
4485,210720,55,0,6766,39,16,25.0,0.0
4486,3240,12,3240,38,7,5,25.0,63.38
4487,1077888,455,0,9142,250,205,3.333333333333333,0.0
4488,240,4,84,108,3,1,25.0,99.81
4489,1920,1,1920,1632,1,0,25.0,60.0
4490,48408,27,48408,1377,23,4,8.333333333333334,43.87
4491,408,1,408,144,1,0,33.333333333333336,57.8
4492,1463616,1421,0,61371,746,675,1.075268817204301,0.0
4493,396,21,396,108,21,0,4.761904761904762,51.7
4494,4248,7,4248,596,6,1,14.285714285714286,92.97
4495,4584,30,4584,4000,18,12,8.333333333333334,50.95
4496,1308696,41,1308696,3644,23,18,9.090909090909092,0.0
4497,252,3,252,60,1,2,50.0,99.48
4498,72,5,72,24,5,0,14.285714285714286,53.98
4499,348,7,348,185,5,2,16.666666666666668,67.72
4500,63888,12,0,7050,7,5,33.333333333333336,0.0
4501,240,0,240,0,0,0,50.0,65.44
4502,13092,39,13092,2093,30,9,6.666666666666667,39.33
4503,205704,55,12576,20178,51,4,3.225806451612903,13.16
4504,79356,43,0,17885,29,14,14.285714285714286,0.0
4505,84,0,84,0,0,0,50.0,65.44
4506,72,31,60,22,23,8,5.555555555555555,17.02
4507,1205412,536,0,12694,294,242,1.9230769230769231,0.0
4508,528,30,528,92,28,2,3.8461538461538463,42.41
4509,1452,1,1452,192,1,0,50.0,65.78
4510,12000,48,0,1123,33,15,100.0,0.0
4511,72,29,60,17,20,9,7.142857142857143,53.35
4512,492,4,492,66,3,1,25.0,58.22
4513,233136,69,233136,2933,25,44,20.0,97.99
4514,21888,35,21888,56,35,0,2.7777777777777777,43.55
4515,88884,34,88884,77030,25,9,4.761904761904762,69.59
4516,84,1,84,72,1,0,33.333333333333336,30.35
4517,267504,0,267444,0,0,0,20.0,63.56
4518,23040,38,23040,64,32,6,3.225806451612903,42.85
4519,96,3,96,32,2,1,33.333333333333336,34.16
4520,876,65,876,43,53,12,2.0408163265306123,25.98
4521,3132,9,3132,461,9,0,10.0,60.96
4522,24348,39,24348,41,35,4,2.857142857142857,49.06
4523,9384,6,9384,570,4,2,25.0,91.23
4524,1630200,2366,0,182171,1322,1044,1.0,0.0
4525,24936,39,24936,22,29,10,4.0,23.25
4526,30744,20,27403,19533,19,1,6.666666666666667,25.04
4527,2448,17,0,1198,17,0,14.285714285714286,0.0
4528,1634940,2287,401424,307507,1231,1056,1.0,2.0
4529,768,49,768,54,47,2,2.083333333333333,61.93
4530,2868,9,2868,0,9,0,9.090909090909092,55.85
4531,1597896,5677,0,137405,3246,2431,1.0,0.0
4532,1944,0,1944,0,0,0,50.0,64.0
4533,38556,26,1296,1495,25,1,3.703703703703704,35.5
4534,9696,11,9696,76,6,5,33.333333333333336,51.19
4535,52572,28,52572,1268,24,4,5.2631578947368425,41.53
4536,17460,20,17460,699,15,5,16.666666666666668,39.82
4537,408,0,408,0,0,0,50.0,60.51
4538,1618056,913,0,28997,497,416,1.492537313432836,0.0
4539,1498296,325,0,56053,162,163,3.703703703703704,0.0
4540,409440,89,0,7848,36,53,12.5,0.0
4541,5352,16,4518,745,14,2,7.142857142857143,56.88
4542,11364,8,11364,1513,8,0,12.5,77.23
4543,1632996,3796,1031844,451690,2072,1724,1.0,0.0
4544,12828,41,12828,929,40,1,5.882352941176471,17.34
4545,660,22,660,164,14,8,8.333333333333334,91.56
4546,1800,1,1800,204,1,0,50.0,40.0
4547,34848,28,0,3674,25,3,100.0,0.0
4548,30228,147,0,3084,58,89,10.0,39.97
4549,12024,45,0,1267,29,16,100.0,0.0
4550,206160,81,69804,7397,65,16,1.5873015873015872,20.88
4551,1281768,59,0,93906,45,14,16.666666666666668,0.0
4552,14808,47,4224,1442,44,3,5.555555555555555,14.83
4553,17856,3,17856,548,3,0,33.333333333333336,68.1
4554,41292,48,0,1522,36,12,50.0,0.0
4555,721812,496,5352,8396,253,243,2.7777777777777777,0.0
4556,84,7,84,22,4,3,33.333333333333336,58.57
4557,31896,28,31896,1382,24,4,5.882352941176471,76.81
4558,209580,39,50100,14931,29,10,5.2631578947368425,54.64
4559,1479768,789,0,13082,440,349,1.96078431372549,0.0
4560,9276,31,1968,1032,22,9,6.666666666666667,81.18
4561,54072,34,54072,1448,28,6,5.555555555555555,35.65
4562,5388,2,5388,984,2,0,25.0,96.07
4563,828744,698,0,9048,378,320,2.1739130434782608,0.0
4564,52836,201,0,5085,117,84,100.0,0.0
4565,1375620,103,0,66382,49,54,7.142857142857143,0.0
4566,7344,43,7344,1021,41,2,5.882352941176471,13.44
4567,832752,47,0,97556,38,9,16.666666666666668,0.0
4568,12144,6,0,5386,4,2,20.0,15.75
4569,1470936,228,357878,209100,228,0,1.4492753623188406,88.54
4570,3360,86,0,1228,67,19,100.0,0.0
4571,1292820,60,0,29266,46,14,25.0,0.0
4572,49392,48,0,2442,38,10,50.0,0.0
4573,1640520,50,0,44358,41,9,20.0,0.0
4574,2160,1,2160,492,1,0,50.0,93.71
4575,426672,9,426672,83880,9,0,11.11111111111111,98.61
4576,64128,57,0,2695,44,13,50.0,0.0
4577,261756,0,261756,0,0,0,100.0,100.0
4578,931104,796,0,8854,438,358,1.5873015873015872,1.0
4579,427548,193,214070,109925,193,0,1.5625,81.19
4580,10200,41,0,1227,26,15,100.0,0.0
4581,32544,15,32544,889,12,3,10.0,61.44
4582,6444,53,6444,1185,51,2,4.0,13.25
4583,1464,0,1464,0,0,0,100.0,100.0
4584,1664064,16478,399984,294582,9939,6539,1.0,0.0
4585,99540,5,50058,535,3,2,50.0,99.97
4586,1546008,55,0,111411,44,11,20.0,0.0
4587,60,4,48,24,2,2,33.333333333333336,59.35
4588,62700,26,62700,586,23,3,4.761904761904762,64.45
4589,186072,323,0,3233,175,148,3.4482758620689653,0.0
4590,564,2,564,372,1,1,50.0,12.38
4591,8328,46,0,821,34,12,50.0,0.0
4592,88176,327,0,9366,217,110,100.0,0.0
4593,9324,20,9324,376,18,2,9.090909090909092,62.36
4594,252,7,252,75,6,1,14.285714285714286,53.24
4595,480,33,480,36,31,2,3.125,49.33
4596,9552,48,0,718,32,16,50.0,0.0
4597,174180,6,174180,72,4,2,25.0,74.84
4598,984,49,984,23,41,8,2.5641025641025643,12.84
4599,744,50,174,95,42,8,2.5641025641025643,0.0
4600,1603116,577,0,14921,292,285,3.4482758620689653,0.0
4601,996,44,996,58,38,6,2.702702702702702,7.09
4602,11484,20,11484,439,17,3,6.25,88.78
4603,252,1,252,72,1,0,33.333333333333336,73.6
4604,287196,49,0,6730,37,12,25.0,0.0
4605,64500,41,0,4346,32,9,100.0,0.0
4606,72552,44,72552,1932,37,7,3.8461538461538463,31.0
4607,76464,41,0,8113,37,4,50.0,0.0
4608,1670484,3329,79032,71453,1833,1496,1.0,0.0
4609,240,1,240,0,1,0,33.333333333333336,97.29
4610,12204,44,0,1354,37,7,50.0,0.0
4611,4872,24,4872,446,20,4,5.882352941176471,87.6
4612,10236,47,0,1198,30,17,100.0,0.0
4613,1008,2,1008,378,2,0,7.6923076923076925,68.38
4614,84780,29,0,4506,25,4,100.0,0.0
4615,60,22,60,14,13,9,20.0,19.03
4616,888,19,0,310,14,5,100.0,0.0
4617,684,36,84,47,22,14,10.0,67.34
4618,169860,27,169860,3420,26,1,4.0,35.39
4619,78600,61,78600,2472,50,11,3.125,53.63
4620,816,4,816,342,4,0,25.0,97.12
4621,311844,32,311844,11,20,12,6.25,52.71
4622,48,8,48,19,4,4,50.0,58.99
4623,42900,32,0,3449,28,4,25.0,0.0
4624,1254132,779,0,286693,279,500,2.0,0.0
4625,1058652,281,0,11551,146,135,2.9411764705882355,4.75
4626,83724,34,83724,1812,26,8,5.555555555555555,35.77
4627,10212,41,0,1224,26,15,100.0,0.0
4628,348,3,0,172,2,1,100.0,0.0
4629,72,1,72,24,1,0,33.333333333333336,30.5
4630,12540,57,0,1751,47,10,50.0,0.0
4631,8184,30,8184,592,27,3,4.0,75.6
4632,564,1,564,216,1,0,33.333333333333336,22.65
4633,1385040,1452,0,42477,790,662,1.162790697674419,0.0
4634,684,10,0,325,6,4,100.0,0.0
4635,621420,192,0,5412,88,104,4.3478260869565215,0.0
4636,1464,23,1464,284,23,0,5.555555555555555,76.12
4637,96,55,84,30,30,25,5.882352941176471,19.51
4638,3408,29,3408,651,25,4,5.0,53.01
4639,107724,3,107724,13604,3,0,2.1739130434782608,6.23
4640,16572,52,0,1771,50,2,50.0,0.0
4641,22092,37,22092,467,30,7,4.545454545454546,48.71
4642,90960,107,90960,3198,56,51,14.285714285714286,71.86
4643,1691124,3862,0,78942,2129,1733,1.0,0.0
4644,1173924,243,0,8046,116,127,3.225806451612903,0.0
4645,7164,46,0,1423,37,9,50.0,0.0
4646,1208076,186,0,19957,88,98,2.857142857142857,3.3
4647,4296,38,4296,844,31,7,4.0,64.57
4648,10212,39,0,1247,24,15,100.0,0.0
4649,1078692,898,0,78680,476,422,2.272727272727273,0.0
4650,1701132,4377,0,479581,2579,1798,1.0,0.0
4651,25752,48,0,1644,40,8,50.0,0.0
4652,26064,48,0,1303,36,12,50.0,0.0
4653,26448,51,0,1325,38,13,50.0,0.0
4654,208584,104,0,3348,80,24,50.0,0.0
4655,1655220,53,0,94953,41,12,25.0,0.0
4656,29472,42,29472,1210,35,7,3.8461538461538463,61.12
4657,1152,4,1152,84,4,0,16.666666666666668,54.02
4658,84,5,84,38,2,3,100.0,100.0
4659,33540,38,33540,46,38,0,2.5,12.65
4660,0,1,0,0,1,0,50.0,0.0
4661,504,4,0,336,2,2,50.0,0.0
4662,20664,9,20664,276,9,0,8.333333333333334,81.18
4663,44820,413,0,5829,269,144,100.0,0.0
4664,60,4,60,12,2,2,50.0,30.16
4665,369420,22,66768,39369,18,4,10.0,61.45
4666,69780,67,0,2491,31,36,12.5,0.0
4667,572556,45,39744,15808,39,6,2.702702702702702,0.0
4668,444,15,444,210,15,0,6.25,79.43
4669,395064,32,0,31842,18,14,50.0,0.0
4670,25668,7,22128,13880,5,2,1.0,0.0
4671,13800,45,0,1625,29,16,100.0,0.0
4672,17364,48,17364,574,43,5,2.9411764705882355,74.24
4673,47136,46,47136,992,45,1,7.142857142857143,13.07
4674,648,36,648,176,27,9,4.545454545454546,69.58
4675,2556,21,2556,523,15,6,10.0,68.77
4676,276,0,276,0,0,0,33.333333333333336,72.18
4677,19152,223,0,1807,132,91,1.5625,0.0
4678,108,24,108,25,18,6,5.882352941176471,48.73
4679,420,4,420,210,2,2,33.333333333333336,78.46
4680,1516512,2229,92880,34444,1287,942,1.0,0.0
4681,84,5,84,24,3,2,25.0,42.42
4682,2820,39,0,966,28,11,100.0,100.0
4683,74652,3,74652,22892,2,1,50.0,0.0
4684,612,40,612,96,34,6,3.0303030303030303,14.72
4685,4392,55,4392,1666,52,3,6.25,24.3
4686,42300,1,42300,0,1,0,50.0,0.0
4687,1308,9,1308,736,7,2,16.666666666666668,91.33
4688,501708,175,0,3654,82,93,5.2631578947368425,3.0
4689,144,31,144,30,19,12,6.666666666666667,58.99
4690,3132,39,3132,179,37,2,3.125,35.14
4691,72,2,72,18,1,1,50.0,74.12
4692,1421172,589,0,30229,328,261,1.96078431372549,0.0
4693,600,1,600,276,1,0,33.333333333333336,60.86
4694,23244,42,23244,1547,38,4,3.0303030303030303,73.25
4695,1380,48,528,405,24,24,7.6923076923076925,90.92
4696,57912,21,57912,1002,18,3,9.090909090909092,54.5
4697,12000,40,0,1256,27,13,100.0,0.0
4698,132,4,132,18,2,2,50.0,59.67
4699,1394736,3616,0,55423,2031,1585,1.0,0.0
4700,1944,31,1944,686,28,3,3.8461538461538463,58.79
4701,828,0,828,0,0,0,50.0,95.75
4702,1716396,1571,0,52525,878,693,1.0,0.0
4703,1643052,319,0,594328,184,135,1.0,0.0
4704,312,37,312,181,24,13,50.0,98.0
4705,108,0,108,0,0,0,50.0,60.92
4706,28032,106,28032,1944,59,47,3.225806451612903,76.79
4707,227040,19,222216,28174,16,3,6.666666666666667,2.52
4708,120,34,120,13,24,10,6.25,39.33
4709,165960,93,165960,2381,71,22,8.333333333333334,10.81
4710,25248,37,25248,1020,33,4,4.0,58.82
4711,10200,69,10200,6173,65,4,1.5151515151515151,54.32
4712,7188,3,7188,320,3,0,20.0,38.2
4713,204792,15,0,25048,11,4,100.0,0.0
4714,1284,8,1284,153,8,0,11.11111111111111,85.12
4715,324,174,324,106,142,32,1.0,39.76
4716,612,10,0,298,8,2,50.0,0.0
4717,14100,11,14100,2356,7,4,33.333333333333336,59.21
4718,33288,26,0,3241,21,5,50.0,0.0
4719,254124,22,254124,3709,19,3,5.882352941176471,4.93
4720,13200,40,13200,1056,40,0,4.166666666666667,19.5
4721,216,19,216,33,17,2,5.555555555555555,50.19
4722,825300,268,0,18578,137,131,5.555555555555555,0.0
4723,8256,6,5178,930,6,0,20.0,78.71
4724,60,30,60,22,22,8,6.25,13.66
4725,96,10,96,31,6,4,20.0,93.13
4726,16680,32,16680,33,28,4,3.571428571428572,47.84
4727,203292,162,0,2559,77,85,6.25,1.18
4728,408,1,0,408,0,1,100.0,0.0
4729,1332324,50,15408,108327,41,9,50.0,0.0
4730,1698972,1426,0,21924,768,658,1.0,0.0
4731,92208,40,0,10453,34,6,25.0,0.0
4732,1260,9,1260,292,6,3,16.666666666666668,68.38
4733,1472940,177,0,68026,83,94,5.555555555555555,0.0
4734,240,0,240,0,0,0,50.0,55.14
4735,1610568,760,0,65865,436,324,1.6129032258064515,2.1
4736,1618272,333,0,63429,160,173,3.0303030303030303,0.0
4737,2436,5,2436,55,3,2,33.333333333333336,60.11
4738,300,3,300,176,3,0,20.0,88.71
4739,483468,182,0,4103,82,100,4.761904761904762,0.0
4740,1584,30,1584,1322,30,0,3.125,79.76
4741,640020,725,0,4934,417,308,1.1764705882352942,0.0
4742,71112,9,71112,881,9,0,16.666666666666668,66.76
4743,9408,8,9408,1792,7,1,1.851851851851852,70.1
4744,1685820,5190,0,270218,2892,2298,1.0,0.0
4745,47292,30,0,3182,26,4,100.0,0.0
4746,528,1,528,0,0,1,1.0,0.0
4747,300,1,300,204,0,1,100.0,0.0
4748,21888,293,0,2362,168,125,100.0,0.0
4749,9288,42,9288,1165,41,1,3.225806451612903,22.65
4750,13800,44,0,1420,29,15,100.0,0.0
4751,257400,25,257400,918,20,5,7.142857142857143,44.6
4752,1740960,660,3780,298410,355,305,1.7543859649122806,0.0
4753,12420,38,0,3201,36,2,20.0,0.0
4754,17376,14,17376,914,11,3,11.11111111111111,66.66
4755,120660,155,0,3762,120,35,100.0,0.0
4756,14796,19,14796,14673,17,2,5.555555555555555,66.45
4757,80484,13,80484,6219,12,1,8.333333333333334,75.59
4758,74964,61,74964,1620,45,16,2.2222222222222223,31.87
4759,102468,17,102468,11061,15,2,7.142857142857143,71.85
4760,43416,50,0,1775,36,14,50.0,0.0
4761,16956,28,16956,716,25,3,4.545454545454546,60.89
4762,775812,55,775812,94633,30,25,1.0,7.59
4763,4704,188,0,1131,108,80,100.0,0.0
4764,4404,114,0,1471,89,25,50.0,90.0
4765,1147368,713,0,8109,381,332,1.639344262295082,0.0
4766,37872,50,37872,1568,45,5,2.9411764705882355,57.59
4767,48960,48,0,1788,36,12,50.0,0.0
4768,3024,19,2412,2470,16,3,9.090909090909092,0.74
4769,49476,48,0,1827,41,7,50.0,0.0
4770,81468,215,0,9344,168,47,100.0,0.0
4771,0,0,0,0,0,0,100.0,0.0
4772,11148,52,11148,1837,50,2,4.761904761904762,22.28
4773,573792,49,0,18070,34,15,50.0,0.0
4774,108,3,108,64,2,1,33.333333333333336,95.86
4775,6192,271,0,1784,156,115,100.0,0.0
4776,865932,1013,0,10010,530,483,1.639344262295082,0.0
4777,288,5,288,55,3,2,25.0,52.82
4778,1689108,691,0,14574,367,324,1.7543859649122806,3.5
4779,228,4,228,15,4,0,16.666666666666668,55.62
4780,496656,48,496656,26264,46,2,2.857142857142857,78.74
4781,3756,9,0,1541,7,2,100.0,0.0
4782,23460,15,23460,2308,15,0,8.333333333333334,95.15
4783,2196,13,2196,159,10,3,14.285714285714286,91.01
4784,78768,1,78768,0,1,0,1.0,0.0
4785,6396,38,6396,1071,38,0,7.6923076923076925,26.23
4786,37680,55,37680,881,47,8,2.702702702702702,56.22
4787,516,33,516,62,25,8,5.2631578947368425,68.36
4788,1064004,60,0,98086,49,11,25.0,0.0
4789,1087524,1212,0,8298,858,354,1.0,0.0
4790,372,10,0,200,8,2,100.0,0.0
4791,34428,22,0,12394,19,3,50.0,0.0
4792,312,1,312,60,1,0,100.0,100.0
4793,373596,21,0,27175,17,4,33.333333333333336,0.0
4794,1562244,635,0,12693,341,294,1.5384615384615383,0.0
4795,252,55,252,22,33,22,4.3478260869565215,59.35
4796,25008,11,2376,7134,8,3,100.0,0.0
4797,194220,13,194220,537,10,3,14.285714285714286,53.19
4798,60,16,60,18,10,6,14.285714285714286,54.59
4799,348,1,348,216,1,0,50.0,99.99
4800,16668,25,10512,1356,19,6,7.6923076923076925,89.43
4801,564,5,0,410,3,2,25.0,0.0
4802,16356,49,0,1041,35,14,50.0,0.0
4803,519120,59,0,19221,49,10,25.0,0.0
4804,1758780,1977,0,132614,1049,928,1.0,0.0
4805,3072,3,0,1328,3,0,16.666666666666668,18.29
4806,63648,13,63648,632,11,2,12.5,55.86
4807,6600,12,0,1057,10,2,100.0,0.0
4808,34548,7,34548,1690,6,1,16.666666666666668,61.01
4809,30588,52,0,1575,39,13,50.0,0.0
4810,22500,49,0,1131,35,14,50.0,0.0
4811,144,0,144,0,0,0,50.0,64.0
4812,108,21,108,30,12,9,20.0,50.94
4813,1236,99,1236,416,55,44,3.125,60.03
4814,384,3,384,200,3,0,25.0,97.38
4815,528,0,528,0,0,0,100.0,100.0
4816,15924,32,15924,1032,26,6,5.0,48.39
4817,1490844,880,0,6020,679,201,1.0,0.0
4818,69456,11,69456,432,9,2,16.666666666666668,47.85
4819,3720,84,0,1209,64,20,33.333333333333336,0.0
4820,1494216,649,3960,6228,383,266,3.571428571428572,0.0
4821,756,1,756,276,1,0,50.0,99.99
4822,1227588,1029,0,9714,574,455,1.0,0.0
4823,14964,3,14964,84,3,0,25.0,92.39
4824,469584,46,0,12290,30,16,33.333333333333336,0.0
4825,1051824,1455,0,15445,808,647,1.1494252873563218,0.0
4826,168,9,168,33,6,3,20.0,20.57
4827,83604,10,83604,4586,9,1,25.0,80.58
4828,288,1,288,0,1,0,50.0,99.02
4829,1606032,849,0,12449,468,381,1.2987012987012987,0.0
4830,2544,13,2544,262,11,2,11.11111111111111,80.31
4831,2772,67,0,1014,52,15,100.0,0.0
4832,141072,297,0,3517,139,158,5.555555555555555,0.0
4833,6804,43,6804,1184,34,9,3.8461538461538463,62.74
4834,2580,56,2580,541,32,24,10.0,91.88
4835,1725792,6105,0,68870,3570,2535,1.0,0.0
4836,819168,228,0,18746,104,124,3.8461538461538463,0.0
4837,59988,56,59988,2105,51,5,4.761904761904762,10.52
4838,49560,16,49560,1231,10,6,16.666666666666668,59.77
4839,15168,19,15168,714,19,0,5.0,51.37
4840,15168,83,0,908,61,22,100.0,0.0
4841,18396,47,0,993,34,13,50.0,0.0
4842,120,3,120,68,1,2,50.0,99.7
4843,785040,53,0,55135,41,12,20.0,0.0
4844,13236,52,0,1013,38,14,50.0,0.0
4845,13812,65,0,1023,49,16,50.0,0.0
4846,1772640,100,1765944,687992,69,31,1.0526315789473684,0.0
4847,79344,19,168,4703,13,6,10.0,90.18
4848,324,0,324,0,0,0,100.0,100.0
4849,1435464,463,0,14208,235,228,2.631578947368421,1.21
4850,55200,13,55200,876,11,2,16.666666666666668,92.78
4851,12000,40,0,1266,25,15,100.0,0.0
4852,276,1,276,48,1,0,33.333333333333336,99.5
4853,107112,24,107112,1257,21,3,5.555555555555555,37.82
4854,130596,0,129228,0,0,0,1.0,0.0
4855,1489488,1862,0,63507,1001,861,1.075268817204301,0.0
4856,21708,256,0,2206,157,99,1.1904761904761905,0.0
4857,56280,81,1044,1089,41,40,6.666666666666667,89.28
4858,132,14,132,35,14,0,6.25,42.11
4859,1727880,414,0,22272,199,215,2.127659574468085,0.0
4860,68928,22,68928,560,17,5,10.0,34.98
4861,600,20,600,478,14,6,10.0,40.99
4862,300,22,300,98,22,0,4.166666666666667,42.99
4863,960,0,960,0,0,0,100.0,100.0
4864,3252,3,0,2284,2,1,33.333333333333336,40.0
4865,112368,38,112368,2087,31,7,4.3478260869565215,57.41
4866,1612512,116,0,26290,53,63,7.6923076923076925,5.0
4867,54420,35,54420,2462,31,4,3.571428571428572,85.48
4868,2076,3,2076,48,3,0,20.0,82.75
4869,168,0,168,0,0,0,50.0,60.92
4870,852,3,852,516,2,1,25.0,93.67
4871,115272,29,115272,1066,23,6,6.666666666666667,36.48
4872,377952,305,0,11594,204,101,50.0,0.0
4873,132,91,132,19,72,19,1.5625,34.15
4874,2016,0,2016,0,0,0,50.0,99.96
4875,54792,183,0,1215,148,35,100.0,0.0
4876,10200,55,0,1299,40,15,100.0,0.0
4877,108,5,108,0,5,0,14.285714285714286,57.92
4878,747264,61,747264,16002,49,12,2.127659574468085,46.6
4879,1241484,46,45024,81612,41,5,2.7777777777777777,77.41
4880,519828,26,48,20009,17,9,9.090909090909092,26.3
4881,1178448,80,0,23166,37,43,1.96078431372549,0.0
4882,72192,54,72192,539,46,8,2.272727272727273,40.1
4883,141216,66,141216,1036,24,42,20.0,97.28
4884,156,6,156,20,3,3,50.0,29.96
4885,1643700,384,0,30359,181,203,3.4482758620689653,0.0
4886,435180,26,435180,11,22,4,5.0,38.44
4887,453768,22,453768,18264,19,3,6.25,58.73
4888,0,0,0,0,0,0,100.0,0.0
4889,74172,47,74172,834,31,16,4.0,49.52
4890,33864,411,0,759,261,150,1.0,0.0
4891,780,0,780,0,0,0,100.0,100.0
4892,94284,62,0,36394,45,17,3.225806451612903,0.0
4893,56112,9,0,22216,5,4,20.0,0.0
4894,1344,0,1344,0,0,0,50.0,97.0
4895,3972,11,3972,338,8,3,1.2048192771084338,80.91
4896,146904,78,146904,578,28,50,20.0,98.66
4897,9852,60,9852,1703,57,3,6.25,29.21
4898,2052,47,2052,49,35,12,3.703703703703704,32.88
4899,20208,69,0,930,48,21,100.0,0.0
4900,835644,503,0,8863,321,182,1.0,0.0
4901,312,0,312,0,0,0,100.0,80.0
4902,144,0,144,0,0,0,50.0,90.0
4903,3780,56,1962,465,34,22,11.11111111111111,82.22
4904,6216,34,6216,362,32,2,3.0303030303030303,13.84
4905,1806528,587,0,679246,298,289,1.0,0.0
4906,302856,1,302856,624,1,0,8.333333333333334,89.0
4907,816,0,816,0,0,0,50.0,70.0
4908,984,15,0,94,14,1,100.0,0.0
4909,1809300,525,1528560,430607,289,236,1.2195121951219512,0.0
4910,262188,146,3456,2639,85,61,5.555555555555555,75.53
4911,144,0,144,0,0,0,50.0,80.0
4912,7176,20,7176,24,20,0,4.545454545454546,75.2
4913,8916,9,8916,764,9,0,9.090909090909092,36.57
4914,96,14,60,31,10,4,11.11111111111111,19.56
4915,13644,33,13644,996,29,4,4.0,62.3
4916,14592,16,14592,10236,8,8,50.0,99.24
4917,132,2,132,0,2,0,25.0,62.4
4918,78552,28,0,3429,19,9,10.0,0.0
4919,23640,48,0,1347,37,11,50.0,0.0
4920,1188612,63,0,27238,34,29,16.666666666666668,0.0
4921,151584,15,151584,68,5,10,50.0,99.6
4922,22188,92,0,6647,70,22,100.0,0.0
4923,5952,0,5952,0,0,0,100.0,100.0
4924,636,0,636,0,0,0,100.0,100.0
4925,3288,8,108,1509,5,3,25.0,60.95
4926,10140,25,10140,10,23,2,4.3478260869565215,22.06
4927,1645224,5049,0,87696,2830,2219,1.0,0.0
4928,372,0,372,0,0,0,50.0,90.0
4929,380880,1,380880,336,1,0,33.333333333333336,99.35
4930,12000,40,0,1226,25,15,100.0,0.0
4931,1001676,493,0,63845,239,254,2.5,7.5
4932,233976,237,0,18719,131,106,100.0,0.0
4933,23028,15,23028,192,11,4,11.11111111111111,89.77
4934,28164,85,28164,3737,65,20,11.11111111111111,18.02
4935,1164,13,0,372,10,3,50.0,0.0
4936,240,2,240,144,2,0,25.0,22.57
4937,254664,315,0,1247,240,75,1.2820512820512822,0.0
4938,1057584,1411,0,88121,757,654,1.351351351351351,0.0
4939,9600,170,0,664,138,32,100.0,0.0
4940,840,2,816,570,1,1,33.333333333333336,83.99
4941,240,4,240,123,4,0,50.0,90.51
4942,6936,192,0,1701,120,72,100.0,0.0
4943,48,2,48,0,2,0,25.0,21.9
4944,1532496,425,0,6469,266,159,1.818181818181818,0.0
4945,67176,95,67176,1586,78,17,1.3333333333333333,19.9
4946,295164,99,0,9875,85,14,1.2195121951219512,4.0
4947,117156,8,117156,603,5,3,20.0,77.59
4948,72,10,72,27,6,4,25.0,20.96
4949,2952,2,2952,132,2,0,33.333333333333336,98.52
4950,151284,112,0,4870,54,58,5.882352941176471,3.0
4951,1829412,125935,796486,804455,70926,55009,1.0,0.0
4952,144,29,60,31,21,8,7.142857142857143,16.66
4953,4308,2,4308,216,2,0,50.0,98.05
4954,1249572,168,0,16377,86,82,7.6923076923076925,0.0
4955,132,4,132,27,3,1,25.0,44.69
4956,2316,53,2316,47,47,6,2.1739130434782608,56.5
4957,895776,187,0,8867,81,106,6.666666666666667,0.0
4958,14748,31,14748,714,30,1,12.5,29.81
4959,696,40,444,258,22,18,20.0,95.27
4960,13344,152,0,1500,89,63,2.2222222222222223,0.0
4961,1791732,1887,0,130645,1070,817,1.098901098901099,0.0
4962,521064,171,0,15641,77,94,7.142857142857143,5.0
4963,31644,27,31644,857,22,5,7.142857142857143,71.48
4964,49704,111,288,585,61,50,3.571428571428572,54.1
4965,24288,42,24288,1534,38,4,3.4482758620689653,58.52
4966,228,14,228,27,14,0,6.25,49.06
4967,480,50,480,136,34,16,3.8461538461538463,74.61
4968,648,22,648,178,22,0,5.882352941176471,77.25
4969,201384,625,0,3524,332,293,1.7543859649122806,0.0
4970,63444,57,63444,3676,43,14,2.4390243902439024,15.04
4971,12024,42,0,1527,28,14,100.0,0.0
4972,1980,3,0,788,2,1,100.0,0.0
4973,1560,45,0,535,36,9,100.0,0.0
4974,3876,99,3876,472,84,15,1.3333333333333333,27.96
4975,696,0,696,0,0,0,100.0,0.0
4976,44376,47,0,1694,35,12,50.0,0.0
4977,45084,48,0,1555,34,14,50.0,0.0
4978,4284,54,4284,30,32,22,4.3478260869565215,60.17
4979,924,38,0,479,16,22,14.285714285714286,0.0
4980,186516,243,0,1549,120,123,6.25,0.0
4981,10728,67,10728,1606,66,1,5.2631578947368425,12.1
4982,1171908,17,935514,85466,11,6,11.11111111111111,29.7
4983,336,9,336,109,7,2,14.285714285714286,54.97
4984,9072,4,9072,1890,3,1,20.0,40.4
4985,1171200,9,1171200,65366,9,0,100.0,100.0
4986,890784,21,0,140867,11,10,11.11111111111111,0.0
4987,23868,43,23868,807,36,7,3.703703703703704,56.0
4988,468,8,468,177,6,2,16.666666666666668,61.93
4989,20652,19,20652,166,17,2,6.25,82.32
4990,1722216,817,0,32600,436,381,1.7241379310344829,0.0
4991,26256,46,0,1162,35,11,50.0,0.0
4992,372,4,240,126,3,1,20.0,21.43
4993,3144,164,3144,2030,133,31,1.0869565217391304,53.82
4994,1181760,54,0,43833,42,12,33.333333333333336,0.0
4995,76224,13,0,13671,11,2,50.0,0.0
4996,10200,40,0,1267,26,14,100.0,0.0
4997,1789296,1784,0,173382,1090,694,1.0,0.0
4998,504,0,504,0,0,0,50.0,90.0
4999,375252,325,0,8812,222,103,100.0,0.0
5000,80148,51,0,8387,26,25,20.0,2.25
5001,1532352,144,0,152600,99,45,4.545454545454546,0.0
5002,180,4,180,123,4,0,16.666666666666668,57.27
5003,27540,22,10248,3028,18,4,6.25,85.41
5004,754908,341,0,147198,177,164,3.333333333333333,0.0
5005,1740,6,1740,12,4,2,25.0,73.01
5006,792,5,792,201,5,0,14.285714285714286,65.01
5007,9612,38,9612,37,32,6,3.4482758620689653,21.13
5008,17316,39,5808,1324,38,1,6.25,33.6
5009,444,4,444,120,2,2,50.0,73.25
5010,6180,50,0,1903,39,11,100.0,0.0
5011,3324,7,3324,385,6,1,16.666666666666668,91.16
5012,11520,12,11520,9,9,3,12.5,62.77
5013,1847160,3861,10308,476717,2189,1672,1.0,0.0
5014,37920,34,37920,20,26,8,4.166666666666667,41.97
5015,425472,846,0,2981,657,189,1.0,0.0
5016,0,0,0,0,0,0,50.0,10.0
5017,64980,15,0,4710,12,3,100.0,0.0
5018,2220,3,2220,416,3,0,25.0,98.7
5019,81108,19,81108,1020,17,2,5.555555555555555,72.38
5020,156,2,156,96,2,0,50.0,89.91
5021,1581240,2117,0,38524,1144,973,1.0,0.0
5022,16368,26,16368,740,23,3,5.2631578947368425,90.78
5023,156,2,156,96,2,0,50.0,89.95
5024,168,3,168,100,3,0,33.333333333333336,89.5
5025,144,2,144,96,2,0,50.0,90.02
5026,85044,33,0,7320,29,4,50.0,0.0
5027,168,2,168,120,2,0,50.0,90.06
5028,892872,268,0,11427,139,129,4.166666666666667,0.0
5029,156,6,156,86,6,0,16.666666666666668,74.8
5030,132,4,132,75,3,1,50.0,89.95
5031,1008,9,1008,386,9,0,14.285714285714286,79.99
5032,132,2,132,90,2,0,50.0,89.98
5033,540,2,0,294,1,1,100.0,0.0
5034,132,2,132,90,2,0,50.0,90.02
5035,156,2,156,96,2,0,50.0,90.06
5036,132,3,132,92,3,0,33.333333333333336,89.12
5037,156,33,132,36,25,8,5.0,27.4
5038,144,4,144,87,3,1,50.0,90.12
5039,156,2,156,102,2,0,50.0,90.15
5040,252,11,0,133,8,3,100.0,0.0
5041,156,2,156,114,2,0,50.0,90.19
5042,1856424,1323,0,97467,731,592,1.0869565217391304,0.0
5043,144,7,144,78,7,0,14.285714285714286,67.69
5044,437340,23,0,21066,22,1,50.0,0.0
5045,361584,333,0,6045,164,169,3.4482758620689653,2.38
5046,8604,22,8604,481,18,4,6.666666666666667,88.95
5047,132,2,132,90,2,0,50.0,89.97
5048,132,2,132,90,2,0,50.0,90.0
5049,144,7,144,77,7,0,14.285714285714286,67.5
5050,1216464,24,0,153893,20,4,33.333333333333336,0.0
5051,420,4,420,114,3,1,33.333333333333336,96.4
5052,228,7,228,97,7,0,14.285714285714286,67.23
5053,228,20,228,13,15,5,8.333333333333334,15.42
5054,12000,51,0,1331,36,15,100.0,0.0
5055,156,2,156,114,2,0,50.0,89.48
5056,156,2,156,102,2,0,50.0,89.52
5057,132,7,132,77,7,0,14.285714285714286,67.02
5058,336,1,336,60,1,0,33.333333333333336,21.9
5059,144,7,144,89,7,0,14.285714285714286,66.73
5060,334968,21,334968,7060,19,2,5.2631578947368425,50.33
5061,168,7,168,92,7,0,14.285714285714286,66.42
5062,312,0,312,0,0,0,50.0,56.25
5063,144,7,144,89,7,0,14.285714285714286,66.09
5064,192,2,192,126,2,0,33.333333333333336,87.78
5065,528,11,528,304,11,0,12.5,77.52
5066,156,3,156,48,2,1,33.333333333333336,58.21
5067,192,7,192,92,7,0,14.285714285714286,65.78
5068,84,57,84,25,37,20,3.4482758620689653,48.46
5069,156,7,156,78,7,0,14.285714285714286,65.41
5070,156,7,156,80,7,0,14.285714285714286,65.02
5071,216,27,216,50,15,12,20.0,58.59
5072,57108,32,57108,1190,25,7,5.2631578947368425,36.4
5073,192,7,192,94,7,0,14.285714285714286,64.6
5074,180,7,180,82,7,0,14.285714285714286,64.14
5075,20484,47,0,1095,36,11,50.0,0.0
5076,144,7,144,78,7,0,14.285714285714286,63.66
5077,384,13,384,233,12,1,8.333333333333334,72.44
5078,132,10,132,82,9,1,12.5,62.95
5079,144,7,144,78,7,0,14.285714285714286,62.57
5080,21096,45,0,1161,36,9,50.0,0.0
5081,864,7,864,807,7,0,14.285714285714286,61.96
5082,156,7,156,80,7,0,14.285714285714286,61.27
5083,144,7,144,89,7,0,14.285714285714286,60.56
5084,48,6,48,10,6,0,14.285714285714286,74.33
5085,180,11,180,93,10,1,11.11111111111111,56.71
5086,156,7,156,90,7,0,14.285714285714286,57.83
5087,1846884,296,0,867226,148,148,1.408450704225352,0.0
5088,156,7,156,80,7,0,14.285714285714286,56.78
5089,156,7,156,78,7,0,14.285714285714286,55.61
5090,372,70,372,178,40,30,3.8461538461538463,15.86
5091,156,2,156,96,2,0,50.0,76.84
5092,144,7,144,78,7,0,14.285714285714286,54.5
5093,3624,5,3624,36,5,0,16.666666666666668,90.07
5094,192,2,192,126,2,0,50.0,75.59
5095,156,7,156,90,7,0,14.285714285714286,53.28
5096,132,7,132,85,7,0,14.285714285714286,51.66
5097,18192,51,0,1099,40,11,50.0,0.0
5098,156,7,156,89,7,0,14.285714285714286,49.81
5099,75972,36,75972,1014,30,6,4.3478260869565215,54.43
5100,168,7,168,113,7,0,14.285714285714286,47.7
5101,168,7,168,80,7,0,14.285714285714286,45.23
5102,1008,5,156,266,3,2,16.666666666666668,90.07
5103,720,84,720,101,76,8,1.351351351351351,38.96
5104,204,4,204,81,4,0,20.0,86.16
5105,19680,50,0,1123,40,10,50.0,0.0
5106,684,26,684,234,24,2,5.2631578947368425,79.18
5107,1032,2,1032,576,2,0,50.0,64.84
5108,156,7,156,70,7,0,14.285714285714286,42.65
5109,204,8,204,109,8,0,14.285714285714286,38.98
5110,9492,42,0,1169,27,15,100.0,0.0
5111,252,3,252,144,3,0,50.0,57.18
5112,468,66,468,111,31,35,7.6923076923076925,27.58
5113,300,5,300,132,4,1,50.0,57.73
5114,888,2,888,24,1,1,50.0,77.08
5115,216,21,216,49,15,6,8.333333333333334,57.54
5116,192,11,192,70,10,1,14.285714285714286,35.73
5117,648,18,648,142,18,0,5.555555555555555,59.24
5118,816,22,816,396,22,0,10.0,80.94
5119,252,6,252,110,5,1,50.0,90.0
5120,853344,795,0,3101,578,217,1.0,0.0
5121,288,9,288,118,8,1,33.333333333333336,88.14
5122,168,10,168,73,9,1,14.285714285714286,67.49
5123,531192,243,0,4304,105,138,5.882352941176471,3.0
5124,1639128,1039,0,31591,564,475,1.2658227848101269,0.0
5125,348,10,348,146,9,1,33.333333333333336,89.49
5126,156,7,156,70,7,0,14.285714285714286,67.25
5127,192,9,192,66,8,1,14.285714285714286,66.96
5128,2256,58,0,668,48,10,100.0,0.0
5129,192,10,192,81,9,1,14.285714285714286,66.65
5130,1791240,649,0,101510,353,296,1.6129032258064515,0.0
5131,180,10,180,85,9,1,14.285714285714286,66.33
5132,6276,39,6276,1214,35,4,3.4482758620689653,50.88
5133,180,10,180,68,9,1,14.285714285714286,65.99
5134,444,10,0,240,7,3,100.0,0.0
5135,216,14,216,75,12,2,11.11111111111111,62.34
5136,1872108,503,0,206986,263,240,1.4492753623188406,0.0
5137,240,6,240,114,5,1,50.0,87.68
5138,276,25,276,12,13,12,33.333333333333336,69.94
5139,1583496,497,0,80611,276,221,2.3255813953488373,0.0
5140,708,30,708,483,22,8,50.0,87.68
5141,180,10,180,64,9,1,14.285714285714286,65.24
5142,120,7,120,53,7,0,14.285714285714286,64.83
5143,252,6,252,88,5,1,20.0,86.45
5144,204,10,204,91,9,1,14.285714285714286,64.37
5145,2340,48,0,793,41,7,100.0,0.0
5146,180,7,180,82,7,0,14.285714285714286,63.71
5147,9588,36,9588,536,28,8,3.8461538461538463,53.1
5148,192,11,192,79,10,1,14.285714285714286,63.17
5149,168,10,168,67,9,1,14.285714285714286,62.6
5150,105792,40,0,5160,36,4,50.0,0.0
5151,192,10,192,80,9,1,14.285714285714286,61.97
5152,180,10,180,57,9,1,14.285714285714286,61.29
5153,180,13,180,52,12,1,12.5,60.54
5154,3168,6,3168,404,5,1,20.0,86.65
5155,180,10,180,74,9,1,14.285714285714286,59.76
5156,204,10,204,129,9,1,14.285714285714286,58.85
5157,168,10,168,63,9,1,14.285714285714286,57.87
5158,72,18,72,18,11,7,16.666666666666668,32.19
5159,180,8,180,84,8,0,14.285714285714286,56.8
5160,120,28,120,19,16,12,16.666666666666668,18.56
5161,180,9,180,106,8,1,14.285714285714286,11.09
5162,276,9,276,110,9,0,14.285714285714286,53.83
5163,204,14,204,40,12,2,11.11111111111111,51.56
5164,324,33,324,108,33,0,3.8461538461538463,64.34
5165,288,12,288,114,11,1,14.285714285714286,50.35
5166,1855224,4651,0,356664,2601,2050,1.0,0.0
5167,11412,41,0,1237,26,15,100.0,0.0
5168,17916,49,0,1141,34,15,50.0,0.0
5169,6456,17,6456,482,15,2,7.6923076923076925,69.03
5170,528,16,528,289,13,3,50.0,70.79
5171,1882128,1899,307692,656143,1181,718,1.0,0.0
5172,312,13,312,167,11,2,12.5,48.39
5173,76548,9,76548,346,8,1,14.285714285714286,47.44
5174,156,12,156,42,10,2,12.5,45.48
5175,16836,46,0,927,35,11,50.0,0.0
5176,216,13,216,74,11,2,12.5,42.89
5177,7224,12,7224,522,10,2,12.5,70.1
5178,15504,45,0,1133,35,10,50.0,0.0
5179,492,0,492,0,0,0,100.0,100.0
5180,468,30,468,32,30,0,3.125,74.4
5181,14220,50,0,889,38,12,50.0,0.0
5182,912,14,912,100,12,2,12.5,38.81
5183,76224,17,76224,631,15,2,8.333333333333334,47.22
5184,276,7,276,102,7,0,14.285714285714286,34.8
5185,88572,113,88572,2017,47,66,7.142857142857143,79.28
5186,48108,21,48108,650,17,4,7.6923076923076925,62.24
5187,372,34,372,194,34,0,2.857142857142857,48.03
5188,2220,0,2220,0,0,0,50.0,78.5
5189,1873128,12459,0,441561,7268,5191,1.0,0.0
5190,1516968,336,0,159556,166,170,4.3478260869565215,0.0
5191,4056,39,4056,1080,32,7,4.166666666666667,61.25
5192,645360,11,207765,121076,11,0,14.285714285714286,99.88
5193,4716,23,0,536,18,5,100.0,100.0
5194,56316,66,56316,2810,60,6,4.761904761904762,12.57
5195,120,0,120,0,0,0,100.0,100.0
5196,1798092,4856,0,1183139,2997,1859,1.0,0.0
5197,57432,115,0,2846,95,20,100.0,0.0
5198,1602108,61,0,80703,41,20,6.666666666666667,0.0
5199,35568,33,35568,457,32,1,7.6923076923076925,14.49
5200,47316,49,0,1133,34,15,100.0,0.0
5201,1416,18,1416,459,14,4,14.285714285714286,0.0
5202,646860,161,184468,153732,161,0,3.8461538461538463,98.28
5203,1992,34,0,699,24,10,100.0,0.0
5204,828,13,828,356,11,2,8.333333333333334,54.62
5205,1723596,29,0,68200,24,5,33.333333333333336,0.0
5206,4644,21,4644,732,17,4,8.333333333333334,71.18
5207,720,4,720,396,3,1,25.0,89.77
5208,1751640,2658,0,90506,1464,1194,1.0,0.0
5209,53532,19,53532,841,17,2,6.25,66.86
5210,7956,180,7956,963,115,65,2.2222222222222223,65.63
5211,173388,140,173388,6958,99,41,2.272727272727273,12.13
5212,82596,12,82596,429,11,1,9.090909090909092,47.74
5213,1738896,1072,0,22941,631,441,1.5151515151515151,1.46
5214,79572,23,79572,2073,13,10,12.5,86.73
5215,1383240,135,0,20472,68,67,8.333333333333334,0.0
5216,612,0,612,0,0,0,50.0,80.0
5217,1693692,286,0,24529,209,77,25.0,0.0
5218,4068,218,0,1317,125,93,100.0,0.0
5219,30300,11,30300,734,11,0,8.333333333333334,61.14
5220,1649388,327,0,10029,166,161,2.1739130434782608,2.5
5221,3972,49,3972,2148,49,0,1.96078431372549,10.75
5222,876,26,876,107,25,1,4.545454545454546,76.74
5223,132,0,132,0,0,0,50.0,80.0
5224,7632,0,7632,0,0,0,100.0,100.0
5225,4548,179,0,778,143,36,100.0,0.0
5226,132,11,132,0,11,0,7.6923076923076925,52.0
5227,95628,32,0,40805,27,5,100.0,0.0
5228,2484,2,0,2004,2,0,20.0,0.0
5229,480,36,480,138,31,5,3.8461538461538463,57.81
5230,81888,33,81888,9,29,4,3.4482758620689653,25.6
5231,228,32,228,28,12,20,25.0,22.18
5232,56460,37,56460,99,34,3,3.4482758620689653,30.69
5233,36588,22,0,23429,12,10,12.5,0.0
5234,876,4,876,87,2,2,33.333333333333336,96.5
5235,1527024,584,0,16343,317,267,2.3255813953488373,0.0
5236,397680,42,397680,1428,35,7,2.702702702702702,10.56
5237,1900188,2226,0,455067,1279,947,1.0,0.0
5238,7260,83,0,917,56,27,2.5,0.0
5239,36096,5,36096,948,5,0,14.285714285714286,51.63
5240,913296,133,0,65085,72,61,6.666666666666667,4.5
5241,1569840,510,0,90268,276,234,1.96078431372549,0.0
5242,49308,21,49308,286,18,3,5.882352941176471,87.92
5243,15264,17,0,1300,11,6,100.0,100.0
5244,151344,2,151344,498,2,0,33.333333333333336,99.91
5245,595248,201,0,8721,93,108,5.555555555555555,0.0
5246,5880,272,0,639,102,170,5.0,0.0
5247,1897884,2122,0,559892,1196,926,1.0,0.0
5248,18648,10,18648,519,9,1,12.5,43.57
5249,69564,2,69564,672,2,0,25.0,76.99
5250,1899168,3999,0,365899,2322,1677,1.0,0.0
5251,2904,16,2904,1133,16,0,12.5,79.84
5252,4236,11,108,417,10,1,9.090909090909092,57.03
5253,195312,104,0,4600,44,60,16.666666666666668,0.0
5254,4992,15,0,646,12,3,100.0,0.0
5255,3156,8,3156,405,8,0,10.0,59.98
5256,636,10,636,74,9,1,10.0,56.37
5257,72636,71,44394,1687,58,13,5.0,19.42
5258,1140,1,1140,888,1,0,33.333333333333336,68.74
5259,25224,25,0,2376,16,9,100.0,0.0
5260,1900536,3011,0,64445,1640,1371,1.0,0.0
5261,1131756,526,0,11236,276,250,3.125,2.0
5262,1602264,236,0,11696,112,124,3.125,2.38
5263,1826856,326,0,13117,153,173,5.0,0.0
5264,46476,48,0,6041,40,8,50.0,0.0
5265,369420,557,0,4848,296,261,1.694915254237288,0.0
5266,1852704,464,0,113889,264,200,1.3888888888888888,10.0
5267,816,9,816,212,9,0,25.0,90.08
5268,6144,5,6144,6040,2,3,50.0,99.24
5269,1737684,49,0,179999,39,10,4.545454545454546,0.0
5270,1906464,3797,1270356,415614,2230,1567,1.0,11.3
5271,1909740,17146,1300869,865063,9749,7397,1.0,0.0
5272,25608,15,25608,968,14,1,7.6923076923076925,73.89
5273,147420,2,0,73758,1,1,50.0,0.0
5274,2760,5,2760,220,4,1,50.0,99.95
5275,21804,2,11844,2430,2,0,100.0,100.0
5276,564,4,564,459,4,0,16.666666666666668,47.15
5277,398448,18,64368,42484,16,2,7.6923076923076925,70.01
5278,71316,35,0,8344,34,1,25.0,0.0
5279,23496,46,23496,925,44,2,5.0,22.72
5280,22524,1,22524,360,1,0,50.0,99.99
5281,50784,170,0,1357,78,92,8.333333333333334,0.0
5282,10632,85,10632,3813,83,2,1.162790697674419,30.68
5283,10704,171,0,551,143,28,100.0,0.0
5284,11256,51,0,904,36,15,100.0,0.0
5285,300,0,300,0,0,0,50.0,60.26
5286,11652,65,11652,3266,55,10,7.142857142857143,42.6
5287,2076,1,2076,1128,1,0,100.0,100.0
5288,405408,26,0,37614,14,12,16.666666666666668,5.0
5289,834324,1426,0,8205,762,664,1.0,3.47
5290,312,69,312,40,57,12,1.8867924528301887,13.52
5291,3060,1,3060,996,1,0,50.0,98.8
5292,551004,151,0,11755,67,84,4.761904761904762,5.0
5293,10152,76,0,790,53,23,2.7777777777777777,2.0
5294,372,46,372,179,26,20,6.666666666666667,58.39
5295,1283388,658,0,9324,365,293,1.4492753623188406,0.0
5296,1537632,906,0,73183,413,493,2.127659574468085,0.0
5297,1721808,160,0,16658,73,87,14.285714285714286,0.0
5298,1890576,1833,0,74282,1019,814,1.0,0.0
5299,1351776,1060,441446,270889,1060,0,1.0,76.64
5300,144,55,144,66,45,10,2.380952380952381,30.98
5301,1257180,1149,0,11439,629,520,1.0869565217391304,4.21
5302,266736,282,0,6192,130,152,4.0,0.0
5303,540,3,540,204,3,0,20.0,94.16
5304,432,2,432,42,1,1,50.0,21.62
5305,1432452,552,0,8863,297,255,1.5873015873015872,0.0
5306,13356,48,13356,1289,43,5,5.882352941176471,20.91
5307,120,25,120,47,14,11,20.0,31.13
5308,684,6,684,264,5,1,16.666666666666668,93.62
5309,1860,17,288,232,11,6,12.5,18.74
5310,1532004,187,0,10967,101,86,4.0,0.0
5311,1908,8,1908,1386,6,2,1.2345679012345678,59.91
5312,1775712,426,0,26942,213,213,3.4482758620689653,0.0
5313,41100,44,0,2829,30,14,100.0,0.0
5314,120,53,120,25,40,13,2.857142857142857,32.98
5315,348,0,348,0,0,0,50.0,90.0
5316,156,68,156,23,56,12,1.9230769230769231,28.15
5317,363648,0,363648,0,0,0,100.0,100.0
5318,3672,92,0,1207,77,15,100.0,0.0
5319,24060,2,24060,450,2,0,25.0,95.7
5320,27072,22,27072,735,18,4,7.142857142857143,49.32
5321,4752,22,4752,487,19,3,5.882352941176471,90.13
5322,2652,1,2652,12,1,0,33.333333333333336,79.57
5323,1918740,2489,266616,472509,1401,1088,1.0,0.0
5324,41436,54,0,2350,43,11,50.0,0.0
5325,1700940,455,0,10287,242,213,2.2222222222222223,0.0
5326,70548,90,70548,1401,74,16,1.3333333333333333,21.79
5327,22536,39,0,2409,28,11,5.0,0.0
5328,1296,32,0,463,27,5,100.0,0.0
5329,174240,51,0,18303,37,14,33.333333333333336,0.0
5330,3516,15,3516,3385,9,6,12.5,94.83
5331,798612,565,0,8557,293,272,2.857142857142857,3.0
5332,39912,12,0,8772,8,4,20.0,0.0
5333,112572,24,112572,24,18,6,5.882352941176471,50.18
5334,1902408,95,0,457697,66,29,6.25,0.0
5335,888,74,888,334,54,20,2.5641025641025643,52.72
5336,44340,50,0,1669,38,12,50.0,0.0
5337,312,15,312,123,12,3,10.0,49.14
5338,17340,43,17340,633,42,1,4.761904761904762,26.9
5339,0,1,0,0,0,1,100.0,0.0
5340,408,5,408,139,5,0,20.0,89.76
5341,744,7,744,288,7,0,12.5,53.31
5342,284472,25,0,23281,21,4,33.333333333333336,0.0
5343,312,6,300,156,4,2,20.0,21.7
5344,912,13,900,352,9,4,12.5,19.62
5345,38940,250,0,9642,185,65,100.0,0.0
5346,1711716,283,0,20624,143,140,3.0303030303030303,0.0
5347,72,2,72,42,2,0,33.333333333333336,87.29
5348,3060,4,144,1587,2,2,50.0,90.38
5349,1889964,2210,5544,12806,1198,1012,1.0,0.0
5350,300,23,276,116,16,7,8.333333333333334,50.14
5351,12012,46,0,1217,31,15,100.0,0.0
5352,5376,48,5376,1314,46,2,11.11111111111111,20.6
5353,281376,327,0,76281,265,62,33.333333333333336,0.0
5354,6084,104,0,1988,48,56,20.0,0.0
5355,26724,118,26724,328,88,30,1.3157894736842106,7.26
5356,275412,133,0,5291,68,65,6.25,2.0
5357,1646928,419,0,9316,203,216,3.0303030303030303,0.0
5358,60,2,60,12,2,0,33.333333333333336,87.55
5359,1536,13,1536,159,11,2,8.333333333333334,92.79
5360,72,6,72,34,3,3,50.0,57.41
5361,156,3,156,92,2,1,50.0,93.72
5362,19836,65,0,1459,46,19,100.0,0.0
5363,1688352,1805,0,17056,949,856,1.0869565217391304,2.1
5364,168,27,168,47,12,15,8.333333333333334,52.92
5365,240,4,240,135,2,2,50.0,22.81
5366,4176,35,4176,454,34,1,100.0,16.47
5367,53388,15,53388,313,13,2,8.333333333333334,72.55
5368,132,2,132,60,1,1,50.0,76.63
5369,0,0,0,0,0,0,25.0,68.02
5370,1935384,11001,96494,228200,6473,4528,1.0,3.5
5371,168,9,60,53,8,1,12.5,0.0
5372,149316,8,149316,232,8,0,12.5,79.44
5373,1942284,8647,65268,231745,4861,3786,1.0,0.36
5374,1152,2,1152,714,2,0,33.333333333333336,24.63
5375,72,2,72,18,2,0,33.333333333333336,89.05
5376,52392,37,52392,2427,28,9,5.0,44.15
5377,14580,20,7680,1186,18,2,5.2631578947368425,84.28
5378,300,8,300,30,6,2,16.666666666666668,67.59
5379,8880,46,0,1224,32,14,100.0,0.0
5380,144,10,144,15,10,0,8.333333333333334,53.13
5381,60,7,60,22,7,0,12.5,71.61
5382,20112,9,20112,950,7,2,50.0,98.26
5383,66864,27,6384,5021,21,6,5.882352941176471,84.81
5384,40692,49,0,1915,35,14,25.0,0.0
5385,8436,38,8436,926,38,0,4.545454545454546,22.83
5386,422112,54,422112,16185,42,12,4.545454545454546,33.76
5387,180,13,180,67,8,5,20.0,56.64
5388,10872,48,10872,1457,42,6,3.125,54.29
5389,1321644,10,0,133660,7,3,50.0,0.0
5390,25236,43,0,1453,32,11,50.0,0.0
5391,2976,47,2976,598,43,4,20.0,12.83
5392,23832,51,0,1224,37,14,50.0,0.0
5393,744,45,744,290,45,0,4.0,69.91
5394,51216,26,51216,1184,23,3,5.882352941176471,44.19
5395,94044,20,94044,1175,18,2,7.142857142857143,39.7
5396,32856,20,32856,525,17,3,8.333333333333334,63.33
5397,6900,47,6900,1227,41,6,3.225806451612903,53.43
5398,54252,12,54252,1058,11,1,10.0,45.71
5399,252,8,252,57,8,0,10.0,87.4
5400,13548,215,0,3220,164,51,16.666666666666668,0.0
5401,72144,20,72144,900,17,3,8.333333333333334,39.29
5402,228,3,228,84,3,0,20.0,63.05
5403,936,8,936,208,7,1,12.5,66.34
5404,14124,50,0,1081,39,11,50.0,0.0
5405,4200,45,4200,980,38,7,3.0303030303030303,57.43
5406,10428,49,0,931,37,12,50.0,0.0
5407,40920,96,40920,2201,70,26,5.0,20.98
5408,3732,48,0,720,38,10,100.0,0.0
5409,120,32,120,5,32,0,3.0303030303030303,59.33
5410,4392,2,4392,132,1,1,50.0,0.0
5411,2088,18,2088,701,16,2,6.25,64.94
5412,75180,15,75180,6476,13,2,10.0,46.78
5413,54660,14,54660,645,12,2,10.0,73.33
5414,5448,2,4128,60,1,1,50.0,0.0
5415,30144,18,30144,241,15,3,7.6923076923076925,80.38
5416,1104036,182,324258,187321,162,20,2.272727272727273,90.3
5417,84,32,84,5,32,0,3.125,60.38
5418,1680648,309,0,24208,154,155,3.125,0.0
5419,14028,50,0,988,41,9,50.0,0.0
5420,1481388,3,748932,5224,2,1,25.0,65.96
5421,38124,57,0,1560,44,13,50.0,0.0
5422,8604,17,8604,221,14,3,8.333333333333334,70.59
5423,25068,30,25068,1558,25,5,7.142857142857143,39.99
5424,462276,55,44940,9279,44,11,3.4482758620689653,43.57
5425,7896,5,0,4344,5,0,14.285714285714286,0.0
5426,4224,2,0,4074,2,0,25.0,0.0
5427,8520,11,0,1630,9,2,11.11111111111111,0.0
5428,15756,12,15756,513,10,2,12.5,56.98
5429,7308,24,7308,1129,21,3,5.882352941176471,45.84
5430,1131336,180,0,127629,107,73,3.125,0.0
5431,804,6,804,360,6,0,20.0,61.17
5432,328056,32,63132,10422,30,2,3.333333333333333,34.96
5433,156,16,156,89,12,4,8.333333333333334,64.92
5434,300,0,300,0,0,0,50.0,64.0
5435,132,1,132,0,1,0,50.0,90.2
5436,924,107,924,454,68,39,2.0,40.43
5437,8748,53,8748,1606,44,9,3.125,43.55
5438,1251000,503,0,317671,236,267,3.703703703703704,1.48
5439,1204512,1104,952080,25457,601,503,1.2345679012345678,14.31
5440,188712,21,5028,9583,18,3,6.25,72.89
5441,8628,25,8628,308,22,3,5.555555555555555,76.14
5442,3444,17,3444,556,15,2,7.142857142857143,76.35
5443,7284,0,7284,0,0,0,50.0,80.91
5444,192,24,192,20,21,3,5.0,19.1
5445,10740,22,10740,867,17,5,11.11111111111111,61.13
5446,54996,23,54996,513,20,3,5.882352941176471,77.18
5447,66828,34,66828,29,32,2,3.0303030303030303,0.0
5448,408,0,408,0,0,0,50.0,61.33
5449,67236,44,67236,36,30,14,4.0,56.44
5450,192,4,192,81,4,0,25.0,96.2
5451,72,4,72,6,4,0,12.5,78.74
5452,72,7,72,0,7,0,11.11111111111111,19.81
5453,3420,38,3420,247,22,16,6.25,85.23
5454,1772724,5753,0,54423,3277,2476,1.0,0.48
5455,6516,30,0,1225,24,6,5.882352941176471,0.0
5456,156,4,156,57,3,1,25.0,89.05
5457,7716,16,7716,458,12,4,16.666666666666668,57.73
5458,1660596,211,0,25777,107,104,4.3478260869565215,0.0
5459,302556,122,0,4416,56,66,5.0,0.0
5460,1756128,470,0,24721,269,201,1.5873015873015872,4.0
5461,7500,69,0,1362,46,23,100.0,0.0
5462,72,9,72,21,8,1,12.5,86.48
5463,900,2,900,348,2,0,50.0,99.34
5464,1515060,313,0,292292,213,100,2.631578947368421,0.0
5465,5616,18,5616,942,16,2,12.5,67.89
5466,12024,33,12024,1315,28,5,5.2631578947368425,74.83
5467,60648,189,0,1968,154,35,100.0,0.0
5468,144,14,144,6,14,0,25.0,69.25
5469,9192,50,9192,1150,44,6,3.571428571428572,60.3
5470,28932,102,1476,596,59,43,4.545454545454546,76.62
5471,4692,41,4692,1366,31,10,5.882352941176471,39.75
5472,7704,4,7704,1068,3,1,33.333333333333336,98.62
5473,638004,23,638004,2104,13,10,10.0,66.38
5474,1473840,270,0,10618,128,142,4.0,0.0
5475,9444,130,0,2117,76,54,2.857142857142857,0.0
5476,84,18,84,7,17,1,5.555555555555555,45.71
5477,23376,85,23376,3123,69,16,5.2631578947368425,18.49
5478,528,7,528,243,5,2,20.0,44.4
5479,1519092,335,0,15748,186,149,3.4482758620689653,0.0
5480,2712,13,0,941,7,6,16.666666666666668,0.0
5481,35244,34,35244,737,34,0,33.333333333333336,28.58
5482,180,1,180,12,1,0,33.333333333333336,63.12
5483,168,0,168,0,0,0,50.0,60.26
5484,983124,116,0,108923,55,61,3.225806451612903,0.01
5485,6444,16,6444,817,14,2,6.666666666666667,76.0
5486,3996,189,0,667,155,34,100.0,0.0
5487,1674900,1614,0,33234,796,818,1.020408163265306,10.0
5488,1779156,956,0,17895,526,430,1.1363636363636365,0.0
5489,1751628,1107,0,15614,609,498,1.0,0.0
5490,46824,4,46824,852,4,0,16.666666666666668,35.68
5491,14160,1,14160,1092,1,0,33.333333333333336,84.9
5492,484836,148,0,5297,63,85,4.761904761904762,0.0
5493,176280,43,176280,167,23,20,6.666666666666667,78.04
5494,3792,3,3792,368,3,0,20.0,77.26
5495,1987584,538,0,492872,306,232,1.1904761904761905,4.0
5496,312,0,312,0,0,0,50.0,77.46
5497,70176,15,70176,2048,12,3,7.142857142857143,85.52
5498,1737528,1311,0,312767,658,653,1.0638297872340423,0.0
5499,522732,305,0,9160,154,151,2.3255813953488373,0.0
5500,515232,15,515232,263241,15,0,6.25,28.42
5501,6804,23,6804,708,21,2,5.2631578947368425,62.13
5502,48,4,48,12,2,2,50.0,22.61
5503,9528,50,0,647,35,15,3.225806451612903,3.0
5504,90828,74,90828,1634,60,14,1.851851851851852,5.56
5505,84,11,84,10,6,5,33.333333333333336,55.0
5506,432,35,432,80,34,1,3.571428571428572,64.42
5507,900,4,900,798,2,2,33.333333333333336,99.1
5508,939876,274,0,13555,147,127,5.555555555555555,0.0
5509,1126560,69,1126560,14937,27,42,12.5,67.66
5510,178740,1125,0,4693,748,377,1.0,0.0
5511,223620,15,0,22728,9,6,16.666666666666668,0.0
5512,324552,491,0,3376,267,224,1.5384615384615383,0.0
5513,252,22,252,40,21,1,6.25,56.56
5514,48,13,48,9,10,3,10.0,17.82
5515,1884,10,1884,504,10,0,8.333333333333334,34.98
5516,21912,35,21912,807,31,4,3.8461538461538463,58.0
5517,72,26,72,19,20,6,6.25,51.8
5518,17556,21,17556,189,19,2,5.555555555555555,78.1
5519,9408,10,0,1940,9,1,100.0,0.0
5520,162228,35,162228,5465,30,5,7.6923076923076925,58.74
5521,58884,86,58884,1512,32,54,14.285714285714286,76.8
5522,159096,127,0,2772,66,61,4.0,0.0
5523,1678668,204,0,9754,98,106,3.333333333333333,0.0
5524,15168,18,15168,1750,17,1,10.0,74.07
5525,48,6,48,0,6,0,12.5,32.5
5526,3096,108,3096,528,50,58,5.882352941176471,88.85
5527,16560,43,16560,1330,38,5,3.4482758620689653,54.74
5528,2148,5,0,456,3,2,100.0,0.0
5529,4776,2,4776,522,2,0,25.0,60.49
5530,316752,0,316752,0,0,0,33.333333333333336,85.0
5531,15228,21,15228,434,19,2,5.2631578947368425,83.87
5532,440736,0,440736,0,0,0,100.0,100.0
5533,1663992,2999,0,81892,1667,1332,1.0,0.11
5534,1220196,908,0,10291,508,400,1.5384615384615383,0.0
5535,48,9,48,9,8,1,11.11111111111111,68.73
5536,108,16,96,23,15,1,6.666666666666667,42.62
5537,384,8,384,55,6,2,14.285714285714286,89.3
5538,342384,111,198847,146729,111,0,4.0,98.78
5539,20952,24,20952,119,24,0,3.8461538461538463,34.86
5540,1779228,275,0,11467,145,130,4.761904761904762,0.0
5541,8064,7,8064,444,6,1,14.285714285714286,65.8
5542,17016,4,17016,1188,4,0,16.666666666666668,95.49
5543,2220,6,2220,1364,6,0,12.5,87.92
5544,21720,0,21720,0,0,0,50.0,61.73
5545,575100,288,0,49327,136,152,3.125,0.0
5546,1489692,341,0,13937,147,194,2.7777777777777777,5.0
5547,352344,65,352344,2053,54,11,1.8867924528301887,21.92
5548,2040,126,312,69,82,44,2.702702702702702,61.79
5549,1809576,224,0,59653,127,97,3.8461538461538463,0.0
5550,1334280,54,110604,29646,45,9,2.3255813953488373,49.3
5551,1641300,696,0,10835,372,324,1.2987012987012987,0.0
5552,1990188,1333,0,27071,739,594,1.0,2.0
5553,420,5,420,206,3,2,33.333333333333336,85.79
5554,18468,38,18468,622,37,1,4.3478260869565215,29.5
5555,492,5,492,180,5,0,14.285714285714286,51.16
5556,862104,41,0,21863,35,6,33.333333333333336,0.0
5557,425700,267,0,9832,137,130,3.703703703703704,0.0
5558,114300,106,0,6149,45,61,11.11111111111111,0.0
5559,11688,47,11688,1281,41,6,3.0303030303030303,58.13
5560,348,5,348,146,5,0,16.666666666666668,91.37
5561,14004,84,0,1853,56,28,2.5,2.0
5562,12768,21,12768,1464,20,1,6.25,75.68
5563,19824,7,19824,19764,3,4,50.0,98.97
5564,684,28,684,266,12,16,16.666666666666668,96.83
5565,108,9,108,34,5,4,33.333333333333336,60.1
5566,264,3,264,100,3,0,20.0,74.79
5567,276,0,276,0,0,0,50.0,85.0
5568,1939692,854,2328,8553,482,372,1.2987012987012987,0.0
5569,180,21,180,26,20,1,4.761904761904762,49.98
5570,6564,42,6564,43,36,6,2.9411764705882355,11.8
5571,228,0,228,0,0,0,50.0,64.0
5572,2002536,1471,0,87450,769,702,2.0,0.0
5573,288,5,288,28,3,2,33.333333333333336,59.93
5574,7248,41,7248,81,41,0,2.5,40.74
5575,2724,66,0,959,52,14,50.0,72.22
5576,324,5,324,43,3,2,33.333333333333336,56.5
5577,384,0,384,0,0,0,100.0,100.0
5578,8184,45,8184,270,35,10,3.0303030303030303,22.66
5579,20640,37,20640,1071,34,3,3.4482758620689653,71.12
5580,5568,41,5568,837,39,2,9.090909090909092,29.86
5581,1188,14,1188,827,7,7,50.0,67.8
5582,9780,10,9780,184,9,1,10.0,20.72
5583,47184,52,0,1849,40,12,50.0,0.0
5584,1608,99,1608,295,45,54,8.333333333333334,93.07
5585,68532,53,68532,1910,40,13,2.380952380952381,15.77
5586,48084,48,0,2013,36,12,50.0,0.0
5587,216,4,216,93,3,1,25.0,89.96
5588,977052,198,0,8706,127,71,1.5625,0.0
5589,1754436,624,0,17512,331,293,2.5,1.57
5590,8052,22,8052,350,16,6,6.25,71.06
5591,4548,38,4548,837,37,1,4.545454545454546,29.86
5592,10176,30,10176,524,26,4,4.3478260869565215,60.92
5593,4404,4,4404,273,4,0,33.333333333333336,99.86
5594,1068,35,1068,73,33,2,2.9411764705882355,38.91
5595,2520,4,2520,1692,3,1,33.333333333333336,71.29
5596,15864,179,0,5142,110,69,100.0,0.0
5597,8868,6,2040,5944,4,2,25.0,0.0
5598,1968,39,1968,732,38,1,20.0,24.2
5599,2021544,5446,4752,207070,2994,2452,1.0,0.0
5600,324,0,324,0,0,0,100.0,100.0
5601,531228,862,0,1832,592,270,1.1235955056179776,0.0
5602,279384,12,0,23817,9,3,9.090909090909092,0.0
5603,3372,38,3372,19,32,6,3.225806451612903,14.44
5604,3732,8,396,808,4,4,100.0,0.0
5605,4344,46,4344,20,32,14,3.703703703703704,45.08
5606,384,13,384,60,9,4,20.0,50.28
5607,1021536,187,0,6286,85,102,4.761904761904762,0.0
5608,322404,18,322404,46679,12,6,8.333333333333334,69.36
5609,10356,34,10356,1226,31,3,3.8461538461538463,73.86
5610,1021368,647,0,66739,338,309,2.0408163265306123,0.0
5611,70008,58,0,4142,49,9,25.0,0.0
5612,1769232,808,0,16066,437,371,1.3888888888888888,0.0
5613,13716,30,10752,1155,23,7,5.2631578947368425,84.38
5614,1764960,1373,0,18983,739,634,1.0,2.0
5615,0,0,0,0,0,0,100.0,100.0
5616,11964,46,0,830,34,12,50.0,0.0
5617,3684,4,3684,1080,4,0,5.882352941176471,0.0
5618,8304,48,8304,1025,42,6,3.0303030303030303,57.69
5619,1730400,829,0,159564,682,147,100.0,0.0
5620,115644,1118,0,1872,810,308,1.0,10.0
5621,757380,6,0,388150,5,1,100.0,100.0
5622,984,22,984,127,18,4,6.25,48.18
5623,372,49,0,70,45,4,100.0,0.0
5624,143748,20,143748,15241,13,7,9.090909090909092,53.4
5625,5100,8,0,874,6,2,100.0,0.0
5626,398676,300,0,2266,150,150,3.0303030303030303,0.0
5627,1494168,240,653616,19661,110,130,2.857142857142857,68.47
5628,1954440,3272,96708,75374,1745,1527,1.0,0.0
5629,6384,22,6384,476,18,4,6.25,87.56
5630,504,2,504,336,1,1,50.0,77.0
5631,19584,50,0,1124,39,11,50.0,0.0
5632,15252,47,15252,2267,44,3,16.666666666666668,18.25
5633,43788,57,43788,1097,46,11,2.2222222222222223,9.0
5634,2009760,428,172255,185034,224,204,1.0,0.0
5635,9588,27,9588,978,25,2,4.0,66.46
5636,9852,21,9852,886,18,3,6.25,60.93
5637,1200,7,1200,564,5,2,25.0,0.0
5638,7992,9,0,1224,6,3,100.0,0.0
5639,120,15,120,20,15,0,7.6923076923076925,57.18
5640,1502304,232,0,15170,110,122,4.545454545454546,0.0
5641,1729692,642,0,64416,345,297,2.631578947368421,0.0
5642,84,19,72,11,19,0,5.555555555555555,52.9
5643,2032716,1043,0,36455,555,488,1.7241379310344829,0.0
5644,1044,34,1044,130,30,4,3.8461538461538463,70.59
5645,624,64,624,263,34,30,4.545454545454546,49.93
5646,492,0,492,0,0,0,50.0,91.4
5647,96,8,96,18,6,2,16.666666666666668,64.58
5648,46008,41,46008,2262,38,3,3.571428571428572,24.77
5649,16452,6,11076,850,6,0,12.5,74.77
5650,384,0,384,0,0,0,50.0,69.82
5651,156,18,156,6,18,0,5.2631578947368425,52.72
5652,228,55,60,32,40,15,3.0303030303030303,9.61
5653,7572,69,7572,1541,56,13,2.5,22.45
5654,60,16,60,3,16,0,5.882352941176471,62.09
5655,84,21,84,8,21,0,4.761904761904762,56.64
5656,1128,16,1128,381,12,4,10.0,94.57
5657,1788252,2097,0,8772,1569,528,1.0,0.0
5658,2952,20,0,484,18,2,50.0,0.0
5659,48,19,48,5,19,0,5.0,62.88
5660,168552,25,0,8243,18,7,50.0,0.0
5661,3264,85,0,1070,65,20,100.0,0.0
5662,72348,29,72348,1207,24,5,4.545454545454546,60.25
5663,22944,48,0,1260,39,9,50.0,0.0
5664,11976,47,11976,917,46,1,5.0,37.66
5665,72,23,72,9,23,0,4.3478260869565215,55.36
5666,21660,47,0,1150,36,11,50.0,0.0
5667,48,33,48,12,33,0,2.857142857142857,50.86
5668,32328,142,0,787,74,68,100.0,0.0
5669,2484,5,2484,547,5,0,16.666666666666668,91.15
5670,1759920,537,0,23252,224,313,1.7241379310344829,0.0
5671,475752,595,0,5077,325,270,1.96078431372549,0.0
5672,36,32,36,10,32,0,3.0303030303030303,47.95
5673,1764,44,0,560,35,9,100.0,0.0
5674,96,24,96,7,24,0,4.166666666666667,56.54
5675,12936,23,12936,959,19,4,7.142857142857143,74.0
5676,1416576,203,0,10588,109,94,4.761904761904762,0.0
5677,52440,44,52440,656,38,6,3.703703703703704,72.54
5678,240,2,240,126,1,1,50.0,63.77
5679,120,35,120,13,35,0,2.9411764705882355,58.23
5680,528,0,528,0,0,0,50.0,77.5
5681,408,2,408,234,2,0,25.0,96.67
5682,5112,14,5112,494,13,1,7.6923076923076925,84.06
5683,744,9,744,398,9,0,9.090909090909092,84.99
5684,16980,45,0,1142,36,9,50.0,0.0
5685,1820364,740,0,62610,430,310,2.127659574468085,0.0
5686,108,21,108,9,21,0,4.761904761904762,71.38
5687,29040,31,0,1954,30,1,100.0,0.0
5688,7368,68,7368,1272,56,12,2.5641025641025643,44.63
5689,85608,54,0,3489,42,12,50.0,0.0
5690,7668,10,7668,220,9,1,12.5,80.33
5691,216,40,216,114,26,14,4.761904761904762,56.04
5692,37416,8,37416,898,8,0,16.666666666666668,70.08
5693,324,12,324,99,8,4,12.5,89.74
5694,72,42,72,15,32,10,3.4482758620689653,13.06
5695,349932,104,0,4247,63,41,2.5,0.0
5696,2056716,4536,111276,104123,2641,1895,1.0,3.83
5697,902160,12,2388,75711,11,1,10.0,89.96
5698,55344,8,55344,7284,8,0,11.11111111111111,68.57
5699,3312,157,0,1315,98,59,100.0,0.0
5700,32028,33,32028,506,28,5,4.761904761904762,76.98
5701,72,12,72,40,9,3,11.11111111111111,43.63
5702,45924,219,0,4280,143,76,1.7857142857142858,1.96
5703,324,0,324,0,0,0,50.0,78.25
5704,1823976,882,0,20195,496,386,1.1764705882352942,0.0
5705,72828,18,72828,821,15,3,11.11111111111111,59.72
5706,300,2,300,54,2,0,25.0,69.48
5707,468,4,468,240,4,0,25.0,73.97
5708,60,20,60,26,14,6,7.6923076923076925,65.5
5709,1678716,47,0,115355,38,9,25.0,0.0
5710,420,25,420,230,13,12,10.0,47.91
5711,1638564,9,973230,35360,5,4,20.0,7.0
5712,888,11,888,354,9,2,11.11111111111111,67.81
5713,6348,62,6348,1530,53,9,2.702702702702702,47.75
5714,35028,13,35028,228,10,3,11.11111111111111,88.57
5715,648,0,648,0,0,0,50.0,67.24
5716,5184,24,5184,420,20,4,7.6923076923076925,86.8
5717,408,29,408,42,27,2,3.703703703703704,50.32
5718,1589928,186,0,18768,88,98,6.666666666666667,0.0
5719,2484,28,2484,2240,22,6,4.761904761904762,54.74
5720,324,29,324,30,29,0,3.703703703703704,52.16
5721,96912,48,58776,6641,30,18,4.3478260869565215,74.98
5722,7752,19,7752,987,17,2,7.142857142857143,71.04
5723,1775520,185,0,12762,89,96,4.166666666666667,0.0
5724,1851948,161,0,22322,73,88,4.545454545454546,0.0
5725,156,15,156,17,15,0,5.882352941176471,53.15
5726,1192440,195,0,26155,95,100,5.2631578947368425,0.0
5727,89628,77,89628,6373,45,32,3.333333333333333,34.83
5728,60,13,60,4,12,1,7.6923076923076925,50.28
5729,96,0,96,0,0,0,50.0,64.72
5730,192,1,192,24,1,0,33.333333333333336,62.48
5731,4212,23,4212,56,15,8,11.11111111111111,60.22
5732,456,61,456,201,29,32,8.333333333333334,25.89
5733,5424,17,5424,1886,12,5,9.090909090909092,83.68
5734,132,21,96,21,18,3,5.555555555555555,40.35
5735,261156,18,0,14634,16,2,50.0,0.0
5736,372,14,372,34,11,3,10.0,61.82
5737,1714836,373,0,18394,186,187,3.8461538461538463,0.0
5738,2066712,14678,0,878242,6861,7817,1.0,0.0
5739,1584,3,1584,336,3,0,33.333333333333336,98.29
5740,142788,8,142788,562,8,0,16.666666666666668,99.79
5741,1871244,964,0,28831,550,414,1.0,0.0
5742,888,44,96,43,38,6,2.7777777777777777,37.78
5743,55260,82,55260,3523,66,16,5.555555555555555,11.41
5744,8712,26,0,1976,11,15,50.0,0.0
5745,595164,377,87684,28931,253,124,20.0,0.0
5746,515280,49,204864,73276,49,0,3.703703703703704,94.77
5747,1857108,352,0,98692,182,170,2.272727272727273,0.0
5748,6084,26,6084,754,24,2,4.761904761904762,84.99
5749,120,1,120,0,1,0,50.0,98.0
5750,492,69,492,308,33,36,25.0,95.47
5751,2076,2,2076,210,2,0,25.0,62.79
5752,2071140,2954,0,1009905,1554,1400,1.0,0.0
5753,56328,115,0,1107,105,10,100.0,0.0
5754,42912,91,42912,190,73,18,1.5151515151515151,22.27
5755,3324,4,3324,501,4,0,16.666666666666668,78.8
5756,84,13,72,16,12,1,7.142857142857143,16.75
5757,3060,2,3060,738,2,0,33.333333333333336,99.39
5758,132,18,132,36,12,6,12.5,47.99
5759,1634748,564,0,5966,306,258,1.851851851851852,0.0
5760,945000,532,0,23091,295,237,1.6129032258064515,0.0
5761,252,21,120,44,16,5,7.142857142857143,44.62
5762,60,27,60,6,27,0,3.4482758620689653,36.94
5763,384,0,384,0,0,0,50.0,88.0
5764,936,29,936,89,24,5,4.761904761904762,56.46
5765,552,36,552,325,30,6,3.0303030303030303,67.39
5766,300,0,300,0,0,0,50.0,97.0
5767,1878468,1846,0,23010,1018,828,1.0,0.0
5768,308868,8,0,81738,3,5,50.0,0.0
5769,165960,752,0,2496,512,240,1.0,0.0
5770,84,6,84,18,3,3,50.0,22.37
5771,15204,8,15204,723,7,1,14.285714285714286,76.08
5772,4476,35,4476,154,33,2,2.857142857142857,36.17
5773,2017224,1468,0,55899,758,710,1.0,0.0
5774,624,4,624,234,2,2,33.333333333333336,80.9
5775,45276,26,45276,6174,14,12,10.0,88.61
5776,72,10,72,0,10,0,8.333333333333334,48.0
5777,3144,0,3144,0,0,0,50.0,64.0
5778,5676,2,5676,528,1,1,50.0,61.11
5779,600,30,600,98,26,4,3.703703703703704,73.51
5780,1786440,37,0,757207,14,23,1.0,1.6
5781,432,0,432,0,0,0,50.0,82.68
5782,6564,2,6564,42,1,1,50.0,61.42
5783,61308,7,61308,843,5,2,25.0,61.98
5784,263352,83,0,5537,47,36,7.142857142857143,1.51
5785,360,15,360,196,15,0,5.882352941176471,63.89
5786,49836,130,0,2242,65,65,5.555555555555555,0.0
5787,16092,11,16092,4369,10,1,9.090909090909092,50.27
5788,300,0,300,0,0,0,100.0,100.0
5789,432,22,432,38,22,0,4.0,33.36
5790,83808,6,83808,1632,6,0,14.285714285714286,32.95
5791,1064580,140,0,9240,69,71,4.0,0.0
5792,5748,5,5748,722,5,0,14.285714285714286,76.28
5793,0,0,0,0,0,0,100.0,100.0
5794,348,73,348,72,54,19,2.7777777777777777,72.69
5795,300,3,300,36,3,0,20.0,94.05
5796,396,130,396,73,82,48,1.6666666666666667,13.21
5797,1713948,131,0,14535,61,70,4.166666666666667,4.0
5798,444,0,444,0,0,0,100.0,100.0
5799,265932,251,0,2224,126,125,2.9411764705882355,0.0
5800,19164,120,0,1559,63,57,5.2631578947368425,3.0
5801,9876,51,9876,170,43,8,2.5641025641025643,42.81
5802,1865700,2899,0,26987,1659,1240,1.0,0.0
5803,782484,309,0,8230,145,164,2.631578947368421,0.0
5804,70764,66,70764,2677,58,8,1.818181818181818,25.44
5805,86688,5,86688,2368,5,0,14.285714285714286,93.48
5806,72,7,72,0,7,0,11.11111111111111,25.57
5807,1320,2,1320,582,1,1,50.0,65.58
5808,1824,27,1824,1146,20,7,5.555555555555555,49.01
5809,468,44,468,191,28,16,4.545454545454546,63.69
5810,336,11,336,53,8,3,11.11111111111111,69.3
5811,1789860,176,0,26559,83,93,3.4482758620689653,0.0
5812,348,2,348,24,2,0,25.0,61.52
5813,1044,34,0,787,32,2,2.5641025641025643,0.0
5814,401436,139,0,8213,75,64,2.2222222222222223,0.0
5815,168,52,168,47,45,7,2.702702702702702,98.62
5816,3276,1,3276,2484,1,0,33.333333333333336,96.22
5817,1793640,775,0,20439,417,358,1.2345679012345678,2.23
5818,600,32,108,51,32,0,3.0303030303030303,13.99
5819,33900,66,132,748,58,8,3.4482758620689653,46.56
5820,2160,7,1968,774,5,2,100.0,0.0
5821,588,46,588,2,46,0,2.083333333333333,34.19
5822,1956,6,1956,1008,5,1,16.666666666666668,66.2
5823,52980,16,52980,3929,11,5,12.5,66.05
5824,1567440,14,1201938,7749,10,4,14.285714285714286,81.42
5825,108,0,108,0,0,0,50.0,67.24
5826,204,20,192,42,16,4,6.666666666666667,39.44
5827,144,0,144,0,0,0,100.0,80.0
5828,2004,2,2004,0,2,0,25.0,55.5
5829,1821192,426,0,48228,241,185,1.351351351351351,0.0
5830,144,38,144,44,28,10,4.3478260869565215,46.17
5831,108,35,108,14,34,1,9.090909090909092,57.03
5832,372,13,372,85,13,0,6.666666666666667,60.91
5833,108,13,108,17,10,3,11.11111111111111,55.41
5834,1871928,618,0,42048,335,283,1.2345679012345678,0.0
5835,120,36,108,31,32,4,3.225806451612903,35.16
5836,48,37,48,13,31,6,3.333333333333333,29.71
5837,84,20,84,31,13,7,12.5,51.11
5838,33204,13,0,2846,12,1,100.0,0.0
5839,499116,171,0,10968,83,88,4.0,0.0
5840,1514220,602,0,12155,343,259,2.2222222222222223,10.0
5841,804,7,804,12,7,0,11.11111111111111,86.0
5842,20532,162,0,1267,64,98,7.142857142857143,0.0
5843,624,10,132,84,8,2,11.11111111111111,18.88
5844,774084,39,774084,6596,29,10,3.8461538461538463,19.48
5845,72,29,72,29,16,13,20.0,67.53
5846,2070996,2156,0,325310,1241,915,1.0,0.0
5847,60,41,60,17,29,12,4.0,46.46
5848,1847076,377,0,16404,189,188,2.9411764705882355,0.0
5849,77688,11,77688,166,7,4,20.0,28.65
5850,433728,61,0,76407,48,13,4.545454545454546,0.0
5851,108,27,108,34,15,12,10.0,67.35
5852,207864,32,0,11434,28,4,50.0,0.0
5853,168,67,108,53,53,14,1.851851851851852,25.91
5854,348,9,348,48,5,4,25.0,52.58
5855,180,8,180,18,5,3,25.0,21.62
5856,29748,127,0,638,84,43,1.8867924528301887,2.0
5857,312,27,312,112,16,11,12.5,16.42
5858,8736,64,8736,1959,57,7,1.7857142857142858,28.46
5859,1979592,1986,0,22035,1107,879,1.0,0.0
5860,1895616,22,17436,90410,18,4,8.333333333333334,70.15
5861,2046864,674,0,84582,363,311,1.4285714285714286,3.84
5862,3156,50,0,1140,39,11,100.0,0.0
5863,108,22,108,31,20,2,5.0,23.31
5864,1404,13,1404,262,7,6,33.333333333333336,70.7
5865,1915524,690,0,25016,380,310,1.96078431372549,0.0
5866,2616,1,2616,1212,1,0,50.0,99.28
5867,1939608,3740,0,30286,2035,1705,1.0,0.0
5868,1582524,340,0,128317,179,161,2.3255813953488373,0.0
5869,573060,24,0,27357,20,4,100.0,0.0
5870,312,12,312,121,8,4,12.5,90.06
5871,1507704,347,0,12764,193,154,2.3255813953488373,0.0
5872,1872660,547,0,26131,292,255,1.7241379310344829,0.0
5873,2484,5,2484,703,5,0,14.285714285714286,91.38
5874,1938144,70,130632,1369261,35,35,1.0,0.0
5875,264,1,264,0,1,0,33.333333333333336,63.56
5876,34740,39,34740,946,35,4,3.8461538461538463,64.33
5877,20172,12,20172,20078,10,2,9.090909090909092,88.64
5878,4320,36,4320,4194,30,6,3.4482758620689653,80.63
5879,12108,18,12108,341,14,4,8.333333333333334,0.82
5880,40488,164,0,1886,113,51,100.0,0.0
5881,2508,48,0,702,37,11,100.0,0.0
5882,144,23,144,35,17,6,7.6923076923076925,40.2
5883,948,1,948,120,1,0,33.333333333333336,55.34
5884,32820,19,32820,623,15,4,10.0,75.52
5885,28020,24,28020,642,20,4,5.882352941176471,66.79
5886,468,2,468,0,2,0,50.0,72.07
5887,324,3,324,20,2,1,33.333333333333336,53.34
5888,49116,40,49116,1425,38,2,8.333333333333334,33.7
5889,19908,201,0,1922,117,84,1.6666666666666667,0.0
5890,84,10,84,34,7,3,20.0,27.26
5891,1980,62,0,703,49,13,100.0,0.0
5892,6048,9,6048,1365,8,1,12.5,90.45
5893,1588896,10,0,272022,10,0,25.0,98.34
5894,1032516,258,0,5619,157,101,100.0,0.0
5895,588,0,588,0,0,0,50.0,56.48
5896,141960,22,0,6625,15,7,10.0,0.0
5897,312,7,312,82,4,3,25.0,96.5
5898,34476,55,34476,797,47,8,2.5641025641025643,79.2
5899,36168,20,36168,504,17,3,6.25,85.62
5900,1381800,944,0,80252,616,328,1.0,0.0
5901,2060172,20,0,105001,13,7,100.0,0.0
5902,12,1,0,12,1,0,33.333333333333336,0.0
5903,53364,9,53364,480,8,1,11.11111111111111,82.33
5904,238044,214,0,1846,97,117,4.166666666666667,0.0
5905,39960,287,0,8308,202,85,33.333333333333336,0.0
5906,204,10,204,72,9,1,9.090909090909092,45.41
5907,20628,26,20628,1779,21,5,6.25,70.04
5908,42864,13,42864,201,12,1,7.6923076923076925,76.52
5909,1845456,616,0,14387,323,293,1.5151515151515151,0.0
5910,324,86,324,85,50,36,2.9411764705882355,50.28
5911,228,1,228,12,1,0,33.333333333333336,24.02
5912,684,14,684,474,13,1,7.6923076923076925,84.09
5913,1044,195,708,287,123,72,1.162790697674419,28.3
5914,10596,14,10596,1016,10,4,10.0,87.13
5915,8928,45,8928,909,44,1,6.25,36.36
5916,1036500,621,0,7428,334,287,1.7241379310344829,0.0
5917,168,3,168,40,1,2,50.0,79.58
5918,1716,10,0,343,9,1,9.090909090909092,0.0
5919,4092,28,4092,1701,26,2,3.703703703703704,61.83
5920,56604,49,0,1956,37,12,50.0,0.0
5921,2076,2,2076,642,2,0,50.0,0.0
5922,840,11,840,626,11,0,7.6923076923076925,77.62
5923,57300,47,0,1883,39,8,50.0,0.0
5924,16524,32,16524,759,27,5,4.761904761904762,64.35
5925,1878612,2342,0,85836,1246,1096,1.0,0.0
5926,780,14,780,570,13,1,7.142857142857143,77.27
5927,11652,17,6420,812,14,3,7.142857142857143,74.63
5928,58836,47,0,1984,37,10,50.0,0.0
5929,1698180,1729,0,5363,1362,367,1.0638297872340423,0.0
5930,319932,78,319932,16212,43,35,4.0,72.3
5931,59472,49,0,2202,34,15,50.0,0.0
5932,1073028,116,831300,480211,114,2,1.7241379310344829,87.8
5933,1199712,231,712488,304976,231,0,1.1764705882352942,76.39
5934,29460,62,0,3650,45,17,100.0,0.0
5935,216,17,216,66,9,8,25.0,20.9
5936,1692,8,1692,384,8,0,11.11111111111111,70.03
5937,405228,41,13512,54449,31,10,4.166666666666667,83.76
5938,2101164,775,0,17908,420,355,1.694915254237288,4.38
5939,23352,36,0,3612,31,5,100.0,0.0
5940,2119116,4122,0,81578,2240,1882,1.0,0.0
5941,2070060,31,248340,137273,28,3,3.8461538461538463,29.99
5942,4584,4,4584,789,4,0,25.0,0.0
5943,1989396,434,0,13221,226,208,3.8461538461538463,0.0
5944,15612,49,15612,1212,47,2,8.333333333333334,17.05
5945,16452,39,0,1410,24,15,100.0,0.0
5946,2124552,548,0,621156,297,251,1.0,1.47
5947,2128116,60566,796884,853293,33778,26788,1.0,0.22
5948,4404,84,4404,3634,82,2,1.1764705882352942,30.31
5949,13032,16,13032,1008,14,2,6.666666666666667,84.68
5950,176316,2,176316,87996,2,0,8.333333333333334,0.0
5951,180,68,180,37,40,28,3.571428571428572,52.63
5952,1768536,1164,0,13297,634,530,1.1904761904761905,0.0
5953,76056,13,76056,363,11,2,12.5,80.74
5954,76116,23,76116,2939,18,5,7.6923076923076925,84.12
5955,120,12,120,9,12,0,7.6923076923076925,74.04
5956,355920,80,0,5234,62,18,33.333333333333336,0.0
5957,5532,8,0,1710,6,2,12.5,0.0
5958,12072,3,0,5280,1,2,33.333333333333336,0.1
5959,153720,11,0,23168,7,4,33.333333333333336,75.0
5960,962220,89,0,22669,69,20,50.0,0.0
5961,456,153,456,142,117,36,1.020408163265306,38.29
5962,2081652,2108,698640,62527,1120,988,1.0,0.0
5963,24540,32,24540,687,27,5,4.761904761904762,70.39
5964,107976,9,107976,35545,6,3,16.666666666666668,91.44
5965,13668,61,13668,2149,60,1,4.0,17.1
5966,362340,52,0,15483,43,9,33.333333333333336,0.0
5967,27624,48,0,1595,33,15,50.0,0.0
5968,25896,47,0,1304,39,8,50.0,0.0
5969,6252,0,6252,0,0,0,50.0,0.0
5970,5580,16,5580,470,12,4,11.11111111111111,90.63
5971,1753128,890,0,18547,477,413,1.7857142857142858,0.0
5972,3876,27,3876,694,23,4,5.555555555555555,65.07
5973,372,2,372,216,1,1,50.0,98.86
5974,68136,20,68136,1344,18,2,7.6923076923076925,50.35
5975,1752,3,1752,384,3,0,50.0,99.98
5976,1452,12,1452,527,12,0,100.0,100.0
5977,27312,48,0,1346,36,12,50.0,0.0
5978,888,1,888,312,1,0,33.333333333333336,86.08
5979,804,3,804,328,2,1,50.0,99.99
5980,40188,71,40188,1146,65,6,1.7857142857142858,66.84
5981,8940,1,8940,252,1,0,33.333333333333336,96.16
5982,81024,87,0,28957,34,53,20.0,0.0
5983,62400,38,62400,152,38,0,2.5,36.63
5984,18804,40,0,1443,25,15,100.0,0.0
5985,216,0,216,0,0,0,100.0,100.0
5986,48324,17,48324,926,15,2,14.285714285714286,69.69
5987,1416,24,1416,1192,18,6,5.882352941176471,67.18
5988,4476,45,4476,1005,37,8,3.8461538461538463,52.79
5989,26916,5,384,5529,3,2,25.0,62.91
5990,1474248,4,1474248,1671,3,1,20.0,8.6
5991,276,49,276,24,44,5,2.380952380952381,83.25
5992,118908,21,118908,2021,17,4,7.6923076923076925,62.1
5993,64464,1,64464,612,1,0,33.333333333333336,33.96
5994,192,11,192,30,7,4,14.285714285714286,89.63
5995,175596,26,175596,2615,22,4,4.761904761904762,41.74
5996,7200,18,7200,778,16,2,8.333333333333334,62.37
5997,65820,16,65820,288,16,0,11.11111111111111,51.25
5998,96,2,96,48,1,1,50.0,65.71
5999,36,7,36,0,7,0,11.11111111111111,21.0
6000,4116,225,0,1014,126,99,100.0,0.0
6001,120,5,120,28,3,2,33.333333333333336,63.74
6002,50016,27,50016,945,22,5,7.142857142857143,78.8
6003,264,2,264,132,2,0,25.0,59.82
6004,420,1,420,60,1,0,33.333333333333336,59.76
6005,7248,23,7248,1149,20,3,8.333333333333334,60.96
6006,7284,45,7284,1309,35,10,4.545454545454546,63.74
6007,1870320,915,0,17452,494,421,1.1764705882352942,0.0
6008,4212,32,4212,501,26,6,4.545454545454546,77.7
6009,24900,21,24900,834,18,3,6.666666666666667,56.7
6010,168,1,168,168,1,0,33.333333333333336,22.87
6011,3900,45,3900,1121,37,8,3.4482758620689653,57.57
6012,69144,15,69144,1397,15,0,7.6923076923076925,26.65
6013,7140,22,2232,845,18,4,8.333333333333334,75.36
6014,101028,105,0,45663,25,80,25.0,0.0
6015,348,8,192,139,7,1,25.0,95.92
6016,45468,25,45468,1295,22,3,3.703703703703704,59.27
6017,6216,27,6216,2902,22,5,7.142857142857143,48.91
6018,2153376,17588,145366,239183,10405,7183,1.0,0.92
6019,4320,140,3636,2286,126,14,1.0,53.96
6020,134868,58,14664,3475,51,7,2.7777777777777777,33.84
6021,7356,3,7356,396,3,0,16.666666666666668,0.0
6022,64800,22,64800,1564,22,0,4.545454545454546,40.24
6023,169920,7,169920,1340,7,0,12.5,66.28
6024,4068,29,4068,1948,27,2,4.0,52.41
6025,21504,30,21504,1727,24,6,6.25,82.14
6026,621552,144,0,12735,92,52,3.125,33.79
6027,159156,2,420,159156,1,1,100.0,100.0
6028,276,5,276,144,5,0,50.0,99.13
6029,81888,40,81888,224,36,4,2.857142857142857,56.52
6030,6912,54,6912,1576,46,8,3.125,74.21
6031,95088,163,47724,4269,116,47,4.3478260869565215,11.79
6032,6504,13,6504,2113,12,1,7.142857142857143,0.0
6033,180,63,180,31,45,18,2.631578947368421,38.9
6034,564,17,564,305,17,0,11.11111111111111,93.15
6035,10704,6,10704,6916,6,0,14.285714285714286,88.62
6036,480,19,480,281,19,0,16.666666666666668,80.85
6037,2532,10,2532,595,9,1,10.0,91.7
6038,288,10,288,183,10,0,12.5,87.88
6039,336,6,336,218,6,0,20.0,90.52
6040,4932,20,4932,531,18,2,9.090909090909092,55.64
6041,10656,58,10656,2237,51,7,2.631578947368421,54.05
6042,780,2,780,30,1,1,50.0,63.45
6043,72,13,72,3,13,0,6.666666666666667,43.95
6044,2148504,654,0,530823,358,296,1.162790697674419,0.0
6045,22200,159,0,618,91,68,2.5641025641025643,2.0
6046,801804,20,801804,702613,20,0,4.761904761904762,65.51
6047,1404,9,1404,250,8,1,12.5,51.67
6048,8448,5,8448,7951,3,2,25.0,97.17
6049,708,1,708,432,1,0,33.333333333333336,0.0
6050,1224,5,1188,736,2,3,33.333333333333336,44.32
6051,584436,208,0,12536,85,123,5.2631578947368425,0.0
6052,1603200,228,0,10011,141,87,33.333333333333336,0.0
6053,12336,27,12336,1432,23,4,5.555555555555555,72.13
6054,8484,222,0,1440,135,87,100.0,0.0
6055,12012,39,0,1304,24,15,100.0,0.0
6056,267120,30,0,10381,27,3,50.0,0.0
6057,2153508,3618,46032,88848,1977,1641,1.0,0.0
6058,127152,44,127152,4636,40,4,3.571428571428572,24.44
6059,108,1,108,0,1,0,50.0,73.91
6060,660,7,660,264,6,1,14.285714285714286,73.87
6061,10272,30,10272,1080,27,3,4.3478260869565215,74.98
6062,4104,33,4104,2114,32,1,3.0303030303030303,53.59
6063,99000,3,99000,1524,3,0,33.333333333333336,99.95
6064,34380,54,0,1512,39,15,50.0,0.0
6065,150648,102,150648,10838,82,20,1.36986301369863,23.23
6066,816,3,816,204,2,1,50.0,99.97
6067,35388,49,0,1933,37,12,50.0,0.0
6068,96852,12,96852,13521,8,4,16.666666666666668,58.75
6069,89064,220,0,16121,152,68,100.0,0.0
6070,29616,12,29616,561,11,1,11.11111111111111,65.73
6071,365520,819,0,5789,445,374,1.5625,0.0
6072,1985676,0,1985676,0,0,0,50.0,10.0
6073,2092932,403,0,116514,300,103,50.0,0.0
6074,3048,19,3048,1158,18,1,50.0,99.98
6075,156,9,156,4,9,0,9.090909090909092,91.0
6076,24144,14,24144,18019,12,2,8.333333333333334,71.79
6077,324,1,324,228,1,0,50.0,86.18
6078,10212,40,0,1245,25,15,100.0,0.0
6079,8376,37,8376,132,35,2,2.7777777777777777,42.6
6080,252,35,252,7,29,6,3.571428571428572,53.71
6081,23280,60,23280,900,51,9,2.380952380952381,78.74
6082,6372,17,4044,2146,14,3,10.0,54.98
6083,2448,63,0,987,51,12,100.0,0.0
6084,14760,36,14760,1119,31,5,3.8461538461538463,62.05
6085,103452,17,0,10285,15,2,100.0,0.0
6086,46380,2,46380,23814,2,0,25.0,96.18
6087,372,5,372,163,3,2,33.333333333333336,58.89
6088,344664,340,216705,176320,304,36,1.5625,20.97
6089,564,67,564,148,63,4,1.5873015873015872,59.15
6090,1931124,316,1931124,835787,261,55,1.5873015873015872,0.0
6091,45708,47,0,1686,35,12,50.0,0.0
6092,1104,6,1056,694,5,1,25.0,75.29
6093,50100,34,50100,2146,33,1,10.0,41.35
6094,75780,6,75780,258,5,1,16.666666666666668,90.52
6095,47940,50,0,1550,38,12,50.0,0.0
6096,487548,772,7488,4886,413,359,2.272727272727273,0.0
6097,21900,37,0,1980,32,5,100.0,0.0
6098,1308,0,1308,0,0,0,50.0,51.2
6099,11100,21,11100,862,17,4,6.666666666666667,83.9
6100,1435884,1347,0,14978,751,596,1.098901098901099,0.0
6101,1202376,5,604122,1987,5,0,16.666666666666668,90.88
6102,56796,52,0,2063,39,13,25.0,0.0
6103,17880,36,17880,1458,32,4,3.571428571428572,77.37
6104,87972,39,0,16428,20,19,10.0,0.0
6105,10200,38,0,1279,24,14,100.0,0.0
6106,11520,51,11520,30,41,10,2.631578947368421,22.08
6107,1802496,325,0,7806,184,141,50.0,0.0
6108,1572,8,1572,496,8,0,10.0,90.84
6109,564,4,564,225,4,0,14.285714285714286,91.06
6110,0,0,0,0,0,0,50.0,99.78
6111,839508,1923,0,18500,1039,884,1.0,0.0
6112,12552,51,0,2239,43,8,100.0,0.0
6113,5448,13,5448,528,13,0,6.25,79.68
6114,10296,23,10296,437,19,4,5.882352941176471,89.43
6115,248424,31,248424,9970,30,1,3.333333333333333,37.98
6116,1725540,74,0,109774,36,38,1.36986301369863,0.0
6117,10212,44,0,1192,28,16,100.0,0.0
6118,612,100,612,128,78,22,1.36986301369863,26.3
6119,2035380,333,0,614565,270,63,1.4285714285714286,0.0
6120,88404,255,0,1312,121,134,4.761904761904762,0.0
6121,1901088,66,20604,108549,62,4,7.142857142857143,26.38
6122,2131524,1430,0,69956,788,642,1.162790697674419,0.0
6123,32328,46,0,1366,34,12,50.0,0.0
6124,528,25,0,79,22,3,100.0,0.0
6125,10992,12,10992,462,12,0,7.142857142857143,80.34
6126,22572,53,0,1297,40,13,50.0,0.0
6127,29532,107,0,1676,59,48,3.125,0.0
6128,240,1,240,48,1,0,25.0,71.29
6129,2215992,12080,78426,313503,6618,5462,1.0,0.7
6130,28152,33,28152,1294,28,5,4.166666666666667,65.92
6131,348,9,348,98,5,4,20.0,48.39
6132,1975272,8,0,362488,7,1,25.0,0.0
6133,303912,28,0,13384,26,2,50.0,0.0
6134,1766496,1247,0,14726,680,567,1.351351351351351,4.97
6135,10224,39,0,1311,25,14,100.0,0.0
6136,2496,21,2496,550,17,4,7.142857142857143,75.05
6137,4428,42,0,648,35,7,33.333333333333336,0.0
6138,2220276,1474,0,1043890,858,616,1.0,1.38
6139,1308924,1256,6948,35877,678,578,1.7543859649122806,0.0
6140,27660,50,0,1550,41,9,50.0,0.0
6141,1404,31,0,416,26,5,100.0,0.0
6142,288,12,288,40,11,1,11.11111111111111,78.8
6143,35112,44,33768,2762,39,5,2.9411764705882355,66.75
6144,25524,53,0,1361,38,15,50.0,0.0
6145,8988,49,0,967,37,12,50.0,0.0
6146,8844,56,8844,1228,55,1,7.6923076923076925,24.67
6147,1821864,4558,26352,58876,2596,1962,1.0,0.0
6148,12180,47,0,1264,36,11,25.0,0.0
6149,1344,8,1344,511,8,0,50.0,99.89
6150,2748,97,0,852,72,25,100.0,0.0
6151,132,9,132,46,8,1,14.285714285714286,91.04
6152,70284,19,70284,1004,16,3,8.333333333333334,58.58
6153,156,1,0,156,1,0,100.0,0.0
6154,4044,52,1560,1060,49,3,3.225806451612903,53.98
6155,63000,43,63000,3821,36,7,4.0,75.92
6156,24120,71,24120,2540,33,38,12.5,89.38
6157,1284,18,1284,316,18,0,33.333333333333336,99.89
6158,540,19,540,306,17,2,20.0,95.59
6159,552,15,552,386,13,2,14.285714285714286,91.69
6160,468,12,468,291,11,1,25.0,92.0
6161,2206212,761,0,25649,423,338,2.083333333333333,0.0
6162,56124,29,56124,1683,24,5,6.25,69.91
6163,45084,1,45084,240,1,0,33.333333333333336,61.57
6164,40488,224,0,1963,135,89,1.6666666666666667,0.0
6165,756,5,756,331,3,2,25.0,73.48
6166,12012,43,0,1227,28,15,100.0,0.0
6167,81048,11,81048,742,10,1,10.0,66.14
6168,2208,3,0,1032,3,0,20.0,0.0
6169,309372,180,0,20870,98,82,5.0,0.0
6170,4572,11,4572,350,11,0,8.333333333333334,63.3
6171,156,27,156,33,21,6,5.555555555555555,47.74
6172,72,12,72,2,11,1,8.333333333333334,46.02
6173,1375812,23,0,129002,13,10,16.666666666666668,0.0
6174,22740,21,22740,1021,19,2,4.545454545454546,73.48
6175,133596,362,0,10590,243,119,100.0,0.0
6176,9456,238,0,1157,136,102,100.0,0.0
6177,264,7,264,130,7,0,20.0,70.81
6178,59136,21,59136,3455,19,2,5.2631578947368425,35.67
6179,1236,10,828,496,9,1,11.11111111111111,73.28
6180,44748,20,44748,928,17,3,7.142857142857143,80.36
6181,4692,181,0,1165,120,61,1.408450704225352,0.0
6182,17688,15,240,1252,8,7,25.0,60.15
6183,48,4,48,18,2,2,33.333333333333336,34.92
6184,1611180,847,0,16814,458,389,1.5151515151515151,0.0
6185,83400,40,648,2275,25,15,7.6923076923076925,55.76
6186,216,0,216,0,0,0,50.0,59.29
6187,63192,28,63192,1637,25,3,6.25,52.65
6188,99336,152,0,2426,76,76,5.2631578947368425,0.0
6189,1844928,794,0,7873,440,354,1.5873015873015872,0.0
6190,36132,270,0,2619,163,107,50.0,0.0
6191,223212,15,0,37168,15,0,5.882352941176471,7.17
6192,188544,53,61848,4309,51,2,1.96078431372549,36.86
6193,132,2,132,60,2,0,25.0,58.22
6194,396,12,396,42,12,0,7.142857142857143,54.88
6195,12012,46,0,1295,30,16,100.0,0.0
6196,29352,47,29352,1986,41,6,3.225806451612903,57.48
6197,324,2,324,72,1,1,100.0,100.0
6198,56604,16,56604,352,14,2,7.6923076923076925,78.3
6199,96,10,96,0,10,0,6.25,21.0
6200,1944,17,1944,611,11,6,25.0,88.85
6201,80640,11,80640,771,11,0,9.090909090909092,22.16
6202,2050596,907,0,20238,526,381,1.2987012987012987,4.0
6203,2229108,920,0,463319,522,398,1.0,0.0
6204,90576,0,90576,0,0,0,100.0,0.0
6205,1200,13,1200,220,11,2,10.0,82.97
6206,7704,24,7704,864,21,3,5.555555555555555,76.06
6207,6048,1,6048,1500,1,0,50.0,99.53
6208,1409520,5,705450,226156,4,1,20.0,33.49
6209,492,1,492,216,0,1,50.0,94.87
6210,175536,136,0,3720,116,20,100.0,0.0
6211,984,3,984,596,3,0,25.0,74.7
6212,4020,7,4020,3020,7,0,11.11111111111111,43.74
6213,2688,11,2688,758,9,2,25.0,0.0
6214,2227608,2529,0,43643,1381,1148,1.0,0.0
6215,4620,167,0,1429,95,72,2.3255813953488373,0.0
6216,192,1,192,96,1,0,33.333333333333336,58.69
6217,27564,27,27564,1095,22,5,7.6923076923076925,83.5
6218,1356,31,1356,176,31,0,3.225806451612903,38.06
6219,1128,1,1128,372,1,0,25.0,49.22
6220,7320,348,0,2675,202,146,100.0,0.0
6221,35700,7,1212,5633,5,2,100.0,0.0
6222,13080,17,13080,612,17,0,5.555555555555555,77.12
6223,169536,60,0,7914,52,8,50.0,0.0
6224,540,0,540,0,0,0,20.0,0.0
6225,90648,6,90648,930,5,1,20.0,81.55
6226,624,11,576,312,10,1,8.333333333333334,45.02
6227,33720,16,33720,1133,12,4,14.285714285714286,64.26
6228,2040,5,666,1039,4,1,100.0,99.99
6229,12012,44,0,1238,28,16,100.0,0.0
6230,12060,10,12060,11920,4,6,33.333333333333336,73.01
6231,1344,38,1344,18,36,2,2.702702702702702,23.32
6232,1368,32,0,469,27,5,50.0,69.44
6233,6204,20,6204,433,17,3,6.25,87.1
6234,2301600,6915,0,303147,3874,3041,1.0,0.0
6235,168,8,168,31,6,2,16.666666666666668,57.43
6236,10320,8,288,1372,6,2,10.0,58.15
6237,96,3,96,44,3,0,20.0,60.75
6238,1973160,162,0,43466,90,72,4.0,0.0
6239,11268,28,11268,1656,26,2,5.0,75.55
6240,624,14,624,238,10,4,9.090909090909092,86.35
6241,36,16,36,9,12,4,10.0,20.29
6242,153744,25,153744,8481,25,0,4.166666666666667,34.7
6243,264,23,264,31,17,6,6.25,65.55
6244,1850364,375,0,17166,191,184,2.083333333333333,0.0
6245,10488,198,0,1327,110,88,100.0,0.0
6246,720,31,720,178,31,0,3.0303030303030303,39.84
6247,1176,0,1176,0,0,0,50.0,57.18
6248,1200,39,1200,20,27,12,4.3478260869565215,28.89
6249,1428564,1537,0,445803,758,779,1.0,0.0
6250,2121792,40,0,163227,35,5,25.0,0.0
6251,1804188,803,0,13102,432,371,1.3157894736842106,3.99
6252,84948,105,55020,4471,80,25,7.6923076923076925,11.69
6253,44784,50,0,1620,37,13,50.0,0.0
6254,5112,183,0,1570,104,79,1.8867924528301887,0.0
6255,621144,2,566214,168,2,0,25.0,0.0
6256,1490472,65,0,168624,51,14,12.5,0.0
6257,1094760,49,3120,156194,35,14,3.125,14.09
6258,2112,3,2112,92,2,1,33.333333333333336,91.84
6259,13056,253,0,2567,198,55,100.0,0.0
6260,2115300,1009,0,15094,546,463,1.3157894736842106,0.0
6261,456,6,456,60,4,2,25.0,52.88
6262,708,1,708,72,1,0,50.0,98.04
6263,2223912,1617,0,34186,895,722,1.0,0.0
6264,78600,178,0,2216,107,71,100.0,0.0
6265,22272,46,22272,1356,39,7,3.333333333333333,60.39
6266,12012,41,0,1341,25,16,100.0,0.0
6267,6564,213,0,2576,159,54,100.0,0.0
6268,432,9,432,105,9,0,9.090909090909092,51.09
6269,92724,97,92724,2329,79,18,1.3157894736842106,21.08
6270,7140,346,0,2728,203,143,100.0,0.0
6271,593028,293,0,8068,252,41,33.333333333333336,0.0
6272,63324,43,0,4788,37,6,50.0,0.0
6273,555996,8,336,156379,6,2,50.0,0.0
6274,12756,7,3048,2760,4,3,100.0,0.0
6275,372,35,168,52,28,7,4.3478260869565215,82.7
6276,60660,47,0,2037,37,10,50.0,0.0
6277,17916,14,17916,1296,12,2,6.666666666666667,85.97
6278,12024,41,0,1287,25,16,100.0,0.0
6279,19572,45,19572,166,37,8,2.857142857142857,20.13
6280,17304,46,17304,814,45,1,7.6923076923076925,45.98
6281,61836,50,0,2000,37,13,50.0,0.0
6282,3936,27,3414,1463,18,9,100.0,0.0
6283,360,7,360,132,7,0,11.11111111111111,59.79
6284,192,2,192,24,1,1,50.0,22.98
6285,89712,285,0,5845,257,28,100.0,0.0
6286,9492,23,9492,793,18,5,6.666666666666667,87.31
6287,66672,54,66672,978,47,7,2.9411764705882355,38.33
6288,12864,23,12864,452,20,3,5.555555555555555,86.81
6289,1904688,222,1206528,226599,182,40,1.0,8.69
6290,21252,48,0,1110,38,10,50.0,0.0
6291,2328132,5723,0,268243,3201,2522,1.0,0.0
6292,192,9,192,36,4,5,50.0,72.89
6293,1925112,2056,0,22444,1157,899,1.0,0.0
6294,12012,42,0,1213,27,15,100.0,0.0
6295,419808,83,0,42766,63,20,20.0,0.0
6296,62556,20,62556,1632,16,4,14.285714285714286,64.53
6297,1152,3,1152,52,2,1,33.333333333333336,24.62
6298,69564,217,37680,8642,117,100,3.8461538461538463,75.37
6299,1896,24,1896,791,23,1,4.3478260869565215,0.0
6300,59328,14,59328,996,11,3,14.285714285714286,72.84
6301,87816,38,0,5204,33,5,100.0,0.0
6302,10812,43,0,1244,28,15,100.0,0.0
6303,36804,52,0,1526,39,13,50.0,0.0
6304,2307336,51,0,196892,40,11,20.0,0.0
6305,67944,94,300,893,66,28,2.272727272727273,51.67
6306,624,6,624,340,6,0,33.333333333333336,53.58
6307,16368,50,0,1067,38,12,50.0,0.0
6308,16404,47,0,1008,36,11,50.0,0.0
6309,408,6,408,232,5,1,25.0,4.7
6310,1728192,125,0,532074,57,68,3.8461538461538463,0.0
6311,8652,268,0,3830,201,67,100.0,0.0
6312,1020,7,1020,325,7,0,25.0,32.41
6313,39252,59,39252,2647,46,13,3.4482758620689653,58.39
6314,47928,21,47928,970,18,3,6.666666666666667,77.83
6315,0,0,0,0,0,0,50.0,90.0
6316,3048,55,3048,1291,48,7,10.0,48.41
6317,1630164,40,0,64447,35,5,33.333333333333336,0.0
6318,2304624,475,0,276760,264,211,1.9230769230769231,9.43
6319,636,10,636,242,9,1,25.0,51.29
6320,1227828,5,674418,363717,3,2,1.0,0.0
6321,1524,23,1524,1314,23,0,4.0,77.89
6322,57444,27,57444,2440,20,7,7.6923076923076925,54.13
6323,32448,58,32448,1799,57,1,4.545454545454546,18.97
6324,735768,195,0,12545,107,88,5.2631578947368425,0.0
6325,1978596,20,4440,297348,17,3,7.142857142857143,74.51
6326,12012,39,0,1303,25,14,100.0,0.0
6327,65592,41,65592,2663,36,5,4.0,67.09
6328,132,0,132,0,0,0,50.0,59.29
6329,8964,44,8964,1465,36,8,3.703703703703704,60.73
6330,1633128,471,0,52628,253,218,2.631578947368421,0.0
6331,444,20,444,0,20,0,4.545454545454546,21.56
6332,552,0,552,0,0,0,100.0,100.0
6333,67500,13,65424,5839,11,2,9.090909090909092,88.61
6334,2182200,34,93732,165184,26,8,6.666666666666667,68.96
6335,2976,37,2976,190,31,6,3.225806451612903,0.0
6336,344112,10,344112,154936,4,6,1.0,0.0
6337,4284,36,4284,86,30,6,3.571428571428572,14.23
6338,4776,38,0,2286,29,9,100.0,0.0
6339,300,23,300,16,21,2,4.0,43.9
6340,43140,39,43140,1690,35,4,50.0,27.81
6341,2328,0,1578,0,0,0,100.0,100.0
6342,1452,84,1452,594,77,7,2.7777777777777777,44.11
6343,25068,101,0,1662,63,38,2.5641025641025643,0.0
6344,444,61,444,41,43,18,2.7777777777777777,13.17
6345,90876,176,0,5371,129,47,33.333333333333336,0.0
6346,58080,123,0,4370,109,14,100.0,0.0
6347,3276,3,3276,428,3,0,20.0,81.97
6348,720,33,720,134,32,1,3.703703703703704,68.68
6349,2138880,1112,0,278687,612,500,1.0,5.97
6350,3900,48,3900,44,32,16,3.8461538461538463,21.46
6351,768,5,768,513,4,1,50.0,99.04
6352,10212,41,0,1372,27,14,100.0,0.0
6353,384,45,168,80,35,10,3.125,40.64
6354,1872,4,1872,786,3,1,25.0,62.5
6355,120,2,120,72,2,0,50.0,80.56
6356,2796,6,2796,424,4,2,100.0,100.0
6357,1858632,174,0,19476,92,82,3.571428571428572,0.0
6358,1296,3,1296,32,3,0,20.0,48.81
6359,192,45,192,26,33,12,3.4482758620689653,15.3
6360,1140,1,1140,660,1,0,33.333333333333336,95.56
6361,216,4,216,90,4,0,100.0,100.0
6362,2212020,457,0,28977,248,209,3.703703703703704,4.98
6363,237888,40,237888,3705,14,26,33.333333333333336,99.04
6364,84,15,84,4,14,1,6.666666666666667,41.28
6365,12420,44,0,3268,32,12,100.0,0.0
6366,359724,1,183180,359724,1,0,20.0,45.45
6367,672,10,672,253,10,0,20.0,97.3
6368,41256,20,41256,774,17,3,10.0,56.08
6369,228,45,36,12,37,8,2.9411764705882355,13.93
6370,1116,0,1116,0,0,0,12.5,0.0
6371,60,3,60,4,3,0,20.0,22.2
6372,109392,270,0,5913,201,69,16.666666666666668,0.0
6373,240,1,240,132,1,0,33.333333333333336,95.56
6374,228,0,228,0,0,0,50.0,90.0
6375,26316,19,26316,1354,18,1,6.666666666666667,76.37
6376,383604,76,0,43046,65,11,3.8461538461538463,0.0
6377,140148,281,0,7301,162,119,50.0,0.0
6378,1484616,108,0,79778,48,60,5.882352941176471,5.0
6379,420,11,0,173,8,3,100.0,100.0
6380,1584,18,1584,341,18,0,9.090909090909092,69.58
6381,828,4,828,636,4,0,9.090909090909092,79.98
6382,12012,40,0,1270,25,15,100.0,0.0
6383,8988,7,8988,188,6,1,16.666666666666668,92.44
6384,1274664,197,0,8675,87,110,7.6923076923076925,2.0
6385,1992,2,1992,276,2,0,25.0,92.74
6386,84,9,84,20,4,5,50.0,81.84
6387,3096,49,0,1399,21,28,25.0,0.0
6388,1454748,109,0,136763,70,39,3.225806451612903,0.0
6389,1960248,411,0,21402,209,202,2.272727272727273,0.0
6390,288,14,288,53,10,4,12.5,67.96
6391,26040,52,26040,1791,44,8,3.0303030303030303,57.65
6392,108,10,108,21,7,3,16.666666666666668,19.97
6393,40968,70,0,1558,55,15,50.0,0.0
6394,900,0,900,0,0,0,50.0,79.0
6395,781044,328,0,23188,172,156,3.703703703703704,0.0
6396,1332,1,1332,192,1,0,50.0,98.24
6397,2308572,1957,0,168597,1121,836,1.0,0.48
6398,263496,244,0,14000,115,129,9.090909090909092,0.0
6399,1680,2,1680,390,1,1,50.0,99.99
6400,3168,29,3168,293,24,5,5.0,0.65
6401,960,2,960,270,2,0,25.0,83.16
6402,429636,12,0,42596,7,5,100.0,100.0
6403,1548,3,1548,316,3,0,25.0,96.44
6404,234324,143,0,24381,91,52,8.333333333333334,0.0
6405,2268,1,2268,96,1,0,50.0,0.0
6406,6000,40,6000,1009,34,6,3.703703703703704,62.06
6407,2376252,12753,446166,336721,7034,5719,1.0,0.0
6408,1620,40,0,550,32,8,100.0,0.0
6409,79968,90,79968,2677,74,16,1.3888888888888888,21.88
6410,10200,40,0,1236,25,15,100.0,0.0
6411,76368,32,76368,1156,29,3,25.0,42.85
6412,180,37,180,58,27,10,4.166666666666667,16.75
6413,48636,47,0,1626,37,10,50.0,0.0
6414,300,22,300,18,22,0,4.3478260869565215,57.58
6415,2216676,72,0,641081,56,16,11.11111111111111,0.0
6416,204,101,120,27,70,31,1.818181818181818,32.38
6417,199644,43,72228,10446,40,3,2.9411764705882355,44.66
6418,33888,51,33888,64,47,4,2.1739130434782608,10.38
6419,15000,27,15000,1326,25,2,5.882352941176471,81.68
6420,10812,76,10812,2984,73,3,1.3333333333333333,20.51
6421,504,25,504,108,21,4,5.555555555555555,40.13
6422,61068,1,61068,0,1,0,33.333333333333336,99.98
6423,953004,2392,0,6251,1781,611,1.0,0.0
6424,3828,39,3828,85,33,6,3.225806451612903,0.0
6425,1452,21,1452,749,19,2,5.555555555555555,74.24
6426,2402040,1334,168300,247814,725,609,1.408450704225352,1.39
6427,84612,655,0,16400,533,122,100.0,0.0
6428,85560,30,0,8530,25,5,50.0,0.0
6429,432,0,432,0,0,0,100.0,100.0
6430,2251380,211,2251380,16178,106,105,5.555555555555555,86.61
6431,57552,54,0,5185,40,14,25.0,0.0
6432,56916,52,0,1827,39,13,50.0,0.0
6433,133692,142,0,2090,66,76,16.666666666666668,0.0
6434,10212,39,0,1278,25,14,100.0,0.0
6435,708,38,708,54,36,2,2.702702702702702,59.29
6436,276,15,276,116,12,3,9.090909090909092,51.92
6437,201768,68,10014,15456,57,11,2.7777777777777777,4.0
6438,19668,22,19668,1318,18,4,6.25,86.57
6439,954348,210,0,26295,111,99,4.761904761904762,0.0
6440,888,6,888,306,6,0,12.5,93.61
6441,2244,14,2244,17,12,2,7.6923076923076925,62.77
6442,2222844,360,0,11151,191,169,2.4390243902439024,0.0
6443,324,22,324,10,18,4,6.25,61.44
6444,2401560,897,0,58162,508,389,1.5151515151515151,2.0
6445,85104,20,85104,1594,17,3,11.11111111111111,57.13
6446,4692,54,0,1067,44,10,25.0,47.22
6447,167664,47,0,15504,39,8,100.0,0.0
6448,197700,19,24168,10940,17,2,5.882352941176471,87.05
6449,1041504,138,1006224,164821,119,19,1.351351351351351,14.87
6450,1548,45,1548,672,43,2,3.8461538461538463,22.26
6451,10212,39,0,1247,24,15,100.0,0.0
6452,20904,52,0,1424,41,11,50.0,0.0
6453,2090664,439,0,19297,234,205,2.3255813953488373,0.0
6454,29388,51,0,1494,39,12,50.0,0.0
6455,14952,47,0,1035,35,12,50.0,0.0
6456,2126664,1966,0,13075,1522,444,1.0,9.0
6457,659520,54,0,59060,45,9,20.0,0.0
6458,2256,12,2256,514,11,1,25.0,99.04
6459,8412,41,0,1176,26,15,100.0,0.0
6460,696,0,696,0,0,0,100.0,100.0
6461,30732,48,30732,2890,37,11,4.166666666666667,58.49
6462,192,3,192,92,3,0,50.0,98.08
6463,2724,17,2724,777,14,3,7.6923076923076925,73.32
6464,24972,52,0,1199,37,15,50.0,0.0
6465,651984,52,0,13521,42,10,33.333333333333336,0.0
6466,11904,47,0,996,39,8,50.0,0.0
6467,5508,47,5508,1301,39,8,3.571428571428572,50.5
6468,708,8,708,285,8,0,100.0,100.0
6469,1464876,54,0,46166,39,15,33.333333333333336,0.0
6470,15912,34,15912,878,32,2,12.5,25.67
6471,1560,1,0,1560,0,1,100.0,0.0
6472,3420,5,3420,1531,3,2,100.0,100.0
6473,2128116,2630,0,126484,1467,1163,1.0,2.08
6474,744,12,744,342,12,0,33.333333333333336,99.74
6475,34188,3,34188,180,3,0,25.0,73.02
6476,792,9,792,256,9,0,50.0,98.55
6477,68664,32,68664,32,30,2,3.225806451612903,53.57
6478,756,4,756,582,2,2,33.333333333333336,98.47
6479,18960,179,852,503,171,8,1.0,27.44
6480,216,6,216,106,5,1,50.0,98.42
6481,1644672,398,0,17128,219,179,2.3255813953488373,0.0
6482,216,16,216,24,9,7,25.0,20.8
6483,1368,14,96,246,11,3,11.11111111111111,72.33
6484,26124,21,3300,4340,17,4,7.142857142857143,59.51
6485,38340,26,38340,525,24,2,4.761904761904762,33.57
6486,4152,41,4152,879,40,1,4.761904761904762,23.49
6487,91992,24,91992,1043,18,6,11.11111111111111,59.74
6488,36,10,36,0,10,0,8.333333333333334,45.24
6489,4488,123,0,1589,94,29,100.0,0.0
6490,1856100,297,0,19717,157,140,2.3255813953488373,5.0
6491,34416,125,0,5056,61,64,11.11111111111111,0.0
6492,984,24,984,451,12,12,50.0,1.6
6493,3528,13,372,514,11,2,25.0,99.18
6494,2088,21,2088,761,17,4,7.6923076923076925,57.96
6495,42060,46,42060,210,40,6,2.7777777777777777,44.36
6496,288,5,288,170,4,1,33.333333333333336,95.28
6497,3324,43,3324,1056,42,1,12.5,25.65
6498,2820,6,2820,610,6,0,20.0,77.13
6499,23280,0,23280,0,0,0,11.11111111111111,0.0
6500,41664,18,41664,532,16,2,6.666666666666667,82.61
6501,168,10,168,26,5,5,50.0,61.47
6502,420,21,420,180,16,5,33.333333333333336,98.53
6503,624,92,624,133,74,18,1.7543859649122806,7.72
6504,2442060,191,0,1018416,4,187,5.2631578947368425,93.95
6505,5520,20,480,895,17,3,7.142857142857143,71.88
6506,1032,126,0,561,66,60,20.0,0.0
6507,300,5,300,168,5,0,14.285714285714286,66.66
6508,5244,17,5244,770,14,3,8.333333333333334,81.47
6509,228,3,228,120,3,0,33.333333333333336,98.31
6510,18180,49,0,1532,33,16,100.0,0.0
6511,60,20,60,18,17,3,6.25,37.17
6512,180,9,180,74,6,3,33.333333333333336,97.97
6513,83676,19,83676,1424,16,3,9.090909090909092,84.69
6514,984,14,984,453,12,2,9.090909090909092,87.77
6515,521748,312,0,11722,180,132,2.857142857142857,3.02
6516,84888,5,84888,691,3,2,25.0,94.78
6517,2317800,2280,0,143761,1188,1092,1.0,0.0
6518,156,0,156,0,0,0,100.0,100.0
6519,45048,57,45048,2361,50,7,14.285714285714286,14.51
6520,69144,63,69144,2559,49,14,4.3478260869565215,35.94
6521,8820,35,8820,1207,28,7,5.2631578947368425,43.77
6522,348,0,348,0,0,0,33.333333333333336,45.63
6523,2568,17,2568,325,15,2,7.142857142857143,47.33
6524,396,0,396,0,0,0,100.0,100.0
6525,10656,20,0,2724,12,8,12.5,0.0
6526,69684,192,0,2318,155,37,100.0,0.0
6527,0,0,0,0,0,0,33.333333333333336,4.75
6528,540,0,540,0,0,0,100.0,100.0
6529,2184,22,2184,255,19,3,5.2631578947368425,52.66
6530,1021176,73,0,14585,54,19,2.380952380952381,3.0
6531,660,74,660,19,48,26,2.702702702702702,12.02
6532,624,4,624,144,2,2,100.0,100.0
6533,92904,23,92904,1209,20,3,5.882352941176471,67.07
6534,5148,65,5148,983,58,7,2.0408163265306123,86.34
6535,1584,43,1584,69,37,6,2.7777777777777777,47.52
6536,3012,0,3012,0,0,0,50.0,51.2
6537,768,45,768,278,40,5,3.225806451612903,44.19
6538,132,2,132,18,1,1,50.0,46.26
6539,9804,16,0,1632,9,7,100.0,0.0
6540,69516,331,0,8188,220,111,100.0,0.0
6541,12372,39,8676,1702,31,8,4.3478260869565215,64.7
6542,514284,28,660,18442,26,2,4.166666666666667,43.95
6543,204,3,204,44,3,0,20.0,73.65
6544,5256,26,5256,306,20,6,6.25,63.26
6545,1032,5,1032,316,5,0,16.666666666666668,77.61
6546,660,4,660,18,2,2,50.0,50.28
6547,162612,251,0,3772,133,118,3.571428571428572,0.0
6548,54432,58,31176,1885,50,8,12.5,14.16
6549,12012,41,0,1288,25,16,100.0,0.0
6550,221796,25,221796,13128,17,8,9.090909090909092,59.62
6551,8016,7,324,1212,6,1,12.5,59.21
6552,384,27,384,164,25,2,14.285714285714286,93.04
6553,162636,112,55956,4655,88,24,1.2987012987012987,19.35
6554,180,5,180,108,5,0,50.0,99.53
6555,960,2,960,366,2,0,7.6923076923076925,0.0
6556,2439168,5585,497816,207935,3138,2447,1.0,0.97
6557,1350600,77,0,72705,60,17,100.0,100.0
6558,144,59,144,22,49,10,2.1739130434782608,39.13
6559,336,6,336,158,6,0,100.0,100.0
6560,1836,0,1836,0,0,0,100.0,100.0
6561,2293848,3525,231756,162725,1960,1565,1.0,0.64
6562,180,2,180,0,2,0,100.0,100.0
6563,216,7,216,138,6,1,33.333333333333336,97.83
6564,135960,0,135960,0,0,0,100.0,100.0
6565,8832,23,8832,745,21,2,5.882352941176471,79.16
6566,324,9,324,177,8,1,50.0,99.07
6567,15084,5,15084,849,5,0,14.285714285714286,57.76
6568,507744,59,87432,33886,29,30,6.25,58.84
6569,15888,7,12996,1008,7,0,12.5,49.76
6570,108,7,108,72,7,0,14.285714285714286,75.76
6571,6480,14,0,563,13,1,50.0,0.0
6572,408,2,408,180,2,0,50.0,97.41
6573,12864,205,0,5480,140,65,100.0,0.0
6574,2296368,601,0,50467,319,282,2.272727272727273,0.0
6575,444,5,444,79,5,0,16.666666666666668,59.64
6576,1248,32,1248,343,27,5,4.166666666666667,71.5
6577,3720,2,3720,0,2,0,25.0,56.21
6578,15564,55,15564,567,39,16,3.0303030303030303,76.87
6579,384,7,384,27,5,2,20.0,45.79
6580,1107792,23,60,48171,19,4,5.555555555555555,35.13
6581,132,20,120,22,19,1,4.761904761904762,29.19
6582,489780,85,0,12374,41,44,25.0,0.0
6583,16032,74,16032,62,54,20,2.127659574468085,42.4
6584,324804,80,324804,1552,35,45,7.142857142857143,86.84
6585,768,41,768,52,41,0,2.3255813953488373,59.59
6586,4044,3,4044,1972,3,0,14.285714285714286,0.0
6587,3792,24,3792,831,21,3,5.555555555555555,68.1
6588,70356,4,70356,183,4,0,20.0,58.19
6589,65592,57,37698,2435,51,6,20.0,13.95
6590,31752,53,0,2313,37,16,50.0,0.0
6591,1685940,97,7932,23037,91,6,1.1235955056179776,28.93
6592,300,1,0,300,1,0,50.0,9.07
6593,31920,49,0,1331,37,12,50.0,0.0
6594,2892,1,2892,876,1,0,100.0,100.0
6595,351852,93,1140,4456,46,47,3.4482758620689653,0.0
6596,2270016,965,0,14134,629,336,1.0,0.0
6597,360,21,360,44,21,0,4.761904761904762,89.58
6598,1422252,6,38820,237766,6,0,12.5,22.07
6599,137748,1453,0,4166,1018,435,1.0,0.0
6600,2450040,2793,0,753883,1358,1435,1.0,0.39
6601,612,42,612,32,34,8,3.125,54.69
6602,56592,11,0,6149,7,4,50.0,0.0
6603,108,3,108,36,2,1,33.333333333333336,56.72
6604,13812,41,0,1321,26,15,100.0,0.0
6605,264792,208,0,2902,116,92,2.5641025641025643,0.0
6606,396,6,396,24,4,2,25.0,58.89
6607,7932,170,0,1335,94,76,100.0,0.0
6608,45480,10,0,6366,6,4,100.0,0.0
6609,1043856,444,0,13224,212,232,2.9411764705882355,0.0
6610,24132,48,24132,738,40,8,3.571428571428572,95.08
6611,14400,20,14400,429,17,3,6.25,85.48
6612,216,6,216,8,4,2,25.0,74.87
6613,26160,13,26160,492,12,1,9.090909090909092,89.64
6614,34200,22,34200,960,17,5,12.5,51.6
6615,996,2,996,0,2,0,16.666666666666668,60.43
6616,1980,2,1680,990,2,0,25.0,51.39
6617,2229156,303,328368,89174,141,162,5.555555555555555,0.0
6618,26868,9,26868,581,8,1,12.5,97.97
6619,6288,5,6288,2700,3,2,10.0,0.0
6620,288,54,288,18,38,16,3.125,45.91
6621,6036,87,6036,68,57,30,2.2222222222222223,14.18
6622,240,0,240,0,0,0,50.0,85.0
6623,6972,58,6972,42,34,24,4.166666666666667,63.85
6624,10608,2,10608,240,2,0,33.333333333333336,78.99
6625,602052,135,0,8242,89,46,5.555555555555555,0.0
6626,318756,44,0,18287,37,7,100.0,0.0
6627,11112,27,11112,1095,24,3,5.0,74.13
6628,2354760,427,0,15873,228,199,1.639344262295082,0.0
6629,2212716,1609,0,110859,722,887,1.020408163265306,0.0
6630,2004,21,2004,548,17,4,8.333333333333334,74.81
6631,8580,6,8580,158,4,2,25.0,84.3
6632,34212,20,34212,1831,16,4,7.6923076923076925,79.77
6633,6288,6,6288,782,6,0,12.5,51.82
6634,266472,33,266472,7213,26,7,5.2631578947368425,24.1
6635,2040,6,2040,1114,5,1,16.666666666666668,89.11
6636,2424,44,0,703,35,9,33.333333333333336,0.0
6637,2415936,1149,0,71233,662,487,1.1111111111111112,2.37
6638,4164,30,4164,881,24,6,5.555555555555555,75.63
6639,2487564,153,2217220,1043732,80,73,1.0,6.23
6640,6924,21,6924,551,18,3,5.882352941176471,86.41
6641,816480,284,0,9500,192,92,50.0,0.0
6642,37764,19,37764,962,15,4,10.0,51.77
6643,99996,265,0,4717,129,136,7.142857142857143,0.0
6644,4224,23,4224,453,19,4,5.882352941176471,86.84
6645,5292,133,5292,884,115,18,1.2658227848101269,30.81
6646,890676,150,343642,157872,148,2,2.083333333333333,94.16
6647,2230380,54,3600,189007,41,13,9.090909090909092,20.0
6648,11892,21,11892,3462,17,4,7.6923076923076925,53.7
6649,16548,25,2988,3531,16,9,12.5,49.65
6650,2251308,220,0,516832,106,114,9.090909090909092,0.0
6651,331488,458,0,5722,241,217,2.857142857142857,0.0
6652,5820,39,5820,319,13,26,50.0,88.59
6653,20256,43,0,1605,28,15,100.0,0.0
6654,1177092,653,0,22892,378,275,1.5151515151515151,1.99
6655,72,4,72,18,4,0,16.666666666666668,55.36
6656,318876,127,0,3616,59,68,4.545454545454546,5.0
6657,1125072,91,0,14965,33,58,25.0,0.0
6658,2163780,703,0,24852,405,298,1.5625,2.36
6659,19428,28,0,1334,23,5,100.0,0.0
6660,56148,44,0,1891,33,11,50.0,0.0
6661,11724,58,11724,64,44,14,2.5641025641025643,49.68
6662,56472,49,0,1924,36,13,50.0,0.0
6663,1008,15,1008,19,11,4,11.11111111111111,48.44
6664,29292,48,29292,1235,18,30,20.0,96.15
6665,516,3,516,36,3,0,20.0,42.6
6666,2217060,1376,0,150089,760,616,1.1904761904761905,1.47
6667,84612,73,0,8186,62,11,33.333333333333336,0.0
6668,29556,80,29556,1104,28,52,33.333333333333336,99.09
6669,2952,70,2952,24,52,18,2.2222222222222223,10.2
6670,468,32,468,19,31,1,5.882352941176471,63.63
6671,10860,266,0,1574,141,125,3.8461538461538463,1.0
6672,240,1,0,240,0,1,100.0,0.0
6673,1814244,355,0,34760,186,169,2.631578947368421,0.0
6674,560652,64,0,8844,46,18,33.333333333333336,0.0
6675,10608,22,10488,2302,19,3,7.6923076923076925,54.64
6676,474540,1504,0,3730,1132,372,1.0,0.0
6677,2340132,307,0,43528,164,143,2.7777777777777777,0.0
6678,3840,54,0,1188,35,19,12.5,0.0
6679,485676,23,485676,8,19,4,5.2631578947368425,40.5
6680,13728,18,13728,356,15,3,7.142857142857143,89.61
6681,432,18,432,16,17,1,5.555555555555555,61.78
6682,1505280,1302,0,17291,739,563,1.7241379310344829,0.0
6683,1200,48,1200,567,38,10,3.333333333333333,57.27
6684,1920132,1369,0,28634,808,561,1.2820512820512822,0.97
6685,2116884,59,2116884,558496,31,28,6.25,71.16
6686,1368,2,0,702,1,1,33.333333333333336,30.0
6687,49848,27,49848,934,23,4,5.0,48.0
6688,16080,20,16080,586,18,2,5.882352941176471,85.45
6689,12012,40,0,1309,25,15,100.0,0.0
6690,201132,29,201132,20176,25,4,4.761904761904762,39.47
6691,88728,4,88728,3192,2,2,50.0,99.96
6692,2289444,475,0,85044,245,230,3.4482758620689653,7.0
6693,0,0,0,0,0,0,33.333333333333336,0.0
6694,2499132,2500,139452,514119,1416,1084,1.0,0.0
6695,1224,8,1224,1041,8,0,11.11111111111111,55.97
6696,5460,6,0,2518,4,2,100.0,0.0
6697,7728,12,7728,560,11,1,12.5,78.25
6698,15108,195,0,2026,122,73,100.0,0.0
6699,528,8,528,114,4,4,12.5,0.0
6700,22536,43,0,2328,32,11,100.0,0.0
6701,2491296,936,0,375539,542,394,1.0,0.0
6702,8928,34,8928,1626,29,5,4.545454545454546,60.35
6703,30612,39,30612,1714,38,1,6.25,29.68
6704,8304,188,0,2699,142,46,50.0,0.0
6705,2517060,51402,659642,742054,29109,22293,1.0,0.26
6706,12492,30,0,1572,25,5,100.0,0.0
6707,2300580,350,0,99035,218,132,5.2631578947368425,0.0
6708,12012,44,0,1265,29,15,100.0,0.0
6709,1104,18,1104,208,18,0,5.882352941176471,81.22
6710,2304,60,0,611,43,17,100.0,0.0
6711,2461692,499,0,275585,273,226,1.851851851851852,0.0
6712,4308,4,4308,2100,2,2,100.0,100.0
6713,1983612,936,0,18340,524,412,1.5873015873015872,0.0
6714,2135352,119,1420974,193905,95,24,1.6666666666666667,20.98
6715,108,0,108,0,0,0,1.0,0.0
6716,192,1,192,0,1,0,33.333333333333336,84.17
6717,9816,4,9816,9474,2,2,100.0,100.0
6718,53436,10,53436,232,10,0,100.0,100.0
6719,108,0,108,0,0,0,100.0,0.0
6720,5592,43,5592,1068,34,9,4.3478260869565215,63.3
6721,2046696,88,0,24285,65,23,50.0,0.0
6722,441612,745,0,7236,441,304,1.639344262295082,0.0
6723,4536,60,4536,45,56,4,1.7857142857142858,37.98
6724,69768,56,69768,1674,45,11,2.9411764705882355,23.4
6725,96,55,96,40,31,24,5.2631578947368425,57.2
6726,1068,0,1068,0,0,0,100.0,100.0
6727,59592,4,59592,5499,2,2,50.0,63.66
6728,50400,36,50400,2692,30,6,6.25,48.46
6729,4044,31,4044,1004,26,5,5.2631578947368425,60.86
6730,46452,36,46452,1977,30,6,4.761904761904762,53.74
6731,83160,51,0,28707,42,9,3.0303030303030303,0.0
6732,224712,7,224712,169,7,0,11.11111111111111,60.87
6733,120,4,120,21,4,0,16.666666666666668,79.63
6734,179712,85,179712,5287,77,8,1.3157894736842106,27.4
6735,0,0,0,0,0,0,50.0,90.0
6736,12000,47,0,1339,32,15,100.0,0.0
6737,36240,39,36240,17,33,6,3.125,13.87
6738,936,1,936,0,1,0,33.333333333333336,65.34
6739,5628,45,5628,973,42,3,10.0,46.21
6740,4680,41,4680,1219,32,9,4.761904761904762,60.98
6741,73116,40,67590,2399,37,3,14.285714285714286,16.85
6742,702996,53,0,49776,44,9,33.333333333333336,0.0
6743,1933656,2044,0,99085,1125,919,1.0,0.69
6744,62844,52,0,2121,40,12,50.0,0.0
6745,46404,24,46404,876,19,5,8.333333333333334,47.81
6746,672,0,672,0,0,0,50.0,64.0
6747,21864,107,0,1028,68,39,2.380952380952381,0.0
6748,38784,47,0,1688,37,10,50.0,0.0
6749,39192,52,0,1377,40,12,50.0,0.0
6750,48048,259,0,9919,177,82,100.0,0.0
6751,1711548,737,0,22414,395,342,1.3888888888888888,0.0
6752,2385516,776,236556,1279461,493,283,1.0,0.0
6753,505236,84,0,6777,61,23,2.3255813953488373,3.0
6754,52704,26,52704,1434,23,3,5.0,88.49
6755,3948,102,3948,3350,100,2,1.0,8.08
6756,648,4,648,222,4,0,16.666666666666668,44.4
6757,420,11,420,1,11,0,7.6923076923076925,43.21
6758,58752,6,58752,1138,6,0,12.5,73.06
6759,9432,55,9432,1424,43,12,4.545454545454546,60.05
6760,372,2,372,60,1,1,50.0,65.3
6761,3864,0,3864,0,0,0,50.0,98.5
6762,170208,631,0,3073,400,231,2.857142857142857,0.08
6763,7548,14,7548,534,12,2,10.0,85.83
6764,1647216,55,727620,200967,44,11,3.571428571428572,30.21
6765,411612,62,411612,18545,53,9,2.0,34.18
6766,12012,46,0,1268,31,15,100.0,0.0
6767,1788,0,1788,0,0,0,50.0,62.41
6768,63012,33,63012,2794,33,0,3.4482758620689653,52.18
6769,60,2,0,42,1,1,50.0,0.0
6770,2319216,993,0,6289,663,330,1.0,0.0
6771,95724,5,95724,32558,5,0,16.666666666666668,90.28
6772,1140,28,1140,1047,18,10,6.666666666666667,72.32
6773,13272,47,13272,1746,41,6,12.5,23.51
6774,660,16,660,307,15,1,25.0,98.59
6775,79896,209,0,2529,140,69,100.0,0.0
6776,105180,239,0,3098,132,107,2.272727272727273,0.0
6777,314376,887,0,1663,565,322,1.0,10.0
6778,2239920,275,0,50856,141,134,2.0,2.0
6779,240,0,240,0,0,0,100.0,94.12
6780,2856,7,0,1338,7,0,50.0,0.0
6781,180,0,180,0,0,0,50.0,59.29
6782,1548,1,924,1548,0,1,100.0,100.0
6783,216,6,216,104,6,0,50.0,99.33
6784,2524872,1165,0,1152159,751,414,100.0,100.0
6785,264,0,264,0,0,0,100.0,100.0
6786,453636,659,0,5510,461,198,1.0,10.0
6787,260916,6,260916,1016,6,0,12.5,31.46
6788,900,5,900,43,3,2,25.0,44.64
6789,1080,8,1080,271,8,0,20.0,54.37
6790,3324,7,3324,474,7,0,11.11111111111111,65.53
6791,608604,3,0,520712,3,0,20.0,93.0
6792,2548080,849,0,182505,476,373,1.1494252873563218,0.0
6793,396,6,396,170,6,0,50.0,57.39
6794,53508,56,28806,1923,48,8,9.090909090909092,17.76
6795,2427252,901,0,37136,465,436,1.0,0.0
6796,65232,33,65232,3242,33,0,14.285714285714286,94.64
6797,372,5,372,192,4,1,33.333333333333336,54.01
6798,1004196,747,0,13766,498,249,1.0,0.0
6799,2276472,1501,0,88503,773,728,1.0,0.0
6800,204,136,180,72,102,34,1.2658227848101269,32.82
6801,2511660,652,1151280,432628,398,254,1.0,0.87
6802,504,68,504,53,54,14,2.0408163265306123,54.4
6803,39900,39,0,3796,30,9,100.0,0.0
6804,372,0,372,0,0,0,50.0,81.0
6805,1520256,343,0,6500,177,166,2.9411764705882355,1.98
6806,1413348,9,1413348,1926,7,2,20.0,49.5
6807,40728,74,0,1958,47,27,100.0,0.0
6808,2196684,263,0,129510,126,137,2.083333333333333,0.0
6809,12000,39,0,1293,24,15,100.0,0.0
6810,1068852,673,0,3086,408,265,1.0,0.0
6811,156,15,156,28,12,3,10.0,66.9
6812,2940,9,2940,750,7,2,14.285714285714286,79.6
6813,528,41,528,253,41,0,2.5641025641025643,80.31
6814,2528268,1587,1256472,396102,925,662,1.0,0.0
6815,9132,41,0,1193,32,9,100.0,0.0
6816,157572,27,0,7102,23,4,100.0,0.0
6817,66972,7,36486,293,7,0,12.5,70.35
6818,2023680,812,0,23378,466,346,1.4492753623188406,0.0
6819,19392,19,19392,845,18,1,6.25,80.4
6820,90012,972,0,1597,648,324,1.0,0.0
6821,948,2,948,24,1,1,50.0,71.78
6822,56844,113,0,11120,48,65,6.666666666666667,0.0
6823,23064,61,0,981,36,25,4.166666666666667,0.0
6824,2368680,1053,0,8106,586,467,1.0,0.0
6825,684,3,684,176,3,0,20.0,95.97
6826,324624,1,324624,420,1,0,100.0,100.0
6827,2413776,2152,55956,127255,1206,946,1.2820512820512822,0.0
6828,14700,6,0,4864,4,2,100.0,0.0
6829,993912,3,993912,163276,1,2,50.0,77.44
6830,181452,95,97944,8106,76,19,1.3333333333333333,13.34
6831,0,0,0,0,0,0,50.0,99.97
6832,243480,37,0,9539,33,4,50.0,0.0
6833,1038192,2,1038192,16824,2,0,20.0,93.94
6834,156,1,156,0,1,0,33.333333333333336,62.4
6835,2387568,1324,0,451504,581,743,1.0,0.0
6836,327300,2,327300,252,2,0,25.0,88.82
6837,47184,32,0,3446,28,4,100.0,0.0
6838,456,3,456,132,2,1,25.0,51.02
6839,79932,34,79932,24399,27,7,7.6923076923076925,61.78
6840,72,13,72,24,7,6,33.333333333333336,56.12
6841,5868,89,0,977,54,35,100.0,0.0
6842,5952,75,0,1024,53,22,2.5641025641025643,3.0
6843,17328,14,17328,17276,10,4,10.0,65.24
6844,3348,4,0,1545,2,2,100.0,0.0
6845,6732,24,6732,594,20,4,5.882352941176471,84.53
6846,2413092,1029,0,185648,556,473,1.4492753623188406,0.04
6847,19944,2,19944,17748,1,1,100.0,100.0
6848,7464,1,7464,2496,1,0,14.285714285714286,57.92
6849,10200,48,0,1172,32,16,100.0,0.0
6850,1210368,5,168,726259,4,1,25.0,57.85
6851,1177596,74,0,163589,48,26,7.6923076923076925,0.0
6852,35196,50,0,1462,36,14,50.0,0.0
6853,1920,60,0,659,45,15,100.0,0.0
6854,28872,9,28872,606,8,1,16.666666666666668,83.62
6855,400392,189,0,22186,145,44,50.0,0.0
6856,36372,49,0,1349,36,13,50.0,0.0
6857,37500,51,0,1364,37,14,50.0,0.0
6858,2364,23,2364,736,19,4,25.0,99.23
6859,1457748,1315,0,4383,964,351,1.0,0.0
6860,504,27,0,141,23,4,100.0,0.0
6861,38700,47,0,2407,37,10,50.0,0.0
6862,170232,55,0,16342,46,9,100.0,0.0
6863,205428,25,205428,201139,25,0,12.5,99.87
6864,744,5,744,223,4,1,20.0,28.16
6865,686052,58,686052,166,53,5,1.96078431372549,29.49
6866,336,21,336,68,13,8,10.0,52.87
6867,74988,9,74988,785,9,0,11.11111111111111,73.49
6868,2448,8,2448,172,5,3,20.0,94.73
6869,130872,3,130872,27400,2,1,33.333333333333336,76.31
6870,2856,4,0,1155,2,2,100.0,0.0
6871,51684,2,6912,25938,2,0,100.0,100.0
6872,696,1,0,696,1,0,100.0,0.0
6873,2506680,283,0,40506,157,126,3.571428571428572,0.0
6874,497892,2,242664,274662,0,2,50.0,0.0
6875,12012,47,0,1216,31,16,100.0,0.0
6876,2056656,1353,0,19479,763,590,1.0638297872340423,0.0
6877,396,28,396,170,16,12,20.0,96.03
6878,91008,22,91008,2143,21,1,5.2631578947368425,52.45
6879,29484,12,29484,3674,4,8,50.0,99.86
6880,83748,81,5352,4215,66,15,100.0,0.0
6881,420,1,420,0,1,0,33.333333333333336,70.25
6882,5160,106,5160,4586,101,5,1.0,29.3
6883,20028,53,20028,4611,41,12,2.4390243902439024,18.9
6884,79596,33,79596,53,17,16,12.5,61.58
6885,397452,78,397452,117073,68,10,1.7857142857142858,14.35
6886,1728,5,1728,288,2,3,100.0,100.0
6887,265560,29,0,11457,26,3,50.0,0.0
6888,7236,3,0,3284,2,1,50.0,90.0
6889,1128000,1800,0,5796,1318,482,1.0,30.0
6890,389328,1,389328,96,1,0,33.333333333333336,96.72
6891,645984,87,0,90781,70,17,20.0,0.0
6892,1772652,109,3000,28574,52,57,5.882352941176471,3.77
6893,11484,19,11484,1294,12,7,9.090909090909092,0.0
6894,88068,0,88068,0,0,0,12.5,0.0
6895,804,0,804,0,0,0,100.0,100.0
6896,10968,23,10968,428,19,4,5.882352941176471,86.46
6897,1473528,5,1473528,2109,5,0,50.0,90.99
6898,540,3,540,424,1,2,33.333333333333336,67.94
6899,306132,59,306132,226798,52,7,2.857142857142857,95.8
6900,2487240,1146,0,544801,500,646,1.0,1.86
6901,852000,3,155712,27304,2,1,25.0,47.65
6902,15456,19,15456,466,17,2,5.882352941176471,89.97
6903,1044,2,1044,660,0,2,50.0,98.04
6904,636,0,636,0,0,0,50.0,96.0
6905,406488,68,375540,116213,62,6,2.083333333333333,15.64
6906,2507196,38,0,73648,30,8,50.0,0.0
6907,12012,40,0,1404,27,13,100.0,0.0
6908,2111628,55,0,711502,55,0,2.857142857142857,52.5
6909,40404,55,0,3963,43,12,100.0,0.0
6910,2064,47,2064,881,44,3,6.666666666666667,34.59
6911,2379228,2291,31218,60710,1258,1033,1.0,0.0
6912,324,3,324,24,2,1,33.333333333333336,22.66
6913,12120,42,0,2250,36,6,100.0,0.0
6914,2073816,1437,0,9875,1027,410,1.0,0.0
6915,11604,13,924,1175,10,3,100.0,0.0
6916,57816,44,57816,2207,37,7,3.8461538461538463,58.58
6917,1478604,223,0,38838,123,100,4.3478260869565215,0.0
6918,15588,8,15588,3193,4,4,50.0,99.99
6919,2436,61,0,888,49,12,100.0,0.0
6920,7584,13,5196,2554,7,6,1.0,0.0
6921,1416,2,1416,462,1,1,50.0,65.61
6922,12144,54,0,1917,37,17,100.0,0.0
6923,7272,123,0,713,62,61,3.4482758620689653,0.0
6924,316164,116,0,3926,84,32,25.0,0.0
6925,9276,39,9276,1582,33,6,4.545454545454546,52.03
6926,23028,27,0,3228,25,2,50.0,0.0
6927,18648,5,18648,6712,5,0,16.666666666666668,62.32
6928,35028,253,0,2147,142,111,100.0,0.0
6929,40680,1,40680,120,1,0,100.0,100.0
6930,56892,13,56892,282,13,0,33.333333333333336,56.81
6931,360,2,360,162,2,0,33.333333333333336,95.08
6932,276,6,276,202,6,0,14.285714285714286,74.23
6933,192,31,192,43,19,12,11.11111111111111,76.32
6934,444,9,444,305,8,1,12.5,76.29
6935,168,6,168,80,6,0,14.285714285714286,74.23
6936,288,6,288,190,6,0,14.285714285714286,74.23
6937,2612040,1207,0,146290,686,521,1.1904761904761905,0.0
6938,948,6,948,166,6,0,14.285714285714286,74.23
6939,63684,62,62004,2529,49,13,2.7777777777777777,17.94
6940,516,3,516,388,3,0,20.0,93.58
6941,38928,46,0,1609,34,12,50.0,0.0
6942,3168,11,3168,1970,11,0,50.0,58.08
6943,3132,8,3132,247,7,1,14.285714285714286,74.46
6944,14988,44,14988,992,43,1,8.333333333333334,30.52
6945,39252,49,0,1486,35,14,50.0,0.0
6946,4380,35,4380,1144,29,6,4.545454545454546,66.47
6947,5748,6,5748,310,6,0,14.285714285714286,74.42
6948,3960,11,3960,834,9,2,20.0,59.53
6949,1080,18,864,470,13,5,11.11111111111111,81.18
6950,1248,4,1248,198,4,0,33.333333333333336,76.51
6951,312,6,312,158,5,1,33.333333333333336,74.8
6952,7584,309,0,2635,166,143,1.9230769230769231,0.0
6953,10092,43,0,1208,28,15,100.0,0.0
6954,432,10,432,199,9,1,25.0,61.8
6955,3672,36,3672,912,27,9,5.0,41.38
6956,480,6,480,200,6,0,50.0,77.44
6957,51852,55,51852,1582,50,5,2.083333333333333,28.16
6958,3936,42,3936,762,41,1,12.5,40.25
6959,528,7,528,92,7,0,14.285714285714286,54.67
6960,240,39,240,59,31,8,3.4482758620689653,68.81
6961,39396,22,39396,758,18,4,6.666666666666667,42.53
6962,348,4,348,168,4,0,50.0,76.1
6963,124836,90,124836,7660,67,23,2.9411764705882355,12.37
6964,115536,20,115536,1,20,0,4.545454545454546,38.39
6965,17292,81,17292,1541,63,18,2.0408163265306123,53.24
6966,45204,70,0,1695,53,17,50.0,0.0
6967,1060800,160,0,28336,75,85,4.761904761904762,0.0
6968,9372,136,0,2082,89,47,100.0,0.0
6969,876,67,876,32,47,20,2.5641025641025643,0.0
6970,45720,50,0,1780,37,13,50.0,0.0
6971,53772,197,0,2603,134,63,1.5151515151515151,3.0
6972,87012,281,0,9916,200,81,100.0,0.0
6973,1452,0,1452,0,0,0,50.0,96.1
6974,43128,24,24078,1374,21,3,5.0,35.0
6975,1485864,1389,0,22923,781,608,1.0309278350515465,0.0
6976,3984,14,3984,879,13,1,7.6923076923076925,84.62
6977,1048632,307,0,9837,178,129,2.127659574468085,0.0
6978,2070840,188,2070840,200747,83,105,1.9230769230769231,59.76
6979,1642584,23,429276,122388,23,0,5.2631578947368425,43.23
6980,54348,36,54348,1480,30,6,5.2631578947368425,76.89
6981,10200,43,0,1333,27,16,100.0,0.0
6982,1564656,59,1411374,111633,49,10,2.702702702702702,14.83
6983,6744,76,0,1398,67,9,2.2222222222222223,12.0
6984,49428,0,49428,0,0,0,50.0,99.0
6985,8280,14,8280,354,13,1,25.0,72.92
6986,76644,12,76644,2451,12,0,8.333333333333334,20.24
6987,324,5,324,91,5,0,14.285714285714286,79.1
6988,2631048,3166,0,94098,1731,1435,1.0,0.0
6989,75720,276,0,2778,185,91,100.0,0.0
6990,4812,30,4812,1204,25,5,5.555555555555555,76.69
6991,2076060,29,0,100838,13,16,16.666666666666668,0.0
6992,1212,106,1212,85,92,14,1.1494252873563218,36.08
6993,1023000,581,0,3565,427,154,1.0,0.0
6994,15072,32,9906,1785,32,0,3.125,25.51
6995,522408,25,522408,31608,10,15,3.333333333333333,54.5
6996,276,67,276,61,35,32,4.761904761904762,18.65
6997,2112,37,2112,328,37,0,2.5641025641025643,39.12
6998,2079816,240,2079816,20877,154,86,1.96078431372549,71.34
6999,10932,16,10932,96,12,4,10.0,47.46
7000,1947444,291,0,28501,153,138,2.272727272727273,0.0
7001,78168,24,78168,6428,12,12,12.5,90.39
7002,1872,0,1872,0,0,0,50.0,64.0
7003,245940,12,108,20563,8,4,14.285714285714286,50.62
7004,972,6,972,462,6,0,14.285714285714286,64.06
7005,2499972,70,0,217988,20,50,1.0,9.93
7006,5400,210,0,1745,117,93,100.0,0.0
7007,168,15,168,8,15,0,5.882352941176471,50.36
7008,1360836,2,1360836,341568,2,0,25.0,96.48
7009,0,0,0,0,0,0,33.333333333333336,2.0
7010,1153092,1007,0,7703,617,390,1.0,0.0
7011,120,51,120,31,39,12,2.857142857142857,33.1
7012,1320,29,1320,236,20,9,6.25,37.1
7013,2388,30,2388,2236,22,8,5.555555555555555,81.9
7014,204,0,204,0,0,0,100.0,100.0
7015,2432976,1434,0,260071,806,628,1.408450704225352,0.0
7016,0,0,0,0,0,0,100.0,0.0
7017,0,0,0,0,0,0,50.0,50.0
7018,16164,44,16164,24,28,16,4.545454545454546,63.57
7019,4416,80,4416,3860,76,4,1.2987012987012987,20.44
7020,732108,134,0,119362,60,74,7.142857142857143,4.16
7021,108528,26,108528,2998,21,5,6.666666666666667,60.17
7022,120,1,120,0,1,0,33.333333333333336,22.5
7023,132,44,132,58,30,14,4.0,45.93
7024,43896,15,43896,1997,15,0,10.0,76.81
7025,2635176,4370,0,1028967,2482,1888,1.0,0.0
7026,1872,1,0,1872,0,1,100.0,0.0
7027,2617092,527,0,799042,303,224,1.5151515151515151,0.0
7028,2354400,985,0,17283,540,445,1.4705882352941178,0.0
7029,1824,18,1824,1434,18,0,4.545454545454546,60.03
7030,223812,173,0,2923,79,94,5.882352941176471,0.0
7031,1692,0,1692,0,0,0,50.0,92.8
7032,900564,2,42576,1656,2,0,20.0,60.11
7033,17352,84,0,4101,64,20,100.0,0.0
7034,60,23,60,27,13,10,9.090909090909092,37.07
7035,2612088,3962,0,604509,2231,1731,1.0,0.0
7036,3576,95,0,1090,60,35,100.0,0.0
7037,1344,10,1344,198,9,1,100.0,100.0
7038,42768,46,0,3754,35,11,100.0,0.0
7039,3096,0,3096,0,0,0,12.5,0.0
7040,63516,100,63516,1598,81,19,1.2820512820512822,15.76
7041,1270776,37,0,191534,19,18,20.0,0.0
7042,15612,40,0,1436,25,15,100.0,0.0
7043,588,11,588,109,10,1,12.5,52.37
7044,56688,16,54568,16937,7,9,16.666666666666668,86.81
7045,1643472,2257,0,7539,1561,696,1.0,0.0
7046,1741716,62,0,77188,26,36,7.6923076923076925,12.5
7047,1620,12,1620,776,11,1,50.0,75.03
7048,1248,1,1248,636,1,0,12.5,0.0
7049,2460,11,996,889,6,5,100.0,0.0
7050,4212,6,4212,486,4,2,20.0,78.62
7051,2354280,577,0,47235,313,264,1.1904761904761905,2.62
7052,21312,2,21312,1530,2,0,33.333333333333336,98.05
7053,1341072,625,0,16585,303,322,1.25,0.0
7054,2316540,262,0,27705,124,138,4.3478260869565215,8.9
7055,106092,44,21744,3730,35,9,4.0,73.88
7056,1310676,187,911416,354510,187,0,1.3157894736842106,79.04
7057,11100,28,11100,10,22,6,5.555555555555555,40.97
7058,88812,33,0,8565,28,5,100.0,0.0
7059,16860,53,16860,2760,46,7,16.666666666666668,14.98
7060,8976,299,0,2258,176,123,100.0,0.0
7061,1944,12,1944,609,8,4,25.0,82.05
7062,15552,11,15552,3177,10,1,12.5,87.58
7063,77556,345,49428,6508,255,90,1.2345679012345678,13.05
7064,300,3,300,88,3,0,20.0,94.65
7065,77940,1,0,77940,0,1,33.333333333333336,89.6
7066,8232,20,8232,838,19,1,7.6923076923076925,65.36
7067,324,16,324,107,10,6,11.11111111111111,43.72
7068,10224,48,0,1328,32,16,100.0,0.0
7069,2276904,2843,0,153449,1243,1600,1.0,0.0
7070,27396,24,27396,1126,21,3,7.142857142857143,78.05
7071,125820,24,125820,17782,19,5,7.142857142857143,75.06
7072,77928,7,0,11266,5,2,33.333333333333336,0.09
7073,17316,6,17316,17184,6,0,11.11111111111111,58.74
7074,2657244,2173,0,1049290,1239,934,1.0,0.0
7075,94428,4,0,24258,2,2,50.0,0.0
7076,254100,4,4488,63903,4,0,25.0,98.51
7077,64788,61,64788,3140,47,14,2.083333333333333,11.6
7078,2629512,2037,0,42973,1122,915,1.0,0.0
7079,34752,52,0,1859,43,9,50.0,0.0
7080,11640,30,11640,797,26,4,4.761904761904762,75.5
7081,1860,44,0,643,36,8,100.0,0.0
7082,504,12,504,55,7,5,20.0,51.98
7083,33252,177,0,1626,115,62,2.083333333333333,2.0
7084,36084,43,0,1521,33,10,50.0,0.0
7085,1284,2,1284,234,1,1,33.333333333333336,94.33
7086,6636,81,6636,5874,77,4,1.2658227848101269,21.99
7087,59268,32,0,5270,27,5,100.0,0.0
7088,37644,50,0,1373,37,13,50.0,0.0
7089,203088,27,27384,7916,21,6,6.25,85.35
7090,8412,180,0,1882,107,73,100.0,0.0
7091,1017972,69,632880,257894,29,40,14.285714285714286,0.0
7092,1152,3,1152,768,2,1,50.0,99.84
7093,339996,33,0,17552,27,6,50.0,0.0
7094,38880,51,0,1915,37,14,50.0,0.0
7095,768,15,768,674,9,6,12.5,76.2
7096,2379084,5385,0,84088,3088,2297,1.0,0.0
7097,340932,44,0,10291,38,6,50.0,0.0
7098,360,25,360,122,15,10,11.11111111111111,46.51
7099,109764,2,109764,13950,2,0,33.333333333333336,99.51
7100,180,7,180,30,4,3,33.333333333333336,22.55
7101,44196,210,0,4696,155,55,50.0,0.0
7102,0,0,0,0,0,0,50.0,95.0
7103,213336,14,213336,426,12,2,8.333333333333334,74.18
7104,12024,41,0,1252,26,15,100.0,0.0
7105,143328,57,7548,5194,53,4,9.090909090909092,44.94
7106,189396,14,612,14541,8,6,20.0,59.45
7107,50496,21,50496,6206,19,2,11.11111111111111,30.56
7108,42660,70,42660,1292,57,13,1.7543859649122806,45.1
7109,4476,36,108,147,26,10,5.2631578947368425,52.49
7110,180,0,180,0,0,0,50.0,60.1
7111,16128,19,16128,1440,17,2,10.0,77.45
7112,444,11,444,128,10,1,10.0,88.04
7113,204,1,204,72,1,0,33.333333333333336,78.4
7114,7728,31,7728,542,31,0,12.5,23.98
7115,72,4,72,12,4,0,16.666666666666668,57.92
7116,972924,50,972924,812202,45,5,3.0303030303030303,86.05
7117,74100,64,0,5457,56,8,100.0,0.0
7118,1085592,2361,0,8373,1772,589,1.0,0.0
7119,8076,39,0,1194,24,15,100.0,0.0
7120,881784,31,0,97182,24,7,25.0,0.0
7121,23148,61,23148,3955,52,9,20.0,15.95
7122,65340,26,0,6871,21,5,50.0,0.0
7123,12816,21,12816,520,18,3,5.882352941176471,88.82
7124,2670312,2660,527820,950369,1996,664,1.0,0.0
7125,30588,43,0,3295,34,9,100.0,0.0
7126,144,1,144,12,1,0,33.333333333333336,38.12
7127,20412,23,15900,1605,18,5,6.25,88.41
7128,624,13,624,476,13,0,6.666666666666667,74.23
7129,8772,47,0,1173,32,15,100.0,0.0
7130,2258184,1694,0,40731,932,762,1.0869565217391304,0.0
7131,416652,250,0,7814,123,127,3.703703703703704,0.0
7132,1230396,58,0,1134415,52,6,100.0,100.0
7133,1512264,341,0,12095,174,167,2.272727272727273,0.0
7134,4224,19,4224,672,16,3,7.6923076923076925,69.08
7135,33108,14,33108,180,11,3,10.0,80.47
7136,43524,35,43524,7971,33,2,33.333333333333336,75.19
7137,480,12,480,300,12,0,16.666666666666668,59.83
7138,3288,76,0,400,47,29,3.125,0.0
7139,49380,27,2436,8176,23,4,33.333333333333336,0.0
7140,2196,45,0,767,37,8,100.0,0.0
7141,2672352,3978,33492,170360,2187,1791,1.0,0.41
7142,29484,182,0,2338,111,71,100.0,0.0
7143,1200,7,1200,975,7,0,16.666666666666668,57.52
7144,8712,42,0,1162,27,15,100.0,0.0
7145,1284,37,1284,605,34,3,14.285714285714286,68.58
7146,420,112,216,70,62,50,2.702702702702702,61.71
7147,6372,42,6372,917,33,9,4.545454545454546,51.45
7148,4584,124,0,1601,92,32,100.0,0.0
7149,3000,17,3000,1712,17,0,12.5,69.63
7150,0,0,0,0,0,0,100.0,0.0
7151,468,8,468,133,8,0,16.666666666666668,55.92
7152,14676,43,0,2155,33,10,100.0,0.0
7153,1758372,1298,0,17381,738,560,1.2345679012345678,0.0
7154,3720,23,3720,910,19,4,6.666666666666667,60.74
7155,8412,11,0,1161,7,4,50.0,0.0
7156,852,18,852,326,17,1,20.0,68.68
7157,418776,26,418776,8617,21,5,5.2631578947368425,28.96
7158,528,9,528,106,9,0,14.285714285714286,53.74
7159,37284,56,0,1613,40,16,50.0,0.0
7160,37680,49,0,1543,39,10,50.0,0.0
7161,38064,48,0,1997,37,11,50.0,0.0
7162,38400,47,0,1549,37,10,50.0,0.0
7163,516396,16,516396,407,10,6,11.11111111111111,80.41
7164,123072,14,0,36189,12,2,100.0,0.0
7165,264,5,264,33,5,0,14.285714285714286,80.36
7166,80484,20,80484,0,20,0,4.545454545454546,46.33
7167,221544,44,0,7708,38,6,50.0,0.0
7168,255984,8,255984,817,6,2,12.5,82.59
7169,255276,13,130470,2082,6,7,33.333333333333336,0.03
7170,3312,26,3312,985,26,0,33.333333333333336,8.97
7171,82032,44,82032,3672,42,2,2.3255813953488373,0.0
7172,5388,62,5388,1628,49,13,3.333333333333333,57.08
7173,261708,199,972,1933,196,3,1.0,43.18
7174,1559964,1062,0,14587,591,471,1.351351351351351,0.0
7175,3780,36,3780,1611,35,1,8.333333333333334,25.87
7176,12276,134,0,1114,71,63,2.702702702702702,0.0
7177,12012,43,0,1334,28,15,100.0,0.0
7178,8652,106,0,951,67,39,100.0,0.0
7179,84,12,84,0,12,0,7.142857142857143,48.19
7180,2064,14,2064,431,14,0,20.0,9.06
7181,2700,2,2700,786,1,1,50.0,93.46
7182,2278044,1038,0,160990,560,478,1.5625,0.0
7183,3060,23,3060,568,19,4,7.142857142857143,59.09
7184,612,8,612,127,6,2,14.285714285714286,20.94
7185,69096,34,69096,1518,27,7,5.555555555555555,51.67
7186,1944,38,1944,75,38,0,2.5,15.97
7187,1296,21,1296,453,21,0,20.0,37.56
7188,34212,18,34212,1690,15,3,6.666666666666667,42.43
7189,87132,66,87132,2525,58,8,1.7857142857142858,25.54
7190,53868,21,53868,731,17,4,8.333333333333334,81.63
7191,5784,51,5784,726,48,3,3.225806451612903,36.59
7192,612,32,492,115,32,0,3.125,80.1
7193,7260,44,7260,1668,40,4,10.0,68.62
7194,132732,142,0,2836,57,85,5.0,2.0
7195,108,2,108,0,2,0,25.0,57.02
7196,1128,1,1128,900,1,0,33.333333333333336,75.25
7197,2490924,430,0,27073,230,200,1.694915254237288,0.11
7198,216,33,216,13,30,3,6.666666666666667,65.71
7199,84,12,84,15,12,0,7.142857142857143,52.22
7200,924,17,924,53,17,0,5.2631578947368425,45.14
7201,3420,0,3420,0,0,0,100.0,100.0
7202,42936,28,42936,1030,24,4,5.2631578947368425,78.48
7203,1824,13,1824,1074,13,0,7.6923076923076925,82.4
7204,504,10,504,104,10,0,8.333333333333334,36.17
7205,1188936,3,1188936,44628,3,0,25.0,80.0
7206,396,6,396,38,4,2,25.0,84.13
7207,1524,2,1524,390,1,1,50.0,91.92
7208,840,18,840,42,14,4,6.666666666666667,60.68
7209,2716212,3716,753168,756530,1631,2085,1.0,0.94
7210,192,0,192,0,0,0,50.0,80.0
7211,72,8,72,18,6,2,14.285714285714286,50.96
7212,10752,30,10752,1206,24,6,5.882352941176471,61.58
7213,1512,7,1512,413,7,0,12.5,99.31
7214,3048,23,3048,684,19,4,6.25,78.38
7215,468,24,468,69,24,0,4.3478260869565215,55.02
7216,1498584,117,1498584,573805,102,15,1.7857142857142858,90.76
7217,11544,23,11544,874,19,4,6.25,70.23
7218,15612,42,0,1355,27,15,100.0,0.0
7219,43188,79,43188,2724,69,10,20.0,17.65
7220,492,0,492,0,0,0,33.333333333333336,67.2
7221,11508,39,11436,1367,30,9,5.2631578947368425,60.97
7222,3060,174,0,1373,105,69,100.0,0.0
7223,216,2,216,90,2,0,20.0,67.02
7224,1104,5,1104,285,5,0,16.666666666666668,91.03
7225,3576,166,0,664,121,45,100.0,0.0
7226,73008,33,73008,1073,28,5,4.761904761904762,73.73
7227,77904,14,77904,2356,14,0,7.6923076923076925,32.0
7228,324,9,324,64,5,4,20.0,83.11
7229,2355588,1147,0,22552,657,490,1.0638297872340423,0.0
7230,2719692,31106,189288,486483,17871,13235,1.0,0.0
7231,32820,1,32820,720,1,0,100.0,100.0
7232,876,6,0,484,5,1,100.0,0.0
7233,18996,43,18996,17,33,10,3.333333333333333,54.24
7234,65052,21,65052,2580,16,5,7.6923076923076925,76.7
7235,648,56,648,58,46,10,2.3255813953488373,4.22
7236,1424832,165,0,36077,78,87,4.166666666666667,0.0
7237,2614548,143,2614548,5616,72,71,3.225806451612903,75.11
7238,7212,5,7212,1082,5,0,50.0,71.05
7239,5004,6,5004,934,6,0,12.5,74.01
7240,35988,32,0,4443,25,7,100.0,0.0
7241,780,21,780,570,21,0,4.3478260869565215,81.2
7242,636,1,636,516,1,0,33.333333333333336,81.2
7243,33228,261,0,2899,146,115,100.0,0.0
7244,9636,13,9636,1163,13,0,7.142857142857143,64.28
7245,18660,7,18660,281,7,0,20.0,31.27
7246,2656392,147,2656392,106003,82,65,5.555555555555555,57.85
7247,2124,70,2124,1853,50,20,1.851851851851852,55.44
7248,254556,7,0,218103,5,2,9.090909090909092,0.0
7249,8640,33,8640,1084,29,4,4.166666666666667,76.73
7250,24636,21,8040,1526,17,4,6.25,87.58
7251,564,7,564,99,7,0,20.0,28.43
7252,2204388,1104,0,22835,580,524,1.0,3.1
7253,1447308,1040,0,6985,720,320,1.0,0.0
7254,2725140,255,0,73549,137,118,3.571428571428572,0.0
7255,92652,28,92652,8877,28,0,4.166666666666667,29.4
7256,76332,89,76332,1631,72,17,1.3888888888888888,17.43
7257,300,0,300,0,0,0,50.0,61.29
7258,1692,11,1692,317,11,0,16.666666666666668,29.67
7259,336,0,336,0,0,0,50.0,94.17
7260,25944,47,25944,21,27,20,5.2631578947368425,75.4
7261,10212,41,0,1220,26,15,100.0,0.0
7262,816,13,816,380,13,0,6.666666666666667,79.46
7263,516396,70,281573,181422,70,0,3.8461538461538463,56.13
7264,27768,61,27768,44,47,14,2.380952380952381,43.86
7265,29460,54,0,2390,46,8,100.0,0.0
7266,1552392,842,94416,25576,465,377,1.4705882352941178,3.03
7267,2412,57,2412,1802,23,34,7.6923076923076925,0.0
7268,2340,22,2340,212,18,4,8.333333333333334,75.97
7269,984,8,984,889,8,0,10.0,89.63
7270,7884,195,0,1428,114,81,2.0,0.0
7271,104736,32,104736,133,22,10,7.6923076923076925,74.38
7272,2296092,1154,0,10020,517,637,1.0,0.0
7273,11340,38,11340,1193,33,5,4.0,72.53
7274,2724804,2445,0,35413,1366,1079,1.0,0.0
7275,55680,57,55680,3034,43,14,2.272727272727273,15.31
7276,204,6,204,36,6,0,12.5,80.23
7277,1140,34,1140,169,22,12,9.090909090909092,63.99
7278,1548516,45,0,37887,37,8,50.0,0.0
7279,1980,1,1980,240,1,0,33.333333333333336,91.69
7280,521472,547,0,5016,240,307,1.7857142857142858,0.0
7281,228,36,228,86,24,12,5.0,63.24
7282,132,82,132,43,64,18,1.7543859649122806,54.68
7283,1116,33,1116,865,33,0,2.857142857142857,41.38
7284,1848,2,1848,90,1,1,50.0,57.78
7285,473484,82,0,10611,51,31,11.11111111111111,0.0
7286,1911060,58,0,68050,28,30,7.6923076923076925,0.0
7287,212076,4,212076,78,3,1,33.333333333333336,96.88
7288,12744,238,0,1953,135,103,100.0,0.0
7289,96,54,96,33,27,27,7.6923076923076925,67.98
7290,1820748,323,0,11222,158,165,3.703703703703704,0.0
7291,2458392,207,0,228527,136,71,1.492537313432836,0.0
7292,216,98,216,67,54,44,3.0303030303030303,66.36
7293,40920,47,0,1568,38,9,50.0,0.0
7294,41400,49,0,1469,36,13,50.0,0.0
7295,1224,4,1224,798,2,2,50.0,99.9
7296,38016,7,38016,216,5,2,25.0,96.23
7297,1196760,383,0,9302,204,179,2.857142857142857,0.0
7298,192,7,192,15,7,0,11.11111111111111,57.23
7299,12000,43,0,1358,28,15,100.0,0.0
7300,22836,45,22836,3397,41,4,14.285714285714286,21.24
7301,2832,76,0,895,59,17,100.0,0.0
7302,44388,47,0,1612,34,13,50.0,0.0
7303,12972,7,12972,1512,6,1,16.666666666666668,88.78
7304,1716,5,1716,321,3,2,25.0,97.53
7305,45888,45,0,1747,37,8,50.0,0.0
7306,11388,25,11388,1019,22,3,5.0,75.6
7307,203304,49,0,21594,41,8,20.0,50.0
7308,7068,341,0,1927,186,155,100.0,0.0
7309,1032,52,1032,59,38,14,3.0303030303030303,54.2
7310,1632,64,1632,43,38,26,4.0,16.38
7311,588,3,588,196,2,1,33.333333333333336,22.68
7312,528,18,528,352,11,7,20.0,93.32
7313,48108,22,0,5503,18,4,100.0,0.0
7314,2323368,1291,0,10934,952,339,1.0,0.0
7315,6924,30,6924,1581,26,4,7.142857142857143,62.9
7316,1512,13,1512,1318,7,6,16.666666666666668,70.28
7317,1118424,577,0,6590,306,271,2.0,0.0
7318,91128,327,0,25580,237,90,100.0,0.0
7319,12012,54,0,1161,39,15,100.0,0.0
7320,1055484,1074,5112,7548,574,500,1.0416666666666667,0.0
7321,1776,20,60,192,11,9,20.0,19.85
7322,228,3,228,80,2,1,33.333333333333336,23.46
7323,228,1,228,36,1,0,50.0,80.39
7324,20844,28,20844,732,23,5,5.0,85.71
7325,2763972,9431,0,301906,5378,4053,1.0,0.0
7326,723228,50,0,20200,44,6,50.0,0.0
7327,90636,17,90636,1018,15,2,7.6923076923076925,74.38
7328,1152,12,1152,254,8,4,16.666666666666668,70.99
7329,108,0,108,0,0,0,50.0,45.14
7330,5004,146,5004,4322,120,26,1.0,23.52
7331,2016,11,2016,291,9,2,12.5,91.22
7332,38712,31,38712,1289,26,5,5.2631578947368425,79.58
7333,12036,43,0,1273,29,14,100.0,0.0
7334,554868,337,0,5479,172,165,2.9411764705882355,0.0
7335,96,57,36,10,53,4,1.9230769230769231,9.13
7336,6468,59,6468,1626,45,14,3.571428571428572,58.72
7337,2740596,806,0,521521,478,328,1.0,1.52
7338,22356,35,22356,1252,31,4,3.8461538461538463,75.89
7339,1750560,84,0,60541,50,34,7.142857142857143,45.16
7340,184464,94,2364,3453,69,25,2.272727272727273,42.22
7341,45852,7,45852,6289,7,0,20.0,28.18
7342,5844,247,0,1323,154,93,1.098901098901099,0.0
7343,684,14,684,208,13,1,16.666666666666668,27.2
7344,540,7,540,89,7,0,14.285714285714286,19.86
7345,156,1,156,12,1,0,33.333333333333336,59.28
7346,12012,47,0,1348,31,16,100.0,0.0
7347,36516,6,36516,394,6,0,16.666666666666668,96.93
7348,28860,47,28860,845,46,1,8.333333333333334,26.51
7349,8220,259,0,3494,187,72,100.0,0.0
7350,864,6,864,604,5,1,25.0,98.6
7351,216,27,216,107,14,13,50.0,99.58
7352,72,12,72,15,9,3,12.5,54.94
7353,37656,66,0,4841,40,26,6.25,0.0
7354,37860,67,10416,2040,52,15,3.571428571428572,95.62
7355,504624,39,504624,15438,34,5,3.703703703703704,34.28
7356,84,14,84,0,14,0,6.25,61.92
7357,66972,3,66972,708,2,1,100.0,0.0
7358,1471236,846,1121190,44476,458,388,1.0,17.57
7359,6804,11,6804,740,10,1,10.0,12.01
7360,204,37,192,35,20,17,16.666666666666668,17.55
7361,39360,56,0,1432,42,14,50.0,0.0
7362,39756,49,0,1566,39,10,50.0,0.0
7363,39936,49,0,1532,36,13,50.0,0.0
7364,40308,51,0,1392,38,13,50.0,0.0
7365,132,32,120,41,25,7,5.0,41.35
7366,244572,720,244572,800,370,350,1.3157894736842106,46.48
7367,26496,8,0,3868,6,2,20.0,0.21
7368,7308,50,7308,973,46,4,5.0,32.73
7369,4584,23,4584,519,18,5,7.142857142857143,95.99
7370,312,37,312,197,21,16,6.666666666666667,63.9
7371,9744,47,0,1293,32,15,100.0,0.0
7372,420,100,252,63,78,22,1.492537313432836,27.53
7373,1155132,748,0,8483,416,332,1.492537313432836,0.0
7374,516,5,516,331,5,0,14.285714285714286,72.3
7375,924,54,924,350,46,8,2.9411764705882355,58.3
7376,144,22,60,30,20,2,5.0,33.84
7377,96,3,96,44,2,1,33.333333333333336,65.37
7378,4500,33,4500,861,26,7,5.882352941176471,97.24
7379,525624,8,525624,58,5,3,25.0,71.0
7380,204,7,204,92,6,1,16.666666666666668,82.4
7381,51180,69,51180,4219,59,10,100.0,29.04
7382,2563752,89,0,113944,41,48,5.2631578947368425,10.0
7383,25428,63,0,1062,42,21,2.9411764705882355,0.0
7384,48216,13,0,6421,10,3,100.0,0.0
7385,3732,35,3732,885,29,6,5.2631578947368425,96.65
7386,903876,515,0,10073,276,239,2.127659574468085,0.0
7387,948,87,948,679,75,12,1.3157894736842106,13.95
7388,148764,16,0,10079,13,3,9.090909090909092,0.0
7389,1208112,259,415090,246679,259,0,2.2222222222222223,85.15
7390,1488,51,1332,272,44,7,2.4390243902439024,3.0
7391,359616,39,0,64034,21,18,12.5,0.0
7392,30612,227,0,2083,150,77,1.5151515151515151,2.0
7393,4776,36,4776,1100,31,5,3.8461538461538463,75.02
7394,12024,42,0,1237,27,15,100.0,0.0
7395,768,0,768,0,0,0,100.0,100.0
7396,888,31,888,129,27,4,3.8461538461538463,56.26
7397,4896,31,4896,744,25,6,5.0,71.64
7398,2721096,655,0,257972,276,379,2.3255813953488373,0.0
7399,84348,32,84348,1075,28,4,4.545454545454546,79.96
7400,1680,77,1680,506,47,30,4.3478260869565215,72.49
7401,5892,194,0,1306,121,73,1.6129032258064515,0.0
7402,43272,1,43272,240,1,0,100.0,100.0
7403,7104,4,7104,579,4,0,16.666666666666668,34.56
7404,6660,6,6660,2978,5,1,16.666666666666668,90.43
7405,369156,13,369156,11588,12,1,7.6923076923076925,33.95
7406,12072,8,12072,1252,8,0,11.11111111111111,51.49
7407,3084,51,3084,2544,51,0,1.8867924528301887,13.07
7408,655728,966,0,7514,671,295,1.0,0.0
7409,5184,32,5184,1350,29,3,4.761904761904762,79.33
7410,153264,24,153264,3165,21,3,5.882352941176471,65.99
7411,732,33,264,63,22,11,7.142857142857143,18.34
7412,1020,12,1020,741,6,6,25.0,0.0
7413,216,7,216,75,6,1,14.285714285714286,65.14
7414,2803140,215,2539092,876963,194,21,1.0638297872340423,3.57
7415,2015052,349,0,43049,218,131,1.36986301369863,0.0
7416,2813676,5822,850152,1003431,3420,2402,1.0,0.7
7417,444,1,444,336,1,0,33.333333333333336,0.0
7418,59484,50,0,20060,46,4,100.0,0.0
7419,871224,61,871224,2363,25,36,20.0,92.06
7420,1044,11,1044,470,9,2,33.333333333333336,99.78
7421,48,15,48,8,11,4,11.11111111111111,50.05
7422,2546616,554,0,36886,292,262,1.96078431372549,4.76
7423,0,0,0,0,0,0,9.090909090909092,93.06
7424,2616,152,0,615,115,37,100.0,0.0
7425,2580252,84,0,100302,34,50,14.285714285714286,0.01
7426,1344,39,1344,843,26,13,4.761904761904762,0.0
7427,684,0,684,0,0,0,50.0,93.6
7428,804,4,804,255,3,1,25.0,53.8
7429,108,9,108,16,9,0,9.090909090909092,87.53
7430,2741928,1567,0,509295,866,701,1.0,0.0
7431,2813424,3792,1029633,386824,2139,1653,1.0,0.0
7432,2880,4,2880,972,3,1,50.0,99.98
7433,5400,28,5400,897,25,3,4.3478260869565215,51.62
7434,78336,5,78336,1478,5,0,14.285714285714286,97.27
7435,2232,78,0,734,63,15,2.0408163265306123,0.0
7436,13812,43,0,1266,28,15,100.0,0.0
7437,2398836,2084,0,41803,1180,904,1.0,0.0
7438,2688576,640,2688576,42792,381,259,1.694915254237288,86.76
7439,612,20,60,48,14,6,9.090909090909092,19.81
7440,1970412,1831,0,7091,1148,683,1.0,0.0
7441,141600,32,0,7949,28,4,50.0,0.0
7442,19896,35,19896,1765,33,2,16.666666666666668,10.64
7443,2764860,1964,0,51687,1102,862,1.0,0.21
7444,1656,9,156,236,6,3,25.0,77.17
7445,10920,29,10920,1263,28,1,4.3478260869565215,75.84
7446,833148,300,0,27021,208,92,50.0,0.0
7447,267792,211,0,11412,105,106,5.555555555555555,0.0
7448,5616,3,5616,528,3,0,25.0,95.06
7449,15660,10,15660,825,9,1,14.285714285714286,39.3
7450,5844,6,5844,500,5,1,20.0,97.25
7451,2816820,803,0,354192,340,463,1.6129032258064515,0.0
7452,15048,176,0,1547,107,69,100.0,0.0
7453,2964,66,2964,78,52,14,2.1739130434782608,31.82
7454,2345832,106,2345832,8295,50,56,4.166666666666667,84.87
7455,324,54,168,75,36,18,3.333333333333333,53.27
7456,127536,257,0,19638,185,72,50.0,0.0
7457,2479596,10,0,1044664,10,0,50.0,99.53
7458,9204,32,9204,1002,29,3,3.8461538461538463,76.14
7459,932916,363,0,10497,194,169,3.0303030303030303,0.0
7460,112692,296,0,2886,164,132,4.761904761904762,0.0
7461,10212,45,0,1205,29,16,100.0,0.0
7462,94656,124,0,2731,48,76,11.11111111111111,0.0
7463,47340,6,25206,2302,4,2,12.5,1.11
7464,2772540,3880,0,129871,2192,1688,1.0,0.0
7465,24324,30,24324,2204,26,4,5.0,46.85
7466,7368,88,7368,108,64,24,1.8867924528301887,16.36
7467,72600,22,72600,16251,22,0,5.0,78.59
7468,14196,74,0,3220,64,10,100.0,0.0
7469,2196,54,0,816,44,10,100.0,0.0
7470,36396,7,36396,5281,4,3,33.333333333333336,34.07
7471,2697744,48,2697744,58515,27,21,11.11111111111111,91.48
7472,41784,57,0,1910,44,13,50.0,0.0
7473,42444,48,0,1501,34,14,50.0,0.0
7474,67116,53,67116,3415,40,13,2.380952380952381,18.23
7475,42924,48,0,1628,36,12,50.0,0.0
7476,1404,16,1404,685,13,3,11.11111111111111,89.37
7477,43320,49,0,1546,36,13,50.0,0.0
7478,1621560,488,0,16060,247,241,1.9230769230769231,1.28
7479,1618008,450,0,9835,221,229,4.0,0.0
7480,264576,303,0,10306,111,192,3.333333333333333,0.0
7481,540,7,540,221,6,1,14.285714285714286,62.5
7482,1488,3,1488,648,2,1,50.0,76.66
7483,803532,374,0,5896,192,182,2.380952380952381,2.0
7484,28968,19,28968,20544,15,4,7.142857142857143,96.42
7485,2762616,1665,0,22246,924,741,1.0,0.81
7486,2322876,372,0,61672,219,153,1.0,0.0
7487,337272,5,337272,26095,5,0,16.666666666666668,92.41
7488,1344,7,1344,342,4,3,20.0,59.22
7489,72,14,60,18,10,4,11.11111111111111,53.88
7490,12024,39,0,1370,25,14,100.0,0.0
7491,105300,57,0,4667,48,9,100.0,0.0
7492,83196,327,0,2221,165,162,4.166666666666667,0.0
7493,2844,19,2100,702,12,7,20.0,99.26
7494,163920,29,0,7688,27,2,50.0,0.0
7495,19056,73,19056,35,45,28,3.0303030303030303,50.78
7496,19392,51,19392,1703,43,8,3.4482758620689653,73.55
7497,57012,5,0,12132,4,1,50.0,99.98
7498,256296,278,0,12686,139,139,5.555555555555555,2.0
7499,22404,32,22404,1450,29,3,20.0,20.21
7500,256824,568,0,2253,308,260,1.5873015873015872,2.38
7501,528,9,528,250,5,4,33.333333333333336,73.73
7502,492,17,492,123,15,2,6.666666666666667,66.93
7503,17904,27,17904,674,23,4,4.761904761904762,85.85
7504,24636,0,24636,0,0,0,100.0,100.0
7505,2416524,1763,6864,28817,988,775,1.098901098901099,0.0
7506,24264,0,24264,0,0,0,100.0,100.0
7507,272256,3,228,92060,2,1,33.333333333333336,60.96
7508,0,0,0,0,0,0,50.0,0.0
7509,168,3,168,0,3,0,20.0,21.32
7510,10512,26,0,2235,22,4,100.0,0.0
7511,12024,43,0,1545,28,15,100.0,0.0
7512,432,3,432,0,3,0,20.0,21.32
7513,176004,44,0,11489,39,5,50.0,0.0
7514,85368,62,0,7964,50,12,100.0,0.0
7515,15072,35,0,5053,31,4,100.0,0.0
7516,48960,23,48960,737,18,5,7.142857142857143,67.95
7517,2652,1,2652,264,1,0,50.0,98.37
7518,178632,47,0,5985,34,13,50.0,0.0
7519,107412,49,0,10648,37,12,100.0,0.0
7520,14316,21,14316,464,15,6,10.0,86.45
7521,477648,733,0,8491,387,346,2.2222222222222223,0.0
7522,2859912,6390,247044,492801,4665,1725,1.0,0.01
7523,1872,4,1872,606,4,0,25.0,99.24
7524,459720,89,0,12550,53,36,8.333333333333334,0.0
7525,423684,25,423684,4640,22,3,4.761904761904762,18.29
7526,12012,46,0,1337,31,15,100.0,0.0
7527,504,1,0,504,1,0,33.333333333333336,96.67
7528,1020,63,1020,661,45,18,2.631578947368421,41.48
7529,10344,41,10344,1670,33,8,4.3478260869565215,60.24
7530,39828,65,0,1588,51,14,33.333333333333336,0.0
7531,2648628,6457,34056,67210,3546,2911,1.0,0.0
7532,5628,179,3552,341,88,91,3.333333333333333,73.07
7533,1013544,51,4080,23509,32,19,7.142857142857143,0.0
7534,3324,11,3324,759,7,4,50.0,99.89
7535,44136,137,0,1504,99,38,33.333333333333336,0.0
7536,4500,17,4500,893,14,3,7.6923076923076925,57.46
7537,37248,32,0,2539,25,7,50.0,0.0
7538,1771776,1067,0,14225,584,483,1.2345679012345678,0.0
7539,4308,30,4308,814,23,7,5.555555555555555,47.02
7540,37968,47,0,1542,33,14,50.0,0.0
7541,38316,51,0,2116,44,7,50.0,0.0
7542,8808,43,0,1176,28,15,100.0,0.0
7543,39132,48,0,1479,37,11,50.0,0.0
7544,720,52,720,66,41,11,2.702702702702702,72.62
7545,960,58,960,16,40,18,3.0303030303030303,14.0
7546,264,79,264,90,47,32,3.125,62.34
7547,1044,44,1044,461,39,5,3.0303030303030303,52.36
7548,4068,33,4068,2473,16,17,33.333333333333336,99.59
7549,6072,61,6072,768,60,1,8.333333333333334,39.99
7550,864,35,864,180,25,10,5.882352941176471,57.42
7551,12612,211,0,1461,113,98,1.9230769230769231,0.0
7552,200748,9,200748,3061,5,4,16.666666666666668,48.81
7553,0,0,0,0,0,0,100.0,0.0
7554,74304,27,74304,869,22,5,6.25,83.03
7555,4824,44,4824,1203,43,1,7.6923076923076925,34.45
7556,456,150,456,354,127,23,1.1904761904761905,42.73
7557,58524,313,0,12361,218,95,100.0,0.0
7558,360108,29,360108,5829,25,4,4.3478260869565215,22.52
7559,73980,18,73980,1976,15,3,11.11111111111111,78.53
7560,8412,45,0,1235,30,15,100.0,0.0
7561,192,0,192,0,0,0,50.0,60.1
7562,2819988,2418,0,85913,1352,1066,1.0638297872340423,0.0
7563,601524,47,469470,4305,38,9,3.333333333333333,12.82
7564,612,0,612,0,0,0,50.0,64.0
7565,76560,13,76560,1091,11,2,16.666666666666668,23.56
7566,6696,29,3384,1005,23,6,7.6923076923076925,80.44
7567,2712,55,2712,1102,53,2,3.125,46.31
7568,339012,68,0,46118,53,15,2.857142857142857,0.0
7569,420,14,420,26,14,0,6.25,55.5
7570,60216,29,0,5692,22,7,7.142857142857143,0.0
7571,73128,13,73128,7065,8,5,16.666666666666668,92.57
7572,1514004,397,0,13537,198,199,3.571428571428572,0.0
7573,2440056,11,1182882,1518924,6,5,1.0,1.4
7574,6528,3,6528,752,3,0,100.0,100.0
7575,166920,62,166920,4265,52,10,2.631578947368421,54.05
7576,4452,2,0,4230,1,1,50.0,90.0
7577,7140,216,0,1195,165,51,100.0,0.0
7578,96,1,96,0,1,0,50.0,0.0
7579,1044,3,1044,492,2,1,50.0,64.27
7580,1752,135,0,504,80,55,2.3255813953488373,0.0
7581,3372,14,3372,420,11,3,14.285714285714286,67.04
7582,1980,56,1980,1498,55,1,1.851851851851852,15.46
7583,93684,268,0,3207,153,115,33.333333333333336,0.0
7584,2604,5,2604,981,3,2,50.0,99.99
7585,381300,8,381300,13525,7,1,20.0,88.61
7586,5016,24,5016,739,20,4,8.333333333333334,65.87
7587,10248,48,0,1219,32,16,100.0,0.0
7588,492,25,492,90,25,0,4.3478260869565215,46.13
7589,348,4,348,30,2,2,100.0,100.0
7590,12588,0,12588,0,0,0,100.0,100.0
7591,88788,20,88788,84224,20,0,5.555555555555555,59.65
7592,31464,292,0,2565,201,91,100.0,0.0
7593,22284,41,22284,758,35,6,2.9411764705882355,13.48
7594,468,14,468,165,7,7,50.0,58.62
7595,39444,69,0,5556,62,7,100.0,0.0
7596,70632,10,70632,1312,9,1,16.666666666666668,26.69
7597,2032404,403,0,19261,165,238,2.5641025641025643,0.0
7598,588,10,588,0,10,0,9.090909090909092,99.02
7599,690840,23,690840,32738,17,6,6.25,87.33
7600,3252,22,3252,972,20,2,6.666666666666667,88.92
7601,45528,8,45528,661,8,0,10.0,96.11
7602,1540260,401,0,70424,202,199,2.4390243902439024,0.0
7603,87936,27,87936,1258,25,2,3.571428571428572,39.89
7604,60,1,60,0,1,0,33.333333333333336,73.15
7605,189792,34,189792,167148,34,0,2.9411764705882355,67.05
7606,900,0,900,0,0,0,100.0,100.0
7607,909708,147,0,20218,79,68,2.631578947368421,0.0
7608,2832,3,468,1468,2,1,50.0,98.43
7609,54648,29,54648,2498,24,5,5.555555555555555,35.18
7610,192,0,192,0,0,0,100.0,100.0
7611,152460,2,152460,1260,1,1,50.0,99.99
7612,1717116,295,0,8669,145,150,4.3478260869565215,0.0
7613,39264,7,39264,133,5,2,25.0,83.95
7614,84,4,84,3,4,0,16.666666666666668,67.56
7615,96,14,96,24,8,6,25.0,75.85
7616,276,1,276,0,1,0,33.333333333333336,60.46
7617,2312580,1317,0,23398,733,584,1.4492753623188406,2.0
7618,1008,3,1008,368,3,0,33.333333333333336,97.4
7619,149472,96,149472,2746,73,23,1.492537313432836,17.84
7620,2227464,237,0,21128,117,120,2.9411764705882355,0.0
7621,43596,42,0,3578,33,9,100.0,0.0
7622,72,33,72,22,27,6,4.0,36.14
7623,18708,10,18708,964,9,1,11.11111111111111,79.69
7624,28320,15,0,6898,8,7,33.333333333333336,0.0
7625,1548,0,1548,0,0,0,100.0,100.0
7626,2076,30,2076,598,14,16,11.11111111111111,56.56
7627,17016,24,17016,995,19,5,6.666666666666667,74.21
7628,636,2,636,228,2,0,25.0,54.15
7629,23028,20,23028,2458,20,0,5.2631578947368425,30.9
7630,10200,40,0,1236,25,15,100.0,0.0
7631,2844,52,2844,1178,41,11,3.333333333333333,67.91
7632,1260960,178,0,18535,98,80,7.6923076923076925,0.0
7633,2229468,689,0,13429,400,289,1.162790697674419,0.0
7634,29940,51,0,1238,40,11,50.0,0.0
7635,672,2,0,618,2,0,50.0,0.0
7636,8700,13,8700,1477,13,0,9.090909090909092,39.81
7637,2690640,218,1345938,24677,108,110,1.25,0.0
7638,48,27,48,13,19,8,7.6923076923076925,39.88
7639,1248,42,1248,7,41,1,33.333333333333336,0.0
7640,756,155,756,334,91,64,1.5873015873015872,55.4
7641,300,0,300,0,0,0,50.0,27.46
7642,31992,47,0,1642,35,12,50.0,0.0
7643,71976,8,71976,2895,7,1,12.5,92.43
7644,9300,67,0,4410,62,5,100.0,0.0
7645,144276,12,948,24448,6,6,8.333333333333334,47.91
7646,2304,2,2304,2106,1,1,16.666666666666668,14.99
7647,480,4,480,246,3,1,25.0,55.62
7648,300,3,300,28,2,1,33.333333333333336,88.69
7649,841404,231,0,11178,126,105,2.127659574468085,2.0
7650,2651844,951,0,54259,544,407,1.2048192771084338,4.75
7651,1838268,727,0,19358,392,335,1.3333333333333333,0.0
7652,432,4,432,210,4,0,16.666666666666668,20.22
7653,744,2,744,354,2,0,33.333333333333336,50.43
7654,106620,32,93768,12955,27,5,4.545454545454546,87.24
7655,234180,49,0,10332,43,6,50.0,0.0
7656,2280816,638,0,40132,352,286,1.0869565217391304,0.0
7657,19476,252,0,2210,153,99,100.0,0.0
7658,10212,41,0,1375,26,15,100.0,0.0
7659,1176,47,1176,593,40,7,3.0303030303030303,63.35
7660,425016,12,425016,14972,12,0,7.142857142857143,94.1
7661,2832060,1337,0,42939,739,598,1.1111111111111112,0.0
7662,132,14,132,43,8,6,25.0,56.71
7663,2007804,36,2007804,2239,33,3,2.9411764705882355,39.98
7664,267144,78,202500,33305,72,6,1.408450704225352,23.26
7665,88548,79,852,4675,70,9,1.5873015873015872,40.16
7666,2136,49,0,741,42,7,25.0,50.0
7667,61824,32,61824,1313,27,5,5.555555555555555,81.37
7668,1080,96,1080,491,72,24,1.6666666666666667,29.71
7669,2000040,182,2000040,101818,182,0,100.0,100.0
7670,54852,216,0,4853,163,53,33.333333333333336,0.0
7671,5040,12,5040,1076,9,3,12.5,83.93
7672,627240,52,0,29949,43,9,50.0,0.0
7673,48276,34,48276,323,32,2,3.0303030303030303,74.94
7674,2964,0,2964,0,0,0,100.0,100.0
7675,47880,63,1476,1594,50,13,2.857142857142857,63.06
7676,360,1,360,72,1,0,100.0,100.0
7677,2052,4,312,633,2,2,50.0,98.92
7678,133152,33,0,17234,24,9,100.0,0.0
7679,10212,47,0,1254,30,17,100.0,0.0
7680,2688,47,2688,275,31,16,3.8461538461538463,60.42
7681,10248,389,0,2599,214,175,100.0,0.0
7682,14976,56,0,2630,45,11,100.0,0.0
7683,4368,38,4368,259,26,12,4.545454545454546,17.03
7684,2562360,872,0,46228,472,400,1.2987012987012987,4.61
7685,84,28,60,15,20,8,6.666666666666667,15.58
7686,106788,40,0,6044,34,6,50.0,0.0
7687,864,1,864,96,1,0,50.0,45.07
7688,216,2,0,180,2,0,50.0,99.96
7689,8016,23,8016,403,19,4,6.25,84.79
7690,1428504,7,696,210570,6,1,20.0,50.29
7691,1956,60,1956,723,49,11,2.7777777777777777,57.06
7692,948,1,0,948,1,0,50.0,99.77
7693,27312,8,27312,435,7,1,12.5,91.54
7694,2856216,980,0,18769,535,445,1.098901098901099,4.8
7695,930912,232,0,8099,109,123,5.0,0.0
7696,156,8,156,85,4,4,50.0,61.73
7697,999216,89,780,11315,79,10,1.2820512820512822,40.91
7698,84360,47,84360,2176,43,4,16.666666666666668,19.78
7699,113652,45,0,6986,37,8,50.0,0.0
7700,10212,41,0,1248,27,14,100.0,0.0
7701,115800,8,115800,255,8,0,10.0,91.18
7702,96,0,96,0,0,0,50.0,59.29
7703,35820,22,35820,611,18,4,7.6923076923076925,83.28
7704,9564,313,0,2805,175,138,1.7543859649122806,0.0
7705,396,19,396,77,16,3,6.666666666666667,15.37
7706,2677752,3917,0,144671,2190,1727,1.0,0.0
7707,95052,38,0,5013,34,4,50.0,0.0
7708,420,0,420,0,0,0,50.0,59.29
7709,2655504,611,0,51826,345,266,2.380952380952381,0.0
7710,2924904,4331,0,102620,2356,1975,1.0,0.0
7711,51936,17,51936,1258,14,3,20.0,27.16
7712,81192,43,0,4129,33,10,50.0,0.0
7713,38988,20,38988,1149,16,4,10.0,77.7
7714,348,27,348,84,21,6,5.555555555555555,17.06
7715,29124,38,0,3127,34,4,50.0,0.0
7716,84984,56,0,11059,45,11,100.0,0.0
7717,20628,59,0,3846,46,13,100.0,0.0
7718,42672,18,42672,3291,15,3,14.285714285714286,73.98
7719,3000,12,3000,833,10,2,16.666666666666668,0.0
7720,2739300,259,2739300,18207,129,130,4.166666666666667,78.6
7721,13824,45,0,1412,28,17,100.0,0.0
7722,21204,46,0,3398,38,8,100.0,0.0
7723,30420,14,0,4794,13,1,6.666666666666667,20.0
7724,2668860,1860,0,27273,1016,844,1.1363636363636365,0.0
7725,117492,1,117492,144,1,0,33.333333333333336,64.83
7726,2623452,588,0,12844,325,263,1.2987012987012987,0.0
7727,1927020,614,0,28314,358,256,1.3157894736842106,0.0
7728,12564,15,12564,696,14,1,8.333333333333334,91.69
7729,7752,3,0,4016,3,0,25.0,0.0
7730,9624,0,9624,0,0,0,33.333333333333336,86.67
7731,4512,148,0,1423,111,37,100.0,0.0
7732,0,0,0,0,0,0,100.0,0.0
7733,9300,43,0,1215,28,15,100.0,0.0
7734,71688,34,71688,2051,31,3,33.333333333333336,38.89
7735,720,62,720,23,40,22,3.225806451612903,12.95
7736,3804,23,3804,1063,20,3,6.25,61.02
7737,2909040,3796,0,167281,2150,1646,1.0,0.0
7738,71208,31,71208,1460,25,6,5.882352941176471,48.88
7739,2364,9,2364,69,9,0,9.090909090909092,48.0
7740,39276,16,39276,1999,13,3,9.090909090909092,63.1
7741,2028,14,2028,584,12,2,8.333333333333334,79.03
7742,68052,129,0,1409,101,28,100.0,0.0
7743,2736996,155,2736996,14151,86,69,4.761904761904762,82.73
7744,148968,10,148968,783,7,3,16.666666666666668,97.04
7745,5712,16,5712,678,15,1,7.142857142857143,62.06
7746,168,29,168,40,23,6,4.545454545454546,53.94
7747,2328,4,2328,0,4,0,16.666666666666668,70.0
7748,45720,2,0,22878,1,1,100.0,0.0
7749,62856,43,1176,2097,37,6,3.225806451612903,52.81
7750,564,26,492,128,23,3,4.166666666666667,53.48
7751,141504,96,140952,9073,81,15,1.2820512820512822,0.0
7752,1068,0,1068,0,0,0,50.0,96.17
7753,45024,25,45024,711,20,5,7.6923076923076925,84.86
7754,64824,28,64824,1667,24,4,5.882352941176471,71.55
7755,9276,37,9276,724,36,1,9.090909090909092,26.66
7756,432,0,432,0,0,0,100.0,100.0
7757,3456,15,3456,680,14,1,8.333333333333334,62.66
7758,2465100,27,32940,414387,23,4,5.555555555555555,57.07
7759,1963260,406,0,25914,211,195,1.7543859649122806,7.38
7760,347964,34,756,10608,22,12,7.142857142857143,66.06
7761,33624,51,33624,3183,43,8,20.0,19.98
7762,13812,52,0,1275,36,16,100.0,0.0
7763,3744,16,3744,754,14,2,8.333333333333334,74.27
7764,958032,27,0,53243,15,12,14.285714285714286,5.94
7765,37872,11,37872,1456,9,2,10.0,85.44
7766,5544,18,5544,906,15,3,7.6923076923076925,81.65
7767,744,10,744,494,8,2,14.285714285714286,70.62
7768,7944,32,7944,1613,29,3,5.555555555555555,54.25
7769,3960,142,0,1357,110,32,100.0,0.0
7770,15852,8,15852,1849,6,2,20.0,85.72
7771,156,0,156,0,0,0,100.0,100.0
7772,36744,24,36744,1124,21,3,9.090909090909092,17.32
7773,132,0,132,0,0,0,50.0,87.25
7774,192,0,192,0,0,0,100.0,100.0
7775,304692,29,3288,11421,26,3,4.761904761904762,45.63
7776,695724,71,443226,8806,59,12,2.272727272727273,7.23
7777,96,0,96,0,0,0,50.0,59.29
7778,9132,18,0,1082,12,6,8.333333333333334,0.0
7779,11388,42,11388,1200,39,3,10.0,41.8
7780,0,0,0,0,0,0,50.0,0.0
7781,1404,8,1404,52,8,0,10.0,79.7
7782,1644,5,1644,1411,5,0,14.285714285714286,91.36
7783,35184,11,35184,1301,11,0,11.11111111111111,78.42
7784,84,4,84,33,3,1,25.0,57.41
7785,12000,42,0,1284,27,15,100.0,0.0
7786,24924,42,24924,66,38,4,2.702702702702702,20.25
7787,10740,23,10740,1040,21,2,4.545454545454546,46.52
7788,28332,49,0,15284,42,7,100.0,0.0
7789,25080,4,25080,3864,3,1,33.333333333333336,59.66
7790,26652,78,26652,2215,36,42,5.555555555555555,69.27
7791,420,53,420,154,27,26,12.5,75.6
7792,204,35,204,68,17,18,11.11111111111111,76.41
7793,188760,63,188760,6436,54,9,1.851851851851852,19.93
7794,2975520,4054,0,485257,2487,1567,1.0,0.0
7795,96,19,96,36,12,7,14.285714285714286,72.48
7796,11100,44,11100,1567,39,5,50.0,26.67
7797,744,26,240,69,19,7,6.666666666666667,54.13
7798,688884,2,392088,529476,2,0,20.0,59.11
7799,999648,254,0,11162,134,120,3.8461538461538463,3.0
7800,8316,1,8316,84,1,0,33.333333333333336,22.87
7801,42468,32,0,3158,24,8,50.0,0.0
7802,15024,24,15024,962,22,2,5.2631578947368425,80.27
7803,216,0,216,0,0,0,50.0,59.29
7804,132,32,72,25,21,11,7.6923076923076925,14.23
7805,384,2,384,186,2,0,25.0,73.82
7806,803868,33,803868,1782,28,5,3.703703703703704,15.18
7807,404592,297,0,5319,141,156,4.761904761904762,0.0
7808,2808,44,2808,36,44,0,2.1739130434782608,40.19
7809,2991984,3866,1701780,935248,2286,1580,1.0,0.0
7810,2148,32,1056,605,29,3,3.571428571428572,62.47
7811,2189748,48,0,301122,42,6,100.0,0.0
7812,6948,224,0,227,152,72,100.0,0.0
7813,2472,6,0,878,3,3,33.333333333333336,10.0
7814,2587272,6117,0,86917,3434,2683,1.0,0.0
7815,636,4,636,237,4,0,16.666666666666668,70.03
7816,1059144,17,412752,68822,14,3,6.25,89.08
7817,1284,51,1284,187,47,4,2.5,40.73
7818,2016,31,1728,301,22,9,4.545454545454546,87.69
7819,144960,46,0,11820,39,7,14.285714285714286,0.0
7820,13812,42,0,1356,27,15,100.0,0.0
7821,1164,19,408,193,10,9,20.0,45.8
7822,70068,213,840,998,201,12,1.0,27.66
7823,17316,175,0,1962,120,55,1.6129032258064515,2.0
7824,282012,99,0,6561,40,59,11.11111111111111,0.0
7825,246996,52,0,8154,42,10,33.333333333333336,0.0
7826,312,2,312,0,2,0,25.0,52.58
7827,540324,74,0,21821,32,42,14.285714285714286,0.0
7828,2037132,126,0,25425,56,70,5.882352941176471,5.0
7829,7644,38,7644,48,34,4,2.9411764705882355,0.0
7830,1236,37,1236,518,32,5,3.4482758620689653,72.03
7831,2812020,1407,0,31635,774,633,1.0,0.75
7832,1284,1,1284,960,0,1,50.0,50.5
7833,10800,30,3720,6457,21,9,25.0,0.0
7834,14748,133,0,1637,74,59,100.0,0.0
7835,2544,58,0,427,37,21,3.4482758620689653,0.0
7836,10212,231,10212,823,103,128,2.9411764705882355,19.99
7837,936,14,936,385,11,3,11.11111111111111,81.14
7838,97236,62,97236,2842,52,10,1.639344262295082,0.0
7839,1359660,515,0,32796,288,227,2.083333333333333,0.0
7840,319956,45,0,16622,38,7,100.0,0.0
7841,2037588,766,0,15730,406,360,1.694915254237288,0.0
7842,576,33,576,223,32,1,3.125,62.22
7843,1080,1,1080,156,1,0,100.0,100.0
7844,1068,1,1068,84,1,0,100.0,95.05
7845,13524,24,13524,611,20,4,5.2631578947368425,86.01
7846,129612,12,0,11050,8,4,50.0,0.0
7847,2232,7,456,500,5,2,100.0,0.0
7848,2484876,1289,0,48338,678,611,1.0526315789473684,0.0
7849,130512,56,0,3147,41,15,50.0,0.0
7850,78996,83,78996,2020,70,13,1.4492753623188406,18.27
7851,1704,9,1704,364,9,0,9.090909090909092,67.84
7852,15276,45,15276,138,41,4,2.380952380952381,42.62
7853,1800,42,0,573,34,8,100.0,0.0
7854,612,4,534,345,3,1,20.0,52.72
7855,300,9,300,109,7,2,14.285714285714286,42.22
7856,1308,17,0,624,15,2,100.0,0.0
7857,684,41,684,2,41,0,2.3255813953488373,40.98
7858,15048,67,0,4864,59,8,100.0,0.0
7859,16476,38,0,1531,30,8,100.0,0.0
7860,70164,37,43152,2382,27,10,5.555555555555555,67.83
7861,12276,49,0,1345,32,17,100.0,0.0
7862,188676,65,188676,1722,54,11,1.8867924528301887,43.75
7863,193044,427,108072,6132,303,124,1.1363636363636365,25.67
7864,169740,31,169740,32503,28,3,3.4482758620689653,66.24
7865,5760,24,5760,958,17,7,7.6923076923076925,61.5
7866,117804,55,117804,2433,41,14,2.380952380952381,14.11
7867,1692516,116,0,131468,59,57,10.0,0.0
7868,2478732,40,1511460,55291,35,5,3.571428571428572,82.82
7869,252,19,252,28,13,6,11.11111111111111,68.07
7870,384,2,384,234,2,0,25.0,53.69
7871,21864,44,21864,302,36,8,2.9411764705882355,13.34
7872,1196184,127,0,13666,51,76,11.11111111111111,8.0
7873,3840,44,0,1022,35,9,100.0,0.0
7874,852,30,852,284,29,1,3.571428571428572,63.8
7875,2940252,901,0,16108,495,406,1.0416666666666667,0.0
7876,9108,22,9108,588,19,3,5.555555555555555,85.16
7877,636,1,636,240,1,0,33.333333333333336,67.92
7878,13896,447,0,4597,254,193,100.0,0.0
7879,516,7,516,178,6,1,16.666666666666668,55.42
7880,168,2,0,114,1,1,100.0,0.0
7881,240,0,240,0,0,0,50.0,59.29
7882,696,34,696,302,33,1,2.9411764705882355,59.94
7883,13896,6,0,5616,5,1,100.0,0.0
7884,11328,14,11328,1544,5,9,10.0,0.0
7885,552,7,0,245,5,2,100.0,0.0
7886,177216,36,177216,109037,33,3,3.4482758620689653,93.09
7887,3012720,4649,2763168,265561,2580,2069,1.0,0.0
7888,92868,273,0,23534,193,80,100.0,0.0
7889,2052,34,2052,50,20,14,12.5,63.58
7890,1374216,2872,0,12423,1948,924,1.0,0.0
7891,430056,76,2268,9631,65,11,100.0,0.0
7892,5232,43,0,1088,28,15,100.0,0.0
7893,107796,604,89892,8271,509,95,1.3157894736842106,8.6
7894,37968,40,37968,743,39,1,14.285714285714286,43.06
7895,588,12,588,51,6,6,50.0,72.57
7896,1582692,615,0,48338,321,294,1.9230769230769231,4.54
7897,303252,194,0,4896,93,101,4.3478260869565215,2.38
7898,6252,23,6252,377,19,4,5.882352941176471,86.29
7899,2292,20,2292,810,12,8,10.0,80.4
7900,210840,0,210840,0,0,0,100.0,0.0
7901,108,63,108,33,37,26,3.8461538461538463,58.41
7902,0,0,0,0,0,0,100.0,0.0
7903,75936,64,0,5259,55,9,50.0,0.0
7904,372,63,372,145,53,10,2.083333333333333,44.52
7905,108,69,108,18,59,10,1.7857142857142858,24.48
7906,80508,53,0,3777,40,13,50.0,0.0
7907,2586984,3126,178356,123234,1732,1394,1.0,0.0
7908,6372,31,6372,560,30,1,20.0,33.23
7909,2325408,22,2208,202384,15,7,50.0,0.0
7910,2693184,480,0,53147,262,218,1.5625,1.79
7911,3672,38,3672,754,26,12,12.5,77.6
7912,2828904,1533,0,58169,801,732,1.0869565217391304,1.84
7913,888,7,888,543,5,2,50.0,99.98
7914,1188,3,1188,540,3,0,50.0,99.99
7915,404268,57,0,45167,42,15,2.9411764705882355,0.0
7916,3023076,26510,278153,413471,14934,11576,1.0,0.47
7917,4752,48,4752,737,47,1,12.5,22.31
7918,2031360,53,0,208379,41,12,50.0,0.0
7919,111192,0,111192,0,0,0,50.0,60.1
7920,13812,43,0,1317,28,15,100.0,0.0
7921,14376,49,0,3493,38,11,100.0,0.0
7922,1273452,1240,0,15077,679,561,1.492537313432836,2.38
7923,23640,42,0,8326,38,4,100.0,0.0
7924,420,2,420,36,1,1,50.0,87.76
7925,2736,5,0,1065,4,1,100.0,0.0
7926,3432,40,3432,900,37,3,6.666666666666667,38.98
7927,2947968,563,0,455416,250,313,1.639344262295082,5.0
7928,58812,32,58812,1404,28,4,5.2631578947368425,59.8
7929,8292,241,0,2140,148,93,1.2820512820512822,0.0
7930,61128,41,0,28705,30,11,4.3478260869565215,0.0
7931,109548,272,62238,2387,213,59,1.1363636363636365,8.18
7932,123648,50,3672,13298,46,4,9.090909090909092,31.04
7933,213720,276,20700,1767,151,125,2.083333333333333,73.4
7934,7944,40,0,1210,25,15,100.0,0.0
7935,3096,16,3096,581,16,0,5.882352941176471,42.71
7936,2951976,488,0,573389,291,197,7.142857142857143,2.7
7937,2040,45,0,539,38,7,100.0,0.0
7938,1752,40,1752,639,38,2,11.11111111111111,39.56
7939,94824,99,0,5142,86,13,50.0,0.0
7940,7740,46,0,2142,38,8,100.0,0.0
7941,17424,52,0,4408,43,9,50.0,0.0
7942,132,3,0,112,1,2,50.0,0.0
7943,60732,20,60732,1278,18,2,9.090909090909092,71.02
7944,2088,21,2088,713,20,1,5.2631578947368425,57.76
7945,345660,63,0,35703,47,16,25.0,0.0
7946,11832,35,0,1135,28,7,100.0,0.0
7947,1585692,5,0,948024,4,1,50.0,99.9
7948,39636,25,0,2306,21,4,50.0,0.0
7949,1920,21,1920,862,19,2,5.882352941176471,66.06
7950,3792,39,3792,1283,38,1,2.9411764705882355,20.2
7951,39012,51,0,1448,38,13,50.0,0.0
7952,2524656,549,0,35195,281,268,2.2222222222222223,0.27
7953,39732,49,0,1757,40,9,50.0,0.0
7954,165132,167,165132,17127,105,62,1.96078431372549,31.18
7955,0,0,0,0,0,0,100.0,0.0
7956,240,35,216,27,33,2,3.125,31.81
7957,617412,84,0,43567,60,24,50.0,0.0
7958,156,76,156,38,68,8,1.639344262295082,31.11
7959,41016,48,0,1442,36,12,50.0,0.0
7960,48276,1078,0,7682,686,392,1.0,0.65
7961,3432,39,3432,1396,33,6,4.0,21.14
7962,144,97,144,23,89,8,1.1904761904761905,19.71
7963,684,67,684,51,41,26,3.4482758620689653,55.87
7964,2304,7,2304,156,5,2,20.0,53.53
7965,1476,46,1476,68,38,8,2.7777777777777777,0.0
7966,50148,54,0,2876,45,9,100.0,0.0
7967,11304,47,0,1385,32,15,100.0,0.0
7968,1992,369,1992,1510,351,18,1.0,36.27
7969,3050988,1565,897396,877767,808,757,1.0,0.0
7970,4380,56,4380,1705,45,11,3.4482758620689653,47.5
7971,262656,3,262656,588,3,0,33.333333333333336,13.62
7972,4824,38,4824,46,28,10,3.8461538461538463,58.26
7973,1368,69,0,476,62,7,50.0,0.0
7974,156,3,156,32,1,2,50.0,99.66
7975,772092,42,598314,31237,37,5,4.0,14.72
7976,3168,10,3168,484,9,1,10.0,83.66
7977,6936,41,6936,64,35,6,3.0303030303030303,0.0
7978,639408,35,2508,19460,30,5,4.0,44.43
7979,8448,61,8448,141,46,15,2.5641025641025643,47.79
7980,979380,353,0,10774,190,163,5.0,0.0
7981,30540,0,30540,0,0,0,100.0,100.0
7982,77580,224,0,5532,167,57,100.0,0.0
7983,4104,52,4104,622,34,18,33.333333333333336,78.51
7984,53004,265,0,2693,183,82,1.2345679012345678,3.0
7985,301812,109,0,8936,67,42,4.761904761904762,0.0
7986,1380,5,1380,1192,3,2,25.0,94.39
7987,324,39,324,139,19,20,9.090909090909092,67.74
7988,1032,14,1032,420,12,2,8.333333333333334,51.87
7989,12432,33,2748,1276,28,5,5.0,44.0
7990,33624,145,0,1727,86,59,2.1739130434782608,0.0
7991,2806572,658,0,12899,343,315,1.2987012987012987,0.0
7992,54036,28,54036,429,23,5,4.761904761904762,42.91
7993,261120,144,0,13328,83,61,5.555555555555555,5.0
7994,2956980,4467,0,104009,2443,2024,1.0,0.0
7995,3408,27,3408,1037,24,3,5.2631578947368425,42.63
7996,11688,39,0,1329,26,13,100.0,0.0
7997,61668,44,61668,13981,40,4,25.0,24.96
7998,120,21,120,16,18,3,5.555555555555555,74.97
7999,4092,257,0,1063,122,135,100.0,0.0
8000,108,0,108,0,0,0,50.0,64.0
8001,5988,5,0,1293,4,1,20.0,0.0
8002,68808,0,68808,0,0,0,16.666666666666668,64.15
8003,1992,34,1992,645,31,3,3.333333333333333,67.42
8004,384,33,384,78,29,4,4.3478260869565215,43.69
8005,480,6,480,150,3,3,50.0,45.53
8006,408,31,408,78,30,1,3.225806451612903,49.88
8007,97104,30,97104,1326,26,4,6.666666666666667,36.87
8008,864,21,864,784,21,0,4.3478260869565215,61.91
8009,3037716,1392,663960,795498,842,550,1.0,0.0
8010,144,1,144,0,1,0,33.333333333333336,67.23
8011,2124,118,0,484,70,48,2.4390243902439024,0.0
8012,7644,192,0,1394,151,41,100.0,0.0
8013,468,33,468,73,25,8,5.2631578947368425,53.2
8014,42420,72,192,1323,37,35,6.666666666666667,39.29
8015,82584,19,82584,1227,16,3,8.333333333333334,86.54
8016,48,20,48,7,17,3,6.25,36.29
8017,914340,440,0,7761,240,200,1.639344262295082,0.0
8018,2520,67,180,82,47,20,2.631578947368421,42.27
8019,3049596,1122,0,28589,612,510,1.0869565217391304,0.0
8020,26988,14,26988,1248,13,1,10.0,66.5
8021,26760,260,0,351,145,115,50.0,0.0
8022,1656,7,1656,1482,5,2,16.666666666666668,91.77
8023,2244,77,0,864,51,26,100.0,0.0
8024,25116,28,25116,624,28,0,33.333333333333336,16.82
8025,1944,42,0,614,36,6,100.0,0.0
8026,516,104,516,181,80,24,1.5151515151515151,47.02
8027,165000,86,164508,9857,84,2,1.1904761904761905,0.0
8028,237240,207,0,10381,97,110,4.545454545454546,0.0
8029,1704,6,1704,316,6,0,20.0,7.28
8030,245736,8,0,245350,5,3,50.0,0.0
8031,2031564,838,0,27461,466,372,1.0,5.21
8032,26988,41,0,2716,36,5,100.0,0.0
8033,192,9,192,34,7,2,14.285714285714286,71.23
8034,72,12,72,30,6,6,20.0,50.68
8035,612,21,0,114,16,5,100.0,0.0
8036,4512,136,4512,123,102,34,1.1904761904761905,25.68
8037,2975868,3933,37752,115469,2201,1732,1.0,0.0
8038,21684,47,0,1973,42,5,100.0,0.0
8039,3480,3,3480,1660,2,1,50.0,99.76
8040,108,46,96,33,39,7,2.702702702702702,30.61
8041,168,2,168,6,2,0,25.0,62.97
8042,3007932,984,0,50371,525,459,1.5384615384615383,0.0
8043,1244568,596,0,11246,315,281,1.7857142857142858,0.0
8044,51204,7,0,8197,6,1,50.0,0.0
8045,660,11,660,377,11,0,8.333333333333334,78.48
8046,2773596,53,66852,58414,43,10,2.380952380952381,20.03
8047,384,22,384,41,12,10,25.0,23.29
8048,2268,123,0,489,72,51,100.0,0.0
8049,98880,20,48,7788,17,3,5.882352941176471,38.52
8050,132,8,132,90,5,3,33.333333333333336,0.91
8051,2663088,57,2663088,48069,32,25,7.6923076923076925,45.79
8052,1383540,1937,0,6553,1150,787,1.0,0.0
8053,288,6,288,198,6,0,12.5,87.16
8054,2760,5,2760,518,4,1,25.0,98.51
8055,1065612,165,0,8845,80,85,5.882352941176471,0.0
8056,5772,15,5772,7,15,0,5.882352941176471,40.92
8057,3078468,1958,0,161689,1061,897,1.0,0.0
8058,924,37,0,212,22,15,100.0,0.0
8059,3065856,10442,384468,205716,5718,4724,1.0,0.0
8060,948,10,948,12,10,0,8.333333333333334,47.63
8061,1128,81,1128,166,35,46,7.6923076923076925,88.36
8062,57180,175,0,887,97,78,2.0,0.0
8063,876,13,348,231,8,5,14.285714285714286,0.0
8064,3924,10,0,1286,6,4,100.0,0.0
8065,11004,4,11004,765,3,1,33.333333333333336,93.35
8066,456,8,456,0,8,0,10.0,48.64
8067,516,11,516,41,8,3,12.5,67.74
8068,113664,88,5448,7615,85,3,1.162790697674419,27.74
8069,732,10,432,178,9,1,9.090909090909092,55.07
8070,38412,46,0,2887,37,9,100.0,0.0
8071,21456,2,21456,12624,2,0,12.5,50.87
8072,504,2,504,0,2,0,25.0,55.48
8073,19812,48,0,1407,32,16,100.0,0.0
8074,57696,51,0,5501,43,8,100.0,0.0
8075,521784,65,0,40802,53,12,50.0,0.0
8076,2022252,1175,0,11640,649,526,1.0309278350515465,0.0
8077,101544,13,101544,81654,13,0,7.142857142857143,16.03
8078,840,7,840,346,5,2,20.0,54.49
8079,300,9,300,26,9,0,10.0,39.8
8080,2940,9,2940,432,9,0,33.333333333333336,93.45
8081,612,4,612,258,3,1,33.333333333333336,99.98
8082,5220,17,5220,1324,11,6,16.666666666666668,95.54
8083,15696,60,0,3353,47,13,100.0,0.0
8084,144204,36,0,6959,28,8,50.0,0.0
8085,3636,92,0,1268,71,21,33.333333333333336,0.0
8086,1248,12,396,161,7,5,16.666666666666668,77.64
8087,5364,129,0,807,78,51,100.0,0.0
8088,3384,11,3384,261,9,2,14.285714285714286,69.9
8089,8520,62,0,2048,51,11,100.0,0.0
8090,5088,1,5088,120,1,0,33.333333333333336,90.93
8091,280332,1003,78372,16759,658,345,1.0,37.12
8092,366864,1006,94848,16432,683,323,1.0,26.47
8093,29280,21,29280,674,17,4,7.142857142857143,76.15
8094,20220,4,20220,3,4,0,50.0,0.0
8095,2617476,945,0,10838,531,414,1.1111111111111112,0.0
8096,2700780,1256,0,35419,693,563,1.0,4.43
8097,2439120,1125,0,11773,758,367,1.0,0.0
8098,14064,41,0,1405,26,15,100.0,0.0
8099,37728,11,37728,396,10,1,9.090909090909092,83.33
8100,86604,157,0,5123,119,38,100.0,0.0
8101,2119788,726,0,15367,381,345,2.083333333333333,0.0
8102,113556,32,113556,1262,26,6,4.761904761904762,76.83
8103,15492,9,15492,524,7,2,25.0,92.48
8104,3264,11,1688,1721,9,2,50.0,99.86
8105,288,6,288,212,6,0,14.285714285714286,82.14
8106,62628,13,62628,778,11,2,11.11111111111111,24.34
8107,1500852,479,0,11808,252,227,2.0,0.0
8108,3612,12,0,1746,9,3,33.333333333333336,0.0
8109,163560,32,0,7301,30,2,50.0,0.0
8110,1116,2,1116,678,2,0,20.0,87.32
8111,6744,48,0,1199,34,14,100.0,0.0
8112,33576,32,33576,871,31,1,25.0,16.04
8113,45072,20,45072,397,17,3,6.25,87.11
8114,3099228,295,2133662,1764580,295,0,1.075268817204301,59.57
8115,68148,23,68148,1113,20,3,6.666666666666667,17.53
8116,46596,22,46596,1218,18,4,6.25,85.94
8117,47988,18,47988,1358,17,1,6.25,23.81
8118,69300,40,0,5454,33,7,50.0,0.0
8119,300,3,300,200,3,0,33.333333333333336,99.61
8120,284736,7,0,82877,5,2,33.333333333333336,0.0
8121,1608,2,1608,654,2,0,100.0,100.0
8122,408,2,408,276,2,0,50.0,99.85
8123,3112764,3939,0,344330,2223,1716,1.0,0.0
8124,6288,44,0,1109,29,15,100.0,0.0
8125,74532,51,0,3889,41,10,50.0,0.0
8126,68616,54,0,2184,40,14,50.0,0.0
8127,2791116,61,0,293346,51,10,33.333333333333336,0.0
8128,468,75,468,77,60,15,1.7857142857142858,30.92
8129,684,18,684,158,12,6,16.666666666666668,54.49
8130,75768,46,0,5781,38,8,50.0,0.0
8131,1140,105,1140,110,91,14,1.1904761904761905,30.31
8132,4164,19,4164,696,18,1,9.090909090909092,55.38
8133,8532,43,0,1315,28,15,100.0,0.0
8134,35436,41,0,3185,32,9,50.0,0.0
8135,1740384,78,0,29479,66,12,33.333333333333336,0.0
8136,14100,29,14100,448,28,1,33.333333333333336,16.54
8137,63936,33,63936,1442,29,4,5.2631578947368425,44.28
8138,18144,53,0,3686,44,9,100.0,0.0
8139,2066340,89,0,24235,67,22,33.333333333333336,0.0
8140,2928,29,2928,1128,25,4,5.882352941176471,73.19
8141,5604,50,0,1276,37,13,100.0,0.0
8142,960,9,960,286,9,0,25.0,7.07
8143,5184,32,5184,625,31,1,25.0,36.15
8144,164772,71,0,992,55,16,25.0,0.66
8145,82428,54,0,2884,46,8,50.0,0.0
8146,299292,4,299292,17619,2,2,33.333333333333336,98.08
8147,768,26,768,434,24,2,4.166666666666667,63.78
8148,3756,42,3756,981,41,1,14.285714285714286,11.19
8149,948,4,948,81,4,0,25.0,85.13
8150,516,57,516,251,43,14,2.857142857142857,44.91
8151,951132,10,951132,303,8,2,11.11111111111111,86.94
8152,102864,44,39486,38401,39,5,1.0,13.11
8153,6984,30,6984,1446,25,5,5.0,42.43
8154,16944,30,0,2354,26,4,100.0,0.0
8155,56652,15,56652,691,13,2,10.0,20.2
8156,89472,62,0,6604,45,17,33.333333333333336,0.0
8157,780,8,312,303,7,1,12.5,74.23
8158,10188,55,0,1165,39,16,100.0,0.0
8159,2854140,2522,0,90208,1385,1137,1.0,1.12
8160,32832,21,0,3317,17,4,14.285714285714286,0.0
8161,4716,53,4716,1567,44,9,3.703703703703704,47.6
8162,52788,94,52788,2084,74,20,1.5873015873015872,0.0
8163,130740,128,130740,3732,87,41,2.7777777777777777,11.93
8164,6864,41,6864,983,41,0,14.285714285714286,30.3
8165,3648,11,528,550,10,1,9.090909090909092,72.04
8166,25020,140,0,1225,74,66,5.0,0.0
8167,149784,66,149784,13144,59,7,1.818181818181818,17.58
8168,3372,120,0,740,119,1,50.0,0.0
8169,56436,32,56436,5906,28,4,3.8461538461538463,15.56
8170,2315220,1,2315220,1892208,0,1,100.0,100.0
8171,78312,34,78312,2486,29,5,4.545454545454546,61.29
8172,1260,21,1260,553,16,5,8.333333333333334,67.2
8173,862116,47,571086,26380,39,8,3.4482758620689653,12.27
8174,852,3,852,248,3,0,20.0,93.48
8175,2736,22,2736,682,15,7,8.333333333333334,66.23
8176,792,58,516,45,42,16,2.857142857142857,45.69
8177,223608,491,0,2605,253,238,2.083333333333333,0.0
8178,1908204,1662,24684,29722,925,737,1.0,0.0
8179,228,40,228,38,34,6,2.9411764705882355,39.24
8180,48156,25,48156,875,21,4,6.25,65.34
8181,612,6,612,354,6,0,25.0,91.02
8182,4140,218,0,1678,111,107,2.0408163265306123,0.0
8183,76044,110,0,2465,89,21,100.0,0.0
8184,420,6,420,142,4,2,25.0,68.59
8185,2180628,1345,0,14068,920,425,1.0,0.0
8186,3152628,255,0,1376013,144,111,1.0,0.0
8187,1395492,533,0,3478,351,182,1.0,0.0
8188,344136,10,344136,8646,6,4,33.333333333333336,99.45
8189,504,5,504,273,3,2,50.0,98.38
8190,50988,22,0,9656,18,4,100.0,0.0
8191,756,2,756,420,2,0,50.0,99.01
8192,1404,15,1404,458,9,6,14.285714285714286,94.53
8193,276,4,276,63,4,0,33.333333333333336,96.64
8194,120,1,120,84,1,0,33.333333333333336,0.0
8195,816,3,816,268,3,0,33.333333333333336,99.41
8196,396,6,396,190,6,0,25.0,87.28
8197,528696,5,528696,176395,5,0,14.285714285714286,90.02
8198,11316,19,11316,1334,17,2,6.25,78.48
8199,1769844,550,0,10259,349,201,1.0,0.0
8200,1145628,156,0,27771,62,94,6.25,0.0
8201,624,6,624,394,6,0,20.0,86.51
8202,2760,0,2760,0,0,0,100.0,100.0
8203,77856,7,77856,773,7,0,12.5,73.34
8204,3150684,2230,0,615491,1234,996,1.0,0.8
8205,5352,205,0,1142,154,51,100.0,0.0
8206,45432,50,45432,7815,43,7,14.285714285714286,22.67
8207,3576,0,3576,0,0,0,100.0,100.0
8208,5712,1,5712,1524,1,0,50.0,99.51
8209,3588,150,0,983,87,63,100.0,0.0
8210,360,10,360,44,8,2,12.5,19.16
8211,2964,2,336,1482,1,1,33.333333333333336,0.0
8212,10368,58,1152,770,37,21,4.0,75.5
8213,434304,8,0,113088,8,0,12.5,71.47
8214,189456,198,0,54576,133,65,100.0,0.0
8215,192,18,192,100,15,3,7.142857142857143,54.32
8216,1187856,184,0,31172,93,91,6.25,0.0
8217,1735788,55,0,105090,48,7,50.0,0.0
8218,348,1,348,12,1,0,33.333333333333336,58.52
8219,1776708,585,0,13115,319,266,1.5151515151515151,0.0
8220,44856,53,0,2914,45,8,50.0,0.0
8221,9336,22,9336,1086,19,3,7.142857142857143,53.84
8222,74340,3,74340,15744,3,0,25.0,95.11
8223,413244,6,413244,135376,3,3,50.0,99.99
8224,2270148,3,2270148,481884,3,0,25.0,76.86
8225,3091680,1011,0,46564,525,486,1.1363636363636365,7.89
8226,132,4,132,12,4,0,16.666666666666668,55.2
8227,288,23,288,26,20,3,5.2631578947368425,59.93
8228,2970276,896,1870932,1031194,568,328,1.2658227848101269,0.0
8229,8076,143,0,703,86,57,1.8867924528301887,0.0
8230,29856,49,0,1359,35,14,50.0,0.0
8231,4956,115,4908,4175,101,14,1.098901098901099,27.61
8232,1884,14,1392,656,12,2,100.0,0.0
8233,19764,25,19764,455,20,5,6.25,84.71
8234,134568,56,0,10341,48,8,100.0,0.0
8235,2982708,1614,0,89552,889,725,1.0869565217391304,0.0
8236,85584,3,156,28688,2,1,50.0,99.15
8237,3816,149,0,727,84,65,100.0,0.0
8238,2881488,28,0,1083103,20,8,20.0,0.0
8239,217356,25,217356,6029,13,12,20.0,0.0
8240,54240,42,0,3798,34,8,50.0,0.0
8241,16344,30,16344,864,25,5,5.882352941176471,76.37
8242,13032,21,13032,842,19,2,6.666666666666667,27.89
8243,3127104,3499,0,72721,1954,1545,1.0,0.0
8244,786600,207,0,13361,101,106,5.2631578947368425,2.38
8245,37944,1,37944,0,1,0,33.333333333333336,22.87
8246,63960,10,63960,844,9,1,12.5,78.96
8247,67836,50,0,6499,38,12,50.0,0.0
8248,48468,38,0,4450,33,5,100.0,0.0
8249,5388,0,5388,0,0,0,50.0,98.0
8250,7608,10,7608,538,9,1,16.666666666666668,60.88
8251,30588,43,30588,272,37,6,2.7777777777777777,74.27
8252,54672,73,0,3466,50,23,50.0,0.0
8253,4920,198,0,1388,117,81,100.0,0.0
8254,54984,46,0,3836,43,3,50.0,0.0
8255,1344,11,1344,616,7,4,33.333333333333336,78.33
8256,860484,21,1476,360585,16,5,10.0,94.87
8257,516,56,516,82,46,10,25.0,83.96
8258,20580,32,20580,1273,28,4,5.0,69.33
8259,458016,0,458016,0,0,0,100.0,100.0
8260,8280,153,0,986,97,56,100.0,0.0
8261,1483368,256,856064,96422,256,0,100.0,100.0
8262,47052,52,0,1615,42,10,50.0,0.0
8263,2150064,11,0,485252,5,6,3.703703703703704,0.0
8264,2728800,533,0,23684,272,261,5.555555555555555,0.0
8265,2641680,138,2641680,16169,60,78,6.666666666666667,82.36
8266,2548284,1267,485052,418950,1051,216,1.6129032258064515,94.27
8267,1661772,1,1661772,72,1,0,50.0,99.09
8268,2208,5,2208,364,4,1,12.5,98.64
8269,54816,54,0,2169,39,15,50.0,0.0
8270,32640,77,0,5153,67,10,100.0,0.0
8271,56904,48,0,2059,39,9,50.0,0.0
8272,0,0,0,0,0,0,50.0,0.0
8273,528,13,300,171,9,4,12.5,44.37
8274,3200712,11990,0,1533380,6734,5256,1.0,0.0
8275,27156,18,27156,374,16,2,6.25,87.49
8276,18720,40,0,4533,37,3,50.0,0.0
8277,2331096,2819,1047312,802727,1835,984,1.0,0.0
8278,767340,149,0,26796,73,76,2.5641025641025643,0.0
8279,29712,21,29712,427,18,3,5.882352941176471,83.39
8280,2808,70,0,1161,59,11,50.0,55.8
8281,1896,10,1896,1040,9,1,11.11111111111111,79.33
8282,2014872,56,0,41805,45,11,50.0,0.0
8283,3089580,4184,0,149976,2342,1842,1.0,1.06
8284,4752,33,4752,1122,29,4,4.545454545454546,55.99
8285,396,6,396,280,5,1,16.666666666666668,83.84
8286,456,76,456,73,70,6,1.408450704225352,45.34
8287,756,3,756,572,3,0,25.0,90.03
8288,17412,43,0,1598,28,15,100.0,0.0
8289,29400,42,0,4349,28,14,50.0,0.0
8290,828,6,828,404,5,1,20.0,93.09
8291,744,4,744,81,4,0,25.0,73.86
8292,30288,43,0,4524,39,4,50.0,0.0
8293,71064,50,0,3426,39,11,25.0,0.0
8294,34428,1,34428,72,1,0,100.0,100.0
8295,3072,13,3072,1192,12,1,14.285714285714286,57.85
8296,408,4,408,66,3,1,33.333333333333336,99.68
8297,3207588,1040,546180,749874,487,553,1.0,0.0
8298,71244,40,71244,978,39,1,20.0,31.13
8299,417768,111,0,5102,83,28,33.333333333333336,0.0
8300,28728,48,0,1276,36,12,50.0,0.0
8301,1740084,266,0,44552,155,111,4.3478260869565215,0.0
8302,17748,46,0,5482,38,8,100.0,0.0
8303,20184,49,0,1090,33,16,50.0,0.0
8304,2136,46,0,641,36,10,100.0,0.0
8305,386124,49,0,9132,40,9,25.0,0.0
8306,43368,26,43368,1344,24,2,6.25,70.72
8307,3408,10,3408,738,5,5,16.666666666666668,72.57
8308,6492,60,6492,643,56,4,11.11111111111111,32.99
8309,6864,49,6864,2063,40,9,4.0,40.71
8310,672,7,672,421,5,2,20.0,96.53
8311,564,3,564,208,2,1,100.0,0.1
8312,0,0,0,0,0,0,100.0,0.0
8313,708,3,708,180,2,1,33.333333333333336,91.75
8314,77124,9,77124,74845,9,0,50.0,99.97
8315,63204,241,0,2393,177,64,100.0,0.0
8316,372,4,372,219,3,1,25.0,44.15
8317,43656,26,0,3164,18,8,100.0,0.0
8318,636,2,636,138,1,1,50.0,99.98
8319,13524,16,13524,874,13,3,12.5,73.49
8320,943356,87,588570,29660,67,20,2.4390243902439024,11.67
8321,191940,36,0,42029,30,6,4.3478260869565215,0.0
8322,360,2,360,144,1,1,50.0,99.98
8323,512508,175,339657,196741,146,29,33.333333333333336,99.93
8324,512604,82,0,47747,38,44,16.666666666666668,0.0
8325,84240,16,84240,1812,14,2,8.333333333333334,98.47
8326,9948,55,8148,2168,44,11,4.761904761904762,61.3
8327,3229344,7177,0,826944,4103,3074,1.0,0.0
8328,624,3,624,288,2,1,50.0,99.93
8329,828,7,828,228,6,1,14.285714285714286,29.98
8330,83040,43,83040,27,37,6,2.7777777777777777,13.28
8331,85536,29,85536,5071,24,5,5.882352941176471,76.76
8332,2748,11,0,591,8,3,100.0,0.0
8333,1416,102,0,426,84,18,100.0,0.0
8334,888,1,888,0,1,0,33.333333333333336,51.38
8335,353844,28,0,25538,20,8,16.666666666666668,15.29
8336,528,32,528,132,28,4,4.3478260869565215,52.92
8337,2966688,1874,0,82935,1068,806,1.0,0.0
8338,98052,80,98052,1376,42,38,33.333333333333336,77.92
8339,276,15,276,126,13,2,7.6923076923076925,22.23
8340,216,64,216,49,33,31,5.555555555555555,63.1
8341,1356,33,1356,125,29,4,3.4482758620689653,53.46
8342,312,37,312,84,35,2,2.5641025641025643,25.03
8343,3226308,136,2177878,1651403,78,58,1.0,0.0
8344,888,0,888,0,0,0,100.0,100.0
8345,816,103,816,202,50,53,4.166666666666667,77.14
8346,48,27,48,11,22,5,5.2631578947368425,42.79
8347,408,1,408,96,1,0,33.333333333333336,78.45
8348,120,0,120,0,0,0,50.0,49.0
8349,3001716,268,0,204135,101,167,4.3478260869565215,0.0
8350,9888,123,0,845,74,49,100.0,0.0
8351,369396,94,369396,9981,75,19,1.6666666666666667,38.58
8352,2757936,81,2757936,29891,33,48,9.090909090909092,90.49
8353,26784,9,23796,4270,6,3,25.0,92.41
8354,2544,1,0,432,1,0,25.0,0.0
8355,45132,23,45132,1608,20,3,5.882352941176471,81.61
8356,11616,20,11616,787,19,1,5.882352941176471,70.57
8357,12948,29,12948,1141,25,4,5.2631578947368425,69.25
8358,65436,22,65436,1269,19,3,6.25,81.51
8359,5148,238,0,1306,186,52,100.0,0.0
8360,51108,12,51108,1445,12,0,7.142857142857143,7.62
8361,144,80,144,17,60,20,1.9230769230769231,42.08
8362,1695648,125,0,178060,52,73,7.6923076923076925,0.0
8363,1736868,4,58296,434409,3,1,20.0,53.63
8364,769596,150,0,16382,88,62,1.5873015873015872,3.55
8365,9912,109,9912,63,81,28,1.492537313432836,33.24
8366,2796228,529,0,243636,275,254,2.2222222222222223,2.0
8367,60,23,60,13,18,5,6.666666666666667,37.2
8368,7632,84,7632,6329,82,2,1.2048192771084338,21.2
8369,8952,19,8952,1630,16,3,7.6923076923076925,88.12
8370,55308,1,55308,900,1,0,33.333333333333336,92.39
8371,55896,2,55896,1218,1,1,100.0,99.95
8372,155124,39,0,26767,33,6,100.0,0.0
8373,2525016,4,2525016,321,2,2,100.0,100.0
8374,216,8,216,24,7,1,12.5,88.24
8375,432,2,432,222,2,0,25.0,48.35
8376,56976,70,56976,3866,55,15,1.8867924528301887,19.59
8377,1380,2,1380,270,2,0,25.0,94.8
8378,720,3,720,252,2,1,25.0,53.53
8379,98172,10,98172,594,7,3,14.285714285714286,46.2
8380,867240,1015,0,6388,737,278,1.0,0.0
8381,3996,13,0,1009,6,7,25.0,0.0
8382,492,3,492,280,3,0,25.0,65.29
8383,348,3,348,40,2,1,25.0,51.72
8384,10392,31,10392,10332,13,18,16.666666666666668,79.42
8385,3086736,1228,0,1060484,644,584,1.492537313432836,0.0
8386,28776,4,0,8406,2,2,50.0,0.0
8387,2181588,681,0,38423,360,321,2.083333333333333,1.98
8388,396,5,396,300,5,0,14.285714285714286,77.21
8389,3202836,412,0,19156,211,201,2.0408163265306123,0.0
8390,480,49,264,64,26,23,6.666666666666667,38.7
8391,95064,1,95064,33732,1,0,33.333333333333336,66.96
8392,3103344,40,0,750566,38,2,12.5,0.81
8393,204168,117,204168,56929,112,5,12.5,99.88
8394,2556,4,2556,2307,3,1,25.0,70.78
8395,523152,3,523152,24456,3,0,33.333333333333336,99.98
8396,528,82,528,85,64,18,1.7543859649122806,54.03
8397,684,6,684,290,4,2,16.666666666666668,88.06
8398,516,33,516,257,31,2,3.125,59.15
8399,624,2,624,240,1,1,33.333333333333336,75.46
8400,50916,49,0,2146,40,9,50.0,0.0
8401,115872,5,60318,43804,2,3,50.0,99.96
8402,360,29,360,189,25,4,6.25,51.08
8403,1764,128,0,283,50,78,8.333333333333334,0.0
8404,3209292,1196,0,390629,595,601,1.2658227848101269,0.0
8405,2447292,1147,0,5316,684,463,1.0,0.0
8406,32052,23,32052,770,20,3,5.882352941176471,73.46
8407,108,0,108,0,0,0,100.0,100.0
8408,65916,47,0,4639,38,9,100.0,0.0
8409,600,17,600,205,13,4,7.6923076923076925,79.21
8410,170040,150,0,7448,121,29,100.0,0.0
8411,3828,14,3828,410,10,4,11.11111111111111,55.58
8412,108,13,108,15,9,4,14.285714285714286,61.5
8413,1107216,88,828,12650,77,11,1.408450704225352,42.61
8414,1518576,88,0,37494,75,13,50.0,0.0
8415,1320,0,1320,0,0,0,20.0,94.5
8416,678084,17,678084,98961,16,1,9.090909090909092,57.61
8417,840,5,840,216,5,0,10.0,88.32
8418,98664,51,0,6210,44,7,50.0,0.0
8419,30012,60,0,2143,51,9,100.0,0.0
8420,39720,23,39720,729,20,3,5.2631578947368425,72.24
8421,103740,44,103740,3121,41,3,2.5,28.6
8422,156,1,156,48,1,0,33.333333333333336,58.71
8423,24672,22,12900,1708,18,4,5.882352941176471,87.64
8424,1541100,1506,0,7025,928,578,1.0,0.0
8425,3223752,430,0,31857,219,211,2.702702702702702,0.0
8426,411612,0,411612,0,0,0,50.0,65.8
8427,768,88,768,20,58,30,2.2222222222222223,11.8
8428,300,0,300,0,0,0,50.0,59.29
8429,33396,34,33396,1027,33,1,33.333333333333336,25.33
8430,3273492,40,0,936786,31,9,50.0,67.01
8431,1897836,400,0,21863,212,188,2.2222222222222223,3.96
8432,60,2,60,0,2,0,25.0,61.88
8433,0,0,0,0,0,0,1.0,0.0
8434,6876,18,6876,365,16,2,6.25,86.86
8435,288,8,288,15,6,2,16.666666666666668,48.85
8436,104772,34,0,10344,27,7,50.0,0.0
8437,828,19,828,337,16,3,5.882352941176471,66.34
8438,87204,36,0,7961,32,4,50.0,0.0
8439,2376,7,0,737,5,2,100.0,0.0
8440,3273636,2254,0,296854,1259,995,1.020408163265306,0.0
8441,44520,18,44520,799,15,3,8.333333333333334,73.67
8442,66516,52,0,2242,38,14,50.0,0.0
8443,84,7,84,12,5,2,20.0,53.47
8444,2663520,216,0,17125,120,96,4.545454545454546,0.0
8445,2790300,96,3360,784373,62,34,50.0,71.9
8446,3233976,1858,0,301787,1029,829,1.0,0.0
8447,540756,108,0,104058,97,11,33.333333333333336,0.0
8448,111228,47,0,5061,33,14,50.0,0.0
8449,3278268,6113,103362,472615,3374,2739,1.0,0.0
8450,949512,572,0,13870,304,268,1.408450704225352,2.1
8451,1929636,59,0,102740,48,11,25.0,0.0
8452,1404,13,0,551,10,3,100.0,0.0
8453,20640,53,0,3700,43,10,100.0,0.0
8454,588,5,588,180,5,0,20.0,96.9
8455,2572068,148,0,996310,71,77,1.4492753623188406,4.68
8456,2684784,28,2684784,7541,14,14,25.0,0.0
8457,77700,48,0,2316,38,10,50.0,0.0
8458,11124,27,11124,1089,23,4,9.090909090909092,70.02
8459,1104,3,0,548,2,1,100.0,0.0
8460,216,53,216,64,41,12,3.0303030303030303,35.11
8461,2640,8,2640,421,6,2,16.666666666666668,38.21
8462,80568,48,0,2357,35,13,50.0,0.0
8463,16512,42,16512,1134,41,1,50.0,16.75
8464,168,1,168,0,1,0,33.333333333333336,86.0
8465,2568,74,0,888,56,18,100.0,0.0
8466,2966136,434,0,29977,242,192,2.702702702702702,0.0
8467,230676,9,0,27029,6,3,50.0,99.0
8468,30516,51,0,1368,40,11,50.0,0.0
8469,1188,0,1188,0,0,0,100.0,100.0
8470,2808852,81,0,268539,66,15,7.142857142857143,0.0
8471,1284,36,0,438,30,6,100.0,0.0
8472,228,20,228,78,18,2,5.555555555555555,42.12
8473,16872,52,0,1150,42,10,50.0,0.0
8474,956352,52,768870,55299,46,6,2.7777777777777777,12.69
8475,28908,15,0,2128,14,1,50.0,0.0
8476,173904,5,0,137906,3,2,20.0,38.98
8477,75672,23,75672,1087,20,3,7.142857142857143,77.63
8478,1408392,168,0,29132,150,18,33.333333333333336,0.0
8479,1428,35,1428,713,20,15,14.285714285714286,84.0
8480,2533920,35,10356,138982,28,7,6.25,72.17
8481,2733672,52,0,191105,41,11,33.333333333333336,0.0
8482,7896,34,7896,726,33,1,100.0,30.06
8483,372,25,372,141,14,11,9.090909090909092,58.92
8484,34668,190,0,1797,113,77,100.0,0.0
8485,42612,47,0,3174,40,7,100.0,0.0
8486,62520,0,62520,0,0,0,100.0,100.0
8487,2682048,258,2682048,40223,123,135,3.4482758620689653,73.39
8488,1056,111,0,619,40,71,33.333333333333336,0.0
8489,3792,103,0,723,72,31,2.4390243902439024,0.0
8490,31032,67,31032,54,47,20,2.5641025641025643,45.52
8491,528,18,516,93,16,2,5.882352941176471,46.76
8492,1633704,880,0,26707,483,397,1.2195121951219512,0.0
8493,72204,27,72204,946,24,3,5.555555555555555,67.78
8494,251220,36,1572,7323,35,1,2.702702702702702,40.16
8495,10620,184,0,1911,116,68,1.3888888888888888,0.0
8496,2144760,146,0,16003,82,64,4.761904761904762,0.0
8497,170268,0,170268,0,0,0,100.0,100.0
8498,166740,24,31620,15304,18,6,7.6923076923076925,0.82
8499,3792,72,0,315,47,25,100.0,0.0
8500,900,32,900,282,25,7,4.0,14.87
8501,3317532,17079,1078281,864673,9735,7344,1.0,0.0
8502,85536,25,83964,4537,21,4,6.666666666666667,76.69
8503,504,2,0,462,2,0,25.0,89.87
8504,7644,9,7644,7232,9,0,10.0,73.84
8505,3318912,6645,0,606480,3595,3050,1.0,0.0
8506,69024,250,0,2778,189,61,100.0,0.0
8507,9948,38,7536,1399,37,1,16.666666666666668,39.82
8508,648,23,648,276,19,4,4.761904761904762,43.81
8509,156,16,156,34,12,4,7.6923076923076925,50.28
8510,132,13,132,16,11,2,9.090909090909092,22.63
8511,172332,95,172332,3817,88,7,1.1904761904761905,15.84
8512,910788,61,0,204384,32,29,1.694915254237288,4.13
8513,36720,85,36720,130,55,30,2.3255813953488373,44.43
8514,137244,0,137244,0,0,0,33.333333333333336,80.0
8515,252,32,252,42,32,0,2.857142857142857,19.47
8516,1849920,10,1849920,414968,10,0,9.090909090909092,89.92
8517,77592,59,77592,2975,51,8,3.4482758620689653,72.29
8518,3323376,18712,964686,841798,10617,8095,1.0,0.0
8519,1671324,273,0,95979,138,135,4.761904761904762,0.0
8520,84,19,84,12,14,5,9.090909090909092,62.04
8521,2784,7,2784,425,7,0,12.5,93.05
8522,69096,5,69096,13941,3,2,33.333333333333336,73.8
8523,3320304,3408,918240,1092166,2135,1273,1.0,0.0
8524,876,34,876,473,34,0,2.7777777777777777,61.4
8525,7212,0,4764,0,0,0,100.0,100.0
8526,3516,1,3516,528,1,0,50.0,99.18
8527,3708,18,3708,1102,18,0,6.25,26.61
8528,4356,9,4356,2345,5,4,100.0,100.0
8529,60,1,60,12,1,0,50.0,98.37
8530,5772,248,0,1392,181,67,100.0,0.0
8531,8496,37,8496,759,37,0,100.0,30.18
8532,104916,20,16932,6822,16,4,8.333333333333334,72.03
8533,835548,14,835548,2108,14,0,11.11111111111111,99.85
8534,4836,14,0,2388,13,1,7.142857142857143,0.0
8535,948,7,948,860,5,2,12.5,84.25
8536,719760,2,264,359940,2,0,50.0,0.0
8537,2100,17,2100,1992,15,2,6.25,66.73
8538,3325668,3939,659136,752320,2168,1771,1.0,0.0
8539,540,30,540,82,30,0,3.703703703703704,41.72
8540,7428,13,7428,2700,13,0,6.25,56.72
8541,3172980,1772,0,11833,1318,454,1.0,0.0
8542,540,0,540,0,0,0,50.0,96.25
8543,7716,6,7716,7624,4,2,14.285714285714286,84.09
8544,1010796,614,0,13664,312,302,2.2222222222222223,0.0
8545,920580,171,2916,6340,108,63,1.7241379310344829,28.93
8546,7320,60,7320,192,58,2,1.851851851851852,69.6
8547,11724,0,11724,0,0,0,100.0,100.0
8548,240,29,96,25,25,4,4.3478260869565215,57.42
8549,672,6,672,90,6,0,14.285714285714286,58.1
8550,2316,51,2316,1482,50,1,1.96078431372549,27.11
8551,261324,100,261324,8658,85,15,2.702702702702702,42.47
8552,3159528,503,0,25225,231,272,2.3255813953488373,3.0
8553,47544,35,47544,1716,34,1,2.857142857142857,15.45
8554,1608,12,1608,1033,9,3,9.090909090909092,95.13
8555,212844,194,194352,56345,194,0,1.0,21.93
8556,5004,5,5004,2107,5,0,20.0,98.49
8557,11196,35,11196,1886,35,0,2.7777777777777777,83.4
8558,1863804,397,0,130218,230,167,3.4482758620689653,0.0
8559,23988,24,0,1492,20,4,50.0,0.0
8560,816,0,816,0,0,0,50.0,59.29
8561,2057856,57,0,95327,46,11,50.0,0.0
8562,996840,27,50292,36934,27,0,3.571428571428572,53.09
8563,2722392,289,0,534684,166,123,5.2631578947368425,0.0
8564,912,1,912,288,1,0,33.333333333333336,89.71
8565,2856960,505,0,76466,221,284,2.702702702702702,0.0
8566,1803288,4,1803288,57696,3,1,100.0,100.0
8567,216,18,216,18,17,1,5.555555555555555,47.05
8568,61512,84,61512,2618,69,15,1.5625,12.36
8569,2150376,1150,0,7842,849,301,1.0,0.0
8570,12,4,0,3,4,0,50.0,0.0
8571,224664,94,0,28990,59,35,3.125,0.0
8572,276,1,276,0,1,0,33.333333333333336,54.27
8573,1788,12,1788,28,6,6,50.0,58.0
8574,59700,22,59700,1028,19,3,6.25,84.1
8575,96,13,96,24,12,1,7.6923076923076925,39.13
8576,1180524,60,0,285471,57,3,50.0,0.0
8577,1260,7,1260,752,7,0,9.090909090909092,70.4
8578,4248,106,0,909,59,47,100.0,0.0
8579,39852,133,0,16741,104,29,50.0,0.0
8580,72,2,72,24,1,1,50.0,75.37
8581,433320,1,1272,433320,1,0,50.0,96.25
8582,4896,242,0,1337,192,50,100.0,0.0
8583,61008,52,61008,12583,52,0,2.127659574468085,17.28
8584,75288,2,75288,4638,2,0,25.0,91.25
8585,2104704,687,0,24655,330,357,2.083333333333333,0.0
8586,1164,32,1164,558,30,2,3.333333333333333,68.63
8587,12540,88,1932,289,88,0,1.098901098901099,11.48
8588,432,1,432,276,1,0,25.0,51.8
8589,191820,266,96156,58992,266,0,1.0,78.73
8590,669552,8,16968,86322,8,0,12.5,78.74
8591,384,4,384,135,2,2,50.0,58.59
8592,252,118,252,73,53,65,4.761904761904762,20.35
8593,32160,28,32160,10153,14,14,1.0,0.0
8594,1824,0,1824,0,0,0,50.0,98.0
8595,7212,25,7212,609,21,4,5.2631578947368425,85.19
8596,432,51,432,166,43,8,2.4390243902439024,17.07
8597,1716,54,0,112,45,9,100.0,0.0
8598,3316584,998,0,362117,562,436,1.0,0.0
8599,2455728,431,0,27250,219,212,2.7777777777777777,0.0
8600,816,1,816,684,1,0,50.0,96.91
8601,90108,30,132,3034,25,5,4.761904761904762,38.25
8602,6048,17,96,372,12,5,10.0,57.29
8603,243912,61,243912,2739,51,10,1.9230769230769231,25.93
8604,172404,6,172404,31114,6,0,12.5,17.17
8605,468,5,468,0,5,0,14.285714285714286,49.09
8606,6120,113,6120,4857,89,24,1.25,30.77
8607,246852,3,20004,108644,2,1,50.0,0.0
8608,384,19,384,72,19,0,4.761904761904762,45.49
8609,120,2,120,30,1,1,50.0,79.02
8610,6312,21,6312,2208,16,5,14.285714285714286,95.96
8611,1632,3,0,760,3,0,20.0,0.0
8612,1965744,263,0,29919,126,137,3.333333333333333,0.0
8613,1440,30,1440,300,28,2,3.703703703703704,61.85
8614,240,27,228,72,17,10,9.090909090909092,49.06
8615,15120,12,15120,806,11,1,9.090909090909092,73.82
8616,1915872,1224,0,7787,878,346,1.0,0.0
8617,924,6,924,326,6,0,20.0,88.67
8618,672,45,672,322,36,9,3.333333333333333,74.76
8619,3267456,11,0,1219716,10,1,10.0,0.0
8620,396,15,396,164,14,1,7.142857142857143,55.16
8621,1707240,50,0,35735,38,12,25.0,0.0
8622,23988,29,23988,828,26,3,4.3478260869565215,69.78
8623,507948,204,14676,17040,156,48,1.0,40.95
8624,1966476,166,1400376,26946,77,89,5.2631578947368425,88.98
8625,76692,0,76692,0,0,0,50.0,47.28
8626,38832,58,0,2486,48,10,100.0,0.0
8627,1200,0,1200,0,0,0,50.0,88.0
8628,275604,131,0,78632,63,68,10.0,0.0
8629,66696,50,0,5523,39,11,25.0,0.0
8630,2825616,1019,0,12980,579,440,1.075268817204301,2.0
8631,576,10,576,94,10,0,8.333333333333334,78.07
8632,4020,162,0,641,105,57,1.7857142857142858,0.0
8633,3121644,420,0,24295,242,178,1.851851851851852,0.0
8634,24960,6,0,12744,2,4,100.0,0.0
8635,21972,4,21972,543,3,1,33.333333333333336,95.38
8636,1902708,108,1902708,36697,90,18,1.2048192771084338,10.0
8637,540,29,540,118,29,0,4.0,80.18
8638,468,7,468,248,5,2,20.0,60.27
8639,27300,15,27300,1048,13,2,9.090909090909092,87.42
8640,2868,3,228,1244,1,2,33.333333333333336,0.0
8641,216,2,216,138,2,0,25.0,78.27
8642,30192,23,30192,22157,22,1,5.2631578947368425,45.77
8643,2580420,1155,0,27796,630,525,1.2345679012345678,2.0
8644,3094236,227,0,332726,127,100,3.0303030303030303,0.0
8645,1266756,780,0,5685,428,352,1.2195121951219512,0.0
8646,5748,17,792,1485,14,3,6.666666666666667,71.28
8647,804,39,804,352,32,7,3.703703703703704,66.5
8648,720,121,0,71,110,11,1.0,0.0
8649,2764812,269,2764812,13501,179,90,8.333333333333334,22.41
8650,254568,298,0,3244,153,145,2.857142857142857,4.0
8651,108,6,108,14,6,0,12.5,54.92
8652,2049876,1750,0,18598,941,809,1.0,2.0
8653,14784,65,14784,77,51,14,2.1739130434782608,42.44
8654,1714800,391,0,19228,191,200,2.380952380952381,0.0
8655,1836,2,1836,702,2,0,33.333333333333336,12.41
8656,3343476,312,0,1121055,19,293,6.25,0.0
8657,264,34,180,34,26,8,4.761904761904762,57.96
8658,711384,65,0,87757,51,14,20.0,0.0
8659,6240,82,0,1668,66,16,33.333333333333336,0.0
8660,7548,53,0,1911,43,10,100.0,0.0
8661,108312,21,108312,134,11,10,33.333333333333336,57.82
8662,21444,81,21444,132,69,12,1.5625,29.42
8663,1044,31,1044,470,24,7,5.2631578947368425,54.53
8664,48996,48,0,1721,35,13,50.0,0.0
8665,511080,25,14064,21429,23,2,5.2631578947368425,83.0
8666,2584728,617,0,8863,441,176,1.0,0.0
8667,3114012,3241,0,71252,1815,1426,1.0,0.0
8668,22152,32,22152,1461,31,1,3.125,27.91
8669,117132,6,0,23490,4,2,25.0,0.0
8670,828,4,828,342,3,1,50.0,99.94
8671,3034692,65,0,554132,52,13,50.0,0.0
8672,16476,17,216,1005,13,4,8.333333333333334,52.15
8673,2318268,354,1372212,785332,166,188,2.5,0.0
8674,120,16,120,20,9,7,25.0,71.4
8675,1149288,11,0,500979,5,6,20.0,0.0
8676,7560,20,7560,449,19,1,5.2631578947368425,84.25
8677,2364,7,2364,973,7,0,25.0,97.31
8678,2840424,1281,0,9151,712,569,1.0,0.0
8679,180,40,180,27,33,7,3.4482758620689653,36.97
8680,2684208,52,0,108459,34,18,25.0,0.0
8681,2593188,1099,0,360582,454,645,2.083333333333333,0.0
8682,67416,84,0,5060,67,17,50.0,0.0
8683,21228,27,21228,1201,24,3,7.142857142857143,74.75
8684,372,45,372,88,34,11,3.703703703703704,14.59
8685,192,1,192,12,1,0,33.333333333333336,80.59
8686,384,3,384,228,3,0,20.0,84.52
8687,4008,38,4008,683,30,8,4.545454545454546,66.34
8688,3358428,401,0,1518142,394,7,1.0,0.0
8689,2172,15,2172,1576,15,0,5.2631578947368425,52.3
8690,3259908,4533,7296,24314,2540,1993,1.0,0.0
8691,3282408,41,0,1458599,23,18,1.0,0.0
8692,2628336,69,0,78356,58,11,50.0,0.0
8693,96456,13,240,14950,5,8,33.333333333333336,88.64
8694,216,2,216,42,2,0,25.0,57.95
8695,324,69,216,107,52,17,2.2222222222222223,34.58
8696,3351744,1265,5688,18250,702,563,1.0,1.28
8697,804708,563,444900,22905,439,124,1.2658227848101269,14.32
8698,54984,15,0,5194,11,4,100.0,0.0
8699,76968,53,0,7645,47,6,50.0,0.0
8700,719256,552,407370,16910,438,114,1.492537313432836,2.25
8701,64644,69,0,6443,60,9,100.0,0.0
8702,30228,54,0,1277,42,12,50.0,0.0
8703,80748,44,0,9328,32,12,50.0,0.0
8704,3226764,50,0,69603,41,9,25.0,0.0
8705,74916,46,0,13464,40,6,100.0,0.0
8706,3203448,3614,0,85841,1970,1644,1.0,0.0
8707,2174772,17,33192,244500,13,4,12.5,85.63
8708,66732,21,84,3202,17,4,6.25,46.4
8709,10596,64,0,2481,50,14,100.0,0.0
8710,2491668,63,0,227360,49,14,33.333333333333336,0.0
8711,128016,17,128016,1262,14,3,11.11111111111111,75.55
8712,3612,55,3612,363,47,8,8.333333333333334,63.87
8713,333984,47,0,15965,39,8,50.0,0.0
8714,216,0,216,0,0,0,50.0,61.73
8715,96,2,96,30,1,1,50.0,58.66
8716,104712,80,2148,8022,66,14,100.0,0.0
8717,552,6,552,296,6,0,12.5,79.63
8718,386352,76,0,30105,50,26,5.0,0.0
8719,30408,48,0,1324,38,10,50.0,0.0
8720,564,92,564,129,82,10,1.36986301369863,26.28
8721,1684452,2514,12984,20230,1317,1197,1.0,0.0
8722,31812,48,0,1423,36,12,50.0,0.0
8723,29292,56,29292,3424,53,3,2.0,27.99
8724,28092,44,0,4914,38,6,50.0,0.0
8725,14016,405,0,3580,278,127,25.0,0.0
8726,402888,50,0,12083,39,11,33.333333333333336,0.0
8727,64728,32,64728,759,31,1,12.5,38.98
8728,170592,11,170592,30725,8,3,50.0,99.85
8729,29916,77,0,5872,50,27,50.0,0.0
8730,49644,27,3612,2634,23,4,5.882352941176471,70.18
8731,1918056,47,0,41722,36,11,25.0,0.0
8732,96360,46,0,3650,39,7,33.333333333333336,0.0
8733,3996,19,3996,927,15,4,11.11111111111111,47.99
8734,2538168,502,0,43831,288,214,2.3255813953488373,0.0
8735,1111476,125,809754,97568,110,15,1.5151515151515151,5.33
8736,26364,20,0,2095,19,1,50.0,0.0
8737,4812,29,4812,29,25,4,4.3478260869565215,58.82
8738,40836,61,0,3417,51,10,50.0,0.0
8739,994776,34,994776,3447,20,14,11.11111111111111,0.0
8740,24600,228,0,1636,108,120,100.0,0.0
8741,17172,47,0,1180,35,12,50.0,0.0
8742,0,0,0,0,0,0,100.0,0.0
8743,4284,17,4284,742,14,3,10.0,72.78
8744,1344516,32,51108,43908,25,7,5.555555555555555,69.39
8745,34524,45,34524,36,35,10,3.125,14.9
8746,504,65,504,254,37,28,4.545454545454546,82.96
8747,3135048,1187,0,72608,688,499,1.1494252873563218,0.0
8748,28944,48,28944,1581,25,23,25.0,94.69
8749,10380,33,10380,757,32,1,25.0,31.17
8750,2760,32,2760,966,27,5,5.0,69.55
8751,1872684,4,1872684,219,4,0,20.0,99.54
8752,1375392,18,0,108328,14,4,5.0,0.0
8753,23364,16,23364,545,15,1,9.090909090909092,36.78
8754,40548,30,40548,1372,25,5,7.142857142857143,67.01
8755,8928,267,0,1937,139,128,1.4492753623188406,0.0
8756,996768,286,0,13077,150,136,5.555555555555555,0.0
8757,177720,17,300,10687,12,5,16.666666666666668,99.76
8758,1176,1,1176,384,1,0,33.333333333333336,92.54
8759,6984,33,0,880,29,4,50.0,0.0
8760,1337376,3,1337376,3140,2,1,100.0,0.0
8761,131136,182,0,10870,137,45,100.0,0.0
8762,4836,27,4836,855,21,6,6.666666666666667,37.72
8763,28932,91,28932,4472,71,20,2.272727272727273,64.04
8764,6372,47,6372,1436,46,1,25.0,19.57
8765,432,45,432,104,36,9,4.0,1.59
8766,69336,286,0,3388,231,55,100.0,0.0
8767,3402516,1343,0,19902,940,403,1.0,0.0
8768,6024,28,6024,1107,24,4,5.882352941176471,68.84
8769,636,8,636,457,8,0,10.0,85.35
8770,74088,78,74088,3582,65,13,1.7241379310344829,28.02
8771,221208,18,221208,3182,17,1,5.2631578947368425,65.17
8772,95832,22,95832,783,19,3,6.25,77.68
8773,282420,218,0,10936,125,93,3.8461538461538463,0.0
8774,6384,7,6384,205,6,1,14.285714285714286,92.9
8775,2886300,1573,0,34489,668,905,1.0,0.0
8776,7764,25,7764,763,22,3,5.0,60.86
8777,324,75,324,104,43,32,3.703703703703704,64.09
8778,228,0,228,0,0,0,50.0,80.0
8779,1116,1,1116,252,1,0,100.0,0.0
8780,3275136,221,0,109034,91,130,7.6923076923076925,5.0
8781,11088,32,11088,1252,28,4,5.882352941176471,59.76
8782,33420,48,0,7531,42,6,50.0,97.94
8783,181848,11,0,177180,11,0,33.333333333333336,0.0
8784,1402260,19,1402260,6534,18,1,5.882352941176471,7.62
8785,480,5,480,81,3,2,100.0,0.0
8786,99300,41,99300,3135,33,8,4.761904761904762,72.36
8787,156,34,156,23,23,11,7.6923076923076925,65.26
8788,1005144,15,0,69166,14,1,50.0,0.0
8789,3400944,309,2826732,1815360,309,0,100.0,99.98
8790,636,1,636,504,1,0,33.333333333333336,99.0
8791,336,10,336,162,7,3,33.333333333333336,98.52
8792,30480,7,30480,476,6,1,16.666666666666668,83.07
8793,2340,83,2340,1632,61,22,1.7543859649122806,25.24
8794,3108,23,3108,933,21,2,6.25,55.56
8795,420,8,300,204,7,1,12.5,85.56
8796,8520,47,8520,2037,39,8,4.545454545454546,68.1
8797,3408,49,1272,749,39,10,3.333333333333333,62.16
8798,1032,14,1032,326,8,6,100.0,0.0
8799,2232,7,516,466,5,2,16.666666666666668,93.67
8800,682536,80,0,15340,45,35,14.285714285714286,0.0
8801,720,32,720,47,29,3,3.571428571428572,52.11
8802,192,10,192,13,10,0,9.090909090909092,80.57
8803,8484,21,8484,762,18,3,7.6923076923076925,60.92
8804,57180,51,0,3170,38,13,50.0,0.0
8805,2251524,67,324,67274,36,31,5.0,48.75
8806,17436,42,0,1614,27,15,100.0,0.0
8807,2593920,832,2593920,14053,460,372,1.2658227848101269,66.74
8808,3960,35,3960,1177,31,4,5.0,56.83
8809,2211420,740,0,10028,390,350,1.2820512820512822,0.0
8810,3504,11,3504,1264,11,0,7.6923076923076925,89.18
8811,3250704,218,0,49214,109,109,4.0,0.0
8812,50028,42,0,4252,36,6,50.0,0.0
8813,722928,34,0,44436,19,15,12.5,0.0
8814,587376,138,312,8577,66,72,2.9411764705882355,61.77
8815,1308,29,1308,502,25,4,4.761904761904762,71.93
8816,1148976,266,0,5881,135,131,2.5641025641025643,0.0
8817,2660688,247,2660688,29941,146,101,2.631578947368421,80.43
8818,504,13,504,58,7,6,33.333333333333336,62.54
8819,458136,2,458136,1272,1,1,50.0,90.0
8820,78012,70,78012,470,56,14,1.818181818181818,18.8
8821,5040,125,5040,113,79,46,1.694915254237288,47.48
8822,14976,25,14976,1651,23,2,5.882352941176471,76.53
8823,288,19,288,111,14,5,10.0,73.49
8824,2732004,490,0,36737,253,237,1.6666666666666667,0.0
8825,540,25,540,98,25,0,3.703703703703704,74.44
8826,432,22,228,92,21,1,4.761904761904762,44.68
8827,132,4,132,93,4,0,20.0,90.55
8828,8724,147,0,1099,81,66,2.702702702702702,0.0
8829,204,4,204,165,4,0,20.0,89.43
8830,11976,177,0,1280,101,76,1.818181818181818,0.0
8831,6780,29,6780,1372,25,4,6.666666666666667,72.79
8832,7620,54,0,1704,47,7,100.0,0.0
8833,4500,15,156,313,13,2,6.666666666666667,50.11
8834,2803200,3038,689460,12571,2412,626,1.0,0.0
8835,2558208,195,0,32100,118,77,2.127659574468085,0.0
8836,4932,44,0,1032,30,14,100.0,0.0
8837,50556,43,0,3023,37,6,50.0,0.0
8838,63792,3,63792,13604,3,0,16.666666666666668,45.24
8839,2954532,881,0,25437,488,393,1.4285714285714286,0.0
8840,160896,79,0,13431,68,11,100.0,0.0
8841,3188484,50,0,66707,45,5,50.0,0.0
8842,1296,38,1296,589,29,9,4.545454545454546,69.07
8843,35988,4,35988,561,2,2,50.0,98.45
8844,1911384,75,0,85501,54,21,20.0,0.0
8845,288,7,288,154,7,0,11.11111111111111,81.7
8846,1368876,536,0,15763,282,254,1.6666666666666667,0.0
8847,384,9,384,88,6,3,20.0,72.03
8848,388380,29,388380,21984,22,7,6.25,34.83
8849,55056,78,0,4335,58,20,50.0,0.0
8850,576,12,576,329,12,0,9.090909090909092,52.38
8851,227148,37,227148,4822,25,12,6.25,29.24
8852,1920,48,1824,978,40,8,3.571428571428572,56.47
8853,3411420,452,0,35236,239,213,2.4390243902439024,0.0
8854,1815708,164,0,57117,71,93,8.333333333333334,0.0
8855,216,20,192,88,14,6,10.0,55.14
8856,2897712,1028,0,7938,539,489,1.1235955056179776,0.0
8857,2741688,529,0,20381,283,246,1.818181818181818,0.0
8858,684,5,684,304,3,2,25.0,79.2
8859,27024,6,0,4974,5,1,50.0,0.0
8860,36648,45,0,1587,36,9,50.0,0.0
8861,3029484,97,3029484,11339,41,56,6.666666666666667,88.35
8862,43632,50,0,3871,35,15,50.0,0.0
8863,1980,32,0,523,26,6,100.0,0.0
8864,336,6,336,134,5,1,25.0,74.39
8865,22188,23,22188,1220,19,4,7.6923076923076925,87.22
8866,624,29,624,317,27,2,3.571428571428572,67.0
8867,2327856,802,0,9114,496,306,1.851851851851852,0.0
8868,72,13,72,12,10,3,11.11111111111111,18.83
8869,2408616,1122,0,24691,620,502,1.1111111111111112,0.0
8870,6660,144,0,2775,62,82,8.333333333333334,0.0
8871,1220748,56,0,39297,39,17,33.333333333333336,0.0
8872,648,4,648,354,4,0,20.0,96.08
8873,1884,38,0,649,31,7,100.0,0.0
8874,22152,8,0,4986,6,2,100.0,0.0
8875,1740,35,1740,694,29,6,4.545454545454546,68.33
8876,12840,16,12840,745,14,2,10.0,79.13
8877,3300,31,3300,501,20,11,9.090909090909092,67.43
8878,4992,142,0,512,70,72,100.0,0.0
8879,168,59,168,8,53,6,2.0,36.13
8880,11832,35,0,1915,28,7,100.0,0.0
8881,120,8,120,0,8,0,10.0,21.6
8882,8688,22,8688,415,19,3,5.555555555555555,84.61
8883,15648,19,15648,1009,16,3,7.142857142857143,79.27
8884,828,36,600,138,25,11,5.882352941176471,59.56
8885,3286212,1577,0,46581,840,737,1.0,0.0
8886,41964,53,0,1610,40,13,50.0,0.0
8887,264,0,264,0,0,0,50.0,95.0
8888,2361264,266,0,39104,133,133,3.8461538461538463,0.0
8889,3029760,1318,0,13612,709,609,1.0,0.0
8890,86844,460,86844,12660,381,79,1.3157894736842106,18.35
8891,156,8,156,55,6,2,14.285714285714286,59.45
8892,2805660,70,0,122505,59,11,33.333333333333336,0.0
8893,3111504,256,309612,71372,144,112,1.0,2.0
8894,3237180,2167,0,114793,1184,983,1.2048192771084338,0.0
8895,180,2,180,90,1,1,50.0,76.06
8896,18300,103,18300,163,75,28,1.639344262295082,7.49
8897,46572,47,0,1782,36,11,50.0,0.0
8898,8784,29,8784,969,24,5,6.666666666666667,72.11
8899,1356,39,1356,496,34,5,3.4482758620689653,68.11
8900,26148,50,0,2734,37,13,50.0,0.0
8901,8376,25,8376,1190,21,4,7.142857142857143,75.81
8902,3447108,22513,650712,170218,12537,9976,1.0,0.0
8903,1746936,1185,1004946,96383,1185,0,50.0,99.97
8904,22908,92,22908,47,62,30,2.0408163265306123,10.89
8905,26280,68,0,2884,54,14,50.0,0.0
8906,9024,59,0,2168,51,8,100.0,0.0
8907,569664,2,0,288366,0,2,3.333333333333333,26.75
8908,2784,16,2784,2480,14,2,6.666666666666667,77.78
8909,14784,24,14784,420,20,4,5.555555555555555,82.28
8910,28188,64,0,5074,54,10,50.0,0.0
8911,47436,43,47436,3436,42,1,20.0,27.91
8912,510216,50,0,31742,38,12,33.333333333333336,0.0
8913,3202044,1756,12324,25289,933,823,1.0,0.0
8914,481272,49,0,20740,38,11,33.333333333333336,0.0
8915,4512,20,4512,370,17,3,6.25,87.86
8916,2985156,1343,0,21253,768,575,1.075268817204301,0.0
8917,7812,390,5112,839,212,178,1.408450704225352,62.51
8918,7632,41,0,2260,35,6,33.333333333333336,0.0
8919,30456,44,0,2532,33,11,50.0,0.0
8920,30828,40,0,3455,35,5,50.0,0.0
8921,71148,22,71148,1962,10,12,25.0,77.19
8922,1782576,60,6600,31072,58,2,20.0,16.18
8923,864,18,756,266,16,2,11.11111111111111,69.42
8924,2695980,924,0,18492,507,417,1.9230769230769231,0.0
8925,31464,46,0,3412,29,17,50.0,0.0
8926,21072,45,0,3495,33,12,50.0,0.0
8927,672,79,672,139,70,9,1.4492753623188406,20.41
8928,4488,18,4488,1026,17,1,9.090909090909092,56.18
8929,28200,51,0,1357,38,13,50.0,0.0
8930,70740,50,60348,46616,37,13,25.0,99.73
8931,3415572,333,2180964,41363,197,136,7.142857142857143,5.0
8932,23808,52,0,1188,37,15,50.0,0.0
8933,2796,14,2796,780,13,1,9.090909090909092,74.31
8934,636,67,228,66,37,30,4.3478260869565215,51.6
8935,2952,90,0,1065,68,22,100.0,0.0
8936,960,64,420,107,38,26,4.0,76.33
8937,1824,1,1824,0,1,0,20.0,0.25
8938,576,54,192,70,36,18,4.0,47.38
8939,876,89,876,93,81,8,1.2345679012345678,24.18
8940,72,20,72,18,18,2,5.2631578947368425,39.28
8941,1068,66,192,112,48,18,3.571428571428572,59.74
8942,4836,213,0,1294,115,98,1.818181818181818,0.0
8943,35412,214,0,2159,132,82,1.351351351351351,0.0
8944,3852,84,0,1551,66,18,50.0,50.0
8945,5916,54,5916,2126,45,9,4.3478260869565215,51.95
8946,112668,65,492,2082,62,3,1.5873015873015872,45.48
8947,1200,21,1200,373,16,5,7.142857142857143,68.36
8948,65136,253,0,7664,179,74,100.0,0.0
8949,1267440,92,175704,133220,63,29,3.571428571428572,92.03
8950,174648,107,0,17334,87,20,100.0,0.0
8951,164352,30,164352,285,23,7,4.0,30.53
8952,540,62,540,134,40,22,3.225806451612903,57.05
8953,25236,15,25236,505,13,2,8.333333333333334,80.9
8954,5028,25,5028,1188,23,2,6.25,69.64
8955,26772,57,0,1664,45,12,50.0,0.0
8956,876,6,876,330,6,0,12.5,87.04
8957,44544,20,44544,870,17,3,9.090909090909092,81.72
8958,358032,86,358032,311798,82,4,1.7543859649122806,38.23
8959,26820,51,0,1189,38,13,50.0,0.0
8960,2097960,482,0,22224,250,232,2.1739130434782608,3.0
8961,1668,48,1668,529,35,13,2.857142857142857,50.31
8962,4956,80,4956,57,66,14,1.6129032258064515,7.09
8963,41244,30,41244,1458,24,6,6.666666666666667,71.12
8964,8016,58,0,1815,49,9,100.0,0.0
8965,62724,45,0,2334,30,15,100.0,0.0
8966,5508,40,5508,1593,37,3,4.545454545454546,62.82
8967,11076,28,4032,2866,22,6,11.11111111111111,65.82
8968,780,6,0,294,4,2,25.0,0.0
8969,8040,29,8040,1029,26,3,5.882352941176471,71.04
8970,3456624,4986,873406,175401,2809,2177,1.0,0.0
8971,3948,38,3948,1427,35,3,3.703703703703704,43.21
8972,2388,37,2388,672,30,7,4.761904761904762,63.95
8973,48876,32,48876,1446,26,6,6.25,76.04
8974,20184,128,0,1031,72,56,2.7777777777777777,0.0
8975,5520,657,0,2220,287,370,1.3888888888888888,1.56
8976,81276,57,81276,8234,46,11,4.166666666666667,63.2
8977,11460,16,11460,1111,16,0,5.555555555555555,86.24
8978,10992,23,10992,607,23,0,4.761904761904762,27.35
8979,900,7,900,341,5,2,20.0,80.65
8980,8208,36,8208,1775,31,5,5.2631578947368425,67.23
8981,70812,42,0,2733,27,15,100.0,0.0
8982,2796,23,2796,1311,22,1,5.0,44.91
8983,0,0,0,0,0,0,100.0,0.0
8984,3432,9,3432,1022,8,1,11.11111111111111,60.19
8985,147384,4,147384,50850,4,0,16.666666666666668,77.26
8986,54108,1,54108,192,1,0,50.0,99.86
8987,7572,25,7572,1516,22,3,8.333333333333334,81.36
8988,5016,194,0,700,118,76,1.2820512820512822,0.0
8989,9156,30,9156,807,26,4,5.0,85.04
8990,7944,33,7944,1293,28,5,6.666666666666667,74.76
8991,2232,37,2232,1262,29,8,4.0,63.85
8992,2724,14,2724,482,6,8,20.0,97.08
8993,9672,45,9672,1258,44,1,25.0,12.5
8994,57228,57,0,11610,45,12,50.0,0.0
8995,19956,28,19956,337,22,6,4.3478260869565215,66.07
8996,11496,15,11496,1068,14,1,6.666666666666667,40.19
8997,2499348,720,0,70594,386,334,2.9411764705882355,0.0
8998,9720,271,0,2531,139,132,100.0,0.0
8999,4032,6,0,1880,4,2,33.333333333333336,8.99
9000,320508,63,0,21913,52,11,25.0,0.0
9001,88752,51,1872,4144,37,14,4.0,76.06
9002,10308,242,0,2294,138,104,1.3333333333333333,0.0
9003,2198544,11,336,200004,9,2,14.285714285714286,79.88
9004,3487068,1982,0,242253,1114,868,1.0,2.38
9005,83220,41,0,7471,34,7,100.0,0.0
9006,12072,51,12072,2576,40,11,3.225806451612903,69.28
9007,3512496,2538,0,466870,1465,1073,1.0,0.0
9008,8292,72,8292,60,52,20,2.272727272727273,41.82
9009,45120,50,0,1545,37,13,50.0,0.0
9010,229116,182,372,1788,107,75,1.5151515151515151,52.03
9011,3509952,1134,0,1802465,683,451,1.0,0.0
9012,1524,7,1524,735,5,2,20.0,89.81
9013,2359104,1438,0,59268,613,825,1.0,0.0
9014,45924,55,0,1759,43,12,50.0,0.0
9015,1272,15,1272,451,12,3,9.090909090909092,43.46
9016,660,35,660,330,29,6,3.571428571428572,48.59
9017,20844,20,20844,1020,17,3,6.666666666666667,73.59
9018,57312,55,0,3537,43,12,50.0,0.0
9019,564,5,564,213,5,0,16.666666666666668,86.32
9020,57588,56,0,4149,41,15,50.0,0.0
9021,28176,3,28176,13944,2,1,50.0,96.0
9022,3514692,1482,1458636,135220,797,685,1.2987012987012987,0.0
9023,114240,4,114240,57,4,0,16.666666666666668,53.97
9024,177624,0,177624,0,0,0,100.0,100.0
9025,1499916,352,1499916,107867,352,0,100.0,100.0
9026,177948,3,177948,72,3,0,25.0,97.72
9027,19572,204,0,10181,146,58,50.0,0.0
9028,144,6,144,66,3,3,50.0,76.89
9029,4824,105,0,1438,76,29,33.333333333333336,0.0
9030,40980,69,40980,137,57,12,2.0,39.2
9031,14700,53,0,2576,42,11,100.0,0.0
9032,228,10,228,31,10,0,8.333333333333334,58.4
9033,1432716,155,0,48782,127,28,50.0,0.0
9034,744,22,744,169,14,8,9.090909090909092,0.0
9035,444,8,444,201,8,0,11.11111111111111,74.66
9036,1719504,49,0,81623,40,9,50.0,0.0
9037,4344,159,0,1100,94,65,100.0,0.0
9038,468,9,0,88,8,1,50.0,0.0
9039,708,3,708,64,3,0,20.0,54.96
9040,14160,61,0,2648,47,14,50.0,0.0
9041,0,0,0,0,0,0,100.0,0.0
9042,230940,35,187398,15797,30,5,5.2631578947368425,37.23
9043,1116,21,1116,434,20,1,5.0,58.22
9044,8184,20,8184,343,17,3,6.25,79.36
9045,143796,508,143796,8847,416,92,3.225806451612903,5.91
9046,5904,57,0,1856,45,12,50.0,0.0
9047,120,1,120,0,1,0,33.333333333333336,57.85
9048,19512,12,19512,2510,6,6,33.333333333333336,88.9
9049,14268,40,14268,1599,38,2,2.702702702702702,31.93
9050,1534740,64,1534740,1019,54,10,1.851851851851852,7.37
9051,7008,54,0,1984,40,14,50.0,0.0
9052,1450992,10,456,145176,9,1,9.090909090909092,57.09
9053,732,16,732,264,14,2,9.090909090909092,55.27
9054,708372,39,0,22072,17,22,50.0,0.0
9055,312,12,252,103,9,3,10.0,21.81
9056,216,138,216,64,88,50,1.5151515151515151,48.39
9057,4728,19,4728,363,17,2,5.882352941176471,80.82
9058,1428,53,1428,72,43,10,2.5,42.35
9059,1992984,1163,0,20219,650,513,1.020408163265306,3.12
9060,1044,16,0,277,13,3,100.0,100.0
9061,744,2,744,252,2,0,25.0,56.37
9062,480,26,480,9,25,1,3.8461538461538463,36.05
9063,49176,8,49176,148,7,1,12.5,92.51
9064,1044,1,1044,96,1,0,50.0,99.65
9065,15132,45,0,1347,28,17,100.0,0.0
9066,120,15,120,50,10,5,14.285714285714286,51.76
9067,1596,17,0,633,12,5,100.0,0.0
9068,384,16,348,153,11,5,11.11111111111111,55.13
9069,3143496,81,3143496,13251,29,52,20.0,96.99
9070,24540,86,0,6248,59,27,50.0,0.0
9071,17076,27,17076,1087,23,4,5.2631578947368425,45.51
9072,420,5,420,64,4,1,20.0,76.45
9073,61740,63,0,6110,52,11,50.0,0.0
9074,300,6,0,144,4,2,100.0,0.0
9075,1872,34,0,852,28,6,100.0,0.0
9076,3578712,78,0,1074674,60,18,20.0,0.0
9077,20904,20,20904,914,17,3,8.333333333333334,78.41
9078,1644,30,1644,630,27,3,4.545454545454546,60.75
9079,732,4,732,255,4,0,16.666666666666668,74.0
9080,451404,41,0,13364,32,9,33.333333333333336,0.0
9081,588,7,588,293,6,1,14.285714285714286,59.57
9082,1025124,29,1025124,64031,28,1,3.571428571428572,27.4
9083,3342108,1605,0,33857,870,735,1.2820512820512822,3.95
9084,23088,27,23088,904,22,5,6.666666666666667,77.84
9085,3576,156,0,1158,79,77,5.555555555555555,0.0
9086,2991816,84,0,87782,63,21,25.0,0.0
9087,624,9,624,2,9,0,9.090909090909092,57.42
9088,348,4,348,39,4,0,16.666666666666668,58.93
9089,2923116,31,4092,813602,24,7,5.555555555555555,86.15
9090,48636,39,48636,1032,38,1,50.0,34.03
9091,16776,44,0,2029,33,11,50.0,0.0
9092,3501888,4579,0,73364,2509,2070,1.0,0.0
9093,1026852,30,1026852,14430,29,1,3.703703703703704,27.76
9094,2232,47,0,1071,39,8,50.0,41.17
9095,3403524,219,0,265174,108,111,5.0,0.0
9096,42972,25,14136,2155,20,5,5.555555555555555,87.46
9097,240,36,240,126,21,15,12.5,16.86
9098,14904,52,0,1778,39,13,50.0,0.0
9099,95280,58,0,3771,52,6,25.0,0.0
9100,708,21,708,249,20,1,4.761904761904762,67.28
9101,3438096,1305,0,36677,711,594,1.0,0.0
9102,9864,60,0,1853,46,14,50.0,0.0
9103,113928,29,0,14968,26,3,100.0,0.0
9104,9168,47,0,1780,44,3,50.0,0.0
9105,12696,62,0,3169,52,10,100.0,0.0
9106,468,68,468,61,64,4,1.5384615384615383,43.87
9107,224208,89,2268,10469,72,17,33.333333333333336,0.0
9108,2999784,6,0,1440490,6,0,20.0,0.0
9109,8052,140,0,1293,77,63,100.0,0.0
9110,11340,45,0,1709,33,12,50.0,0.0
9111,10536,49,0,2241,39,10,50.0,0.0
9112,2294688,994,0,30299,539,455,1.2658227848101269,0.0
9113,432,36,432,116,34,2,2.857142857142857,0.0
9114,2608188,266,2608188,40376,149,117,2.9411764705882355,0.0
9115,1836,23,1584,158,19,4,5.555555555555555,48.33
9116,588,43,588,114,31,12,5.0,39.06
9117,90960,186,0,2706,135,51,33.333333333333336,0.0
9118,2628,9,2628,376,6,3,20.0,95.39
9119,516,21,516,254,13,8,10.0,79.09
9120,47448,20,47448,840,16,4,8.333333333333334,87.29
9121,396,26,396,87,25,1,4.3478260869565215,62.0
9122,156,0,156,0,0,0,100.0,100.0
9123,720,18,720,296,12,6,9.090909090909092,59.81
9124,300,15,300,123,10,5,9.090909090909092,67.27
9125,43560,41,43560,1399,35,6,3.571428571428572,65.17
9126,27312,70,0,5265,56,14,100.0,0.0
9127,664320,32,486558,28323,32,0,3.125,32.91
9128,1536,6,1536,318,6,0,12.5,88.39
9129,117000,53,0,3133,41,12,50.0,0.0
9130,768,41,768,340,23,18,6.666666666666667,66.28
9131,768,7,768,284,5,2,25.0,94.09
9132,160992,139,0,27453,63,76,11.11111111111111,0.0
9133,54228,9,54228,6608,9,0,10.0,17.16
9134,3345864,61,0,57452,55,6,50.0,0.0
9135,2580,0,2580,0,0,0,50.0,43.92
9136,792,213,792,195,171,42,1.0,40.44
9137,943380,25,88506,38915,25,0,4.166666666666667,55.18
9138,1188,18,1188,278,13,5,10.0,74.65
9139,1260,32,1260,733,30,2,3.225806451612903,60.51
9140,125952,291,0,13509,233,58,100.0,0.0
9141,38364,36,38364,2037,32,4,3.225806451612903,33.77
9142,168,2,168,24,1,1,50.0,57.12
9143,30960,56,30960,2623,45,11,4.166666666666667,65.97
9144,4536,46,4536,1097,18,28,8.333333333333334,69.24
9145,53688,75,53688,2152,67,8,1.5625,28.17
9146,31068,43,31068,2301,34,9,4.761904761904762,70.18
9147,84,4,84,21,3,1,25.0,60.69
9148,1237380,30,33900,43170,25,5,5.555555555555555,71.59
9149,1932,3,0,1064,3,0,25.0,0.0
9150,5916,29,5916,1387,23,6,9.090909090909092,18.27
9151,432,1,0,432,1,0,50.0,0.0
9152,516,74,516,197,48,26,2.857142857142857,58.96
9153,852,9,852,449,9,0,8.333333333333334,82.02
9154,4224,100,4224,2041,93,7,2.5,21.9
9155,384,64,384,83,40,24,2.5641025641025643,37.55
9156,1608,4,552,642,3,1,25.0,23.76
9157,3553872,1058,0,37683,582,476,1.2820512820512822,0.0
9158,876,1,0,876,1,0,50.0,99.97
9159,53184,28,53184,14118,22,6,5.2631578947368425,32.11
9160,7200,26,7200,1047,22,4,6.666666666666667,63.87
9161,77424,99,0,2044,55,44,100.0,0.0
9162,6348,35,6348,1618,27,8,5.882352941176471,73.5
9163,1536,59,1536,788,45,14,2.5,66.61
9164,5844,260,0,1470,202,58,100.0,0.0
9165,3576,52,3576,1084,50,2,2.0,25.17
9166,20808,35,20808,1039,35,0,11.11111111111111,44.91
9167,96,14,96,18,10,4,12.5,68.15
9168,396,0,396,0,0,0,50.0,71.03
9169,80724,38,8076,3846,30,8,6.666666666666667,20.5
9170,2507868,1386,0,30708,781,605,1.0,0.0
9171,384,1,384,312,1,0,33.333333333333336,74.26
9172,480,5,0,146,4,1,100.0,0.0
9173,204,0,204,0,0,0,50.0,59.29
9174,240,83,240,43,49,34,3.0303030303030303,40.69
9175,1320,53,1320,43,41,12,2.702702702702702,45.61
9176,3676584,15224,0,1119610,8789,6435,1.0,0.0
9177,3395004,423,0,85740,212,211,3.225806451612903,0.0
9178,108,0,108,0,0,0,50.0,80.0
9179,2172,78,2172,70,60,18,1.8867924528301887,39.9
9180,1080,16,1080,248,10,6,16.666666666666668,66.47
9181,612,4,612,306,3,1,20.0,63.01
9182,3418608,226,0,28661,109,117,3.8461538461538463,0.0
9183,8712,1,0,8712,1,0,33.333333333333336,0.0
9184,9000,16,9000,228,13,3,8.333333333333334,69.01
9185,35928,28,35928,603,21,7,7.6923076923076925,63.71
9186,3454740,2901,0,30672,1612,1289,1.0,2.38
9187,845604,35,5976,49530,28,7,5.882352941176471,75.15
9188,852,21,852,300,21,0,4.3478260869565215,0.0
9189,108,4,108,30,2,2,50.0,58.04
9190,75120,0,75120,0,0,0,33.333333333333336,50.0
9191,384,3,384,124,2,1,33.333333333333336,75.59
9192,600,0,600,0,0,0,50.0,77.0
9193,1524708,6,803118,14634,4,2,25.0,24.57
9194,540,41,540,4,41,0,2.3255813953488373,59.56
9195,2395824,448,0,22215,212,236,2.380952380952381,0.0
9196,504,90,504,70,41,49,6.666666666666667,92.1
9197,756,40,756,112,27,13,4.761904761904762,56.69
9198,276,1,276,0,1,0,33.333333333333336,0.0
9199,763704,29,396,74424,24,5,4.545454545454546,49.08
9200,468,48,468,309,36,12,3.125,43.0
9201,1560,34,1266,918,33,1,3.0303030303030303,0.0
9202,178920,131,0,4623,78,53,1.6666666666666667,4.7
9203,192,23,192,17,23,0,4.0,55.7
9204,624,3,624,172,3,0,20.0,21.58
9205,12672,6,12672,662,6,0,12.5,76.07
9206,2945388,1102,0,547065,596,506,1.8867924528301887,0.0
9207,10296,3,10296,1488,3,0,20.0,85.39
9208,3350268,273,0,453208,129,144,4.761904761904762,0.0
9209,2011452,47,0,88490,25,22,5.882352941176471,0.0
9210,336,27,312,156,20,7,6.666666666666667,42.2
9211,948,221,948,290,188,33,1.0,25.4
9212,1032,15,372,272,11,4,10.0,91.52
9213,128880,54,0,13453,45,9,100.0,0.0
9214,3687576,1292,0,2085553,727,565,1.0,0.0
9215,289812,10,0,115922,7,3,20.0,0.0
9216,732,7,732,661,6,1,14.285714285714286,75.67
9217,6516,28,6516,449,23,5,5.882352941176471,44.92
9218,828,8,828,541,7,1,16.666666666666668,53.38
9219,15456,179,0,1534,107,72,50.0,0.0
9220,12264,94,12264,27,70,24,1.6666666666666667,39.36
9221,1019292,7,1019292,117973,3,4,50.0,95.0
9222,8856,220,0,1678,173,47,100.0,0.0
9223,1476,8,1476,112,6,2,14.285714285714286,90.98
9224,3663552,1998,0,234297,1118,880,1.0,0.0
9225,3073248,506,0,32511,271,235,1.694915254237288,0.0
9226,1331892,253,0,31283,128,125,2.702702702702702,0.0
9227,3602616,1215,0,439426,671,544,1.0,0.0
9228,770712,235,0,10806,120,115,3.333333333333333,16.0
9229,1392,47,1392,1074,38,9,3.225806451612903,46.08
9230,33600,6,33600,5134,4,2,20.0,63.3
9231,2085360,370,1534656,127684,199,171,2.857142857142857,0.0
9232,3632004,286,1532748,87742,136,150,3.225806451612903,0.0
9233,468,2,468,186,1,1,100.0,100.0
9234,2427228,1034,1536060,29784,560,474,1.2048192771084338,0.0
9235,477612,101,0,48895,84,17,33.333333333333336,0.0
9236,3521568,260,0,35924,137,123,4.3478260869565215,0.0
9237,192468,13,3984,15781,10,3,9.090909090909092,83.9
9238,996,5,432,297,3,2,25.0,97.45
9239,3589764,3074,0,493930,1663,1411,1.0,0.0
9240,7128,45,0,1546,38,7,100.0,0.0
9241,7068,21,7068,1089,19,2,6.25,56.9
9242,1103556,259,0,8328,125,134,4.545454545454546,0.0
9243,18108,9,18108,4153,8,1,11.11111111111111,49.84
9244,3057192,711,0,55795,391,320,1.3333333333333333,0.0
9245,3692376,26041,190664,771815,14158,11883,1.0,2.0
9246,396,10,396,132,8,2,12.5,86.91
9247,70104,323,0,2827,176,147,100.0,0.0
9248,468,59,468,99,49,10,2.3255813953488373,33.78
9249,80184,52,80184,5331,49,3,2.0408163265306123,31.36
9250,2165580,5,2165580,297940,5,0,6.25,56.93
9251,2989824,1045,0,19366,455,590,1.0,0.0
9252,888,165,0,117,140,25,1.0,0.0
9253,3554736,1148,1544832,214375,547,601,1.1111111111111112,0.0
9254,2961516,91,0,33677,67,24,33.333333333333336,0.0
9255,61272,60,13992,3562,47,13,3.703703703703704,69.46
9256,96,10,96,38,7,3,16.666666666666668,40.8
9257,0,0,0,0,0,0,33.333333333333336,3.0
9258,32088,12,32088,784,11,1,12.5,85.18
9259,1869936,361,1758840,16911,198,163,1.7857142857142858,77.96
9260,17412,46,0,2772,37,9,50.0,0.0
9261,1020,42,1020,540,35,7,3.8461538461538463,39.8
9262,372,71,372,70,39,32,3.8461538461538463,64.52
9263,325296,1,325296,72,1,0,33.333333333333336,86.71
9264,276,21,276,64,15,6,12.5,60.14
9265,852,89,852,35,63,26,1.9230769230769231,39.0
9266,2618316,113,2618316,8101,61,52,5.882352941176471,88.02
9267,355020,15,355020,230960,15,0,7.6923076923076925,92.93
9268,61488,38,0,4162,31,7,100.0,0.0
9269,0,0,0,0,0,0,100.0,0.0
9270,176688,704,176688,10411,581,123,1.7241379310344829,19.86
9271,14136,54,0,2095,48,6,100.0,0.0
9272,1371048,677,0,13739,355,322,1.694915254237288,4.05
9273,456,29,456,0,29,0,3.225806451612903,43.54
9274,528,5,528,69,5,0,14.285714285714286,71.86
9275,3466608,439,0,32942,234,205,2.2222222222222223,0.0
9276,744,24,744,282,23,1,4.166666666666667,61.24
9277,169080,43,0,4611,31,12,50.0,0.0
9278,47472,26,804,2230,23,3,4.166666666666667,54.61
9279,170328,508,99270,10874,414,94,2.631578947368421,4.38
9280,192,4,192,69,2,2,33.333333333333336,79.37
9281,3707796,9634,435355,648324,5312,4322,1.0,0.0
9282,168,123,120,52,91,32,1.2820512820512822,26.7
9283,67704,68,2076,5871,60,8,33.333333333333336,0.0
9284,2945136,51,0,176193,42,9,25.0,0.0
9285,636,6,0,330,5,1,100.0,0.0
9286,1188432,105,0,92684,56,49,11.11111111111111,0.0
9287,3706992,1784,0,230112,985,799,1.0,2.0
9288,1044,2,1044,126,2,0,33.333333333333336,50.1
9289,113496,49,0,3099,38,11,50.0,0.0
9290,1272,35,0,456,28,7,100.0,0.0
9291,3223416,54,0,74618,46,8,33.333333333333336,0.0
9292,2752716,1266,0,13598,550,716,1.0,0.0
9293,93228,108,93228,2273,84,24,1.3157894736842106,16.31
9294,10584,22,10584,385,19,3,5.555555555555555,84.0
9295,2730636,55,351208,500351,24,31,7.142857142857143,7.74
9296,0,0,0,0,0,0,50.0,99.78
9297,3713100,8011,0,584702,4422,3589,1.0,0.0
9298,660,2,660,174,1,1,100.0,100.0
9299,2220,12,0,820,7,5,100.0,100.0
9300,16476,76,16476,1992,63,13,2.3255813953488373,60.27
9301,2760,89,0,1018,66,23,100.0,0.0
9302,576,2,576,330,2,0,25.0,76.45
9303,264,3,264,108,2,1,33.333333333333336,1.42
9304,1668,39,1668,595,37,2,20.0,35.42
9305,71352,40,0,3424,36,4,50.0,0.0
9306,0,0,0,0,0,0,50.0,99.94
9307,312,10,288,134,9,1,9.090909090909092,17.7
9308,15504,26,15504,434,23,3,5.0,83.37
9309,29364,23,29364,932,20,3,7.6923076923076925,21.91
9310,74112,40,0,4518,36,4,50.0,0.0
9311,7128,23,7128,463,20,3,5.2631578947368425,83.5
9312,66444,77,66444,2692,59,18,2.857142857142857,36.16
9313,1112952,52,1112952,60037,47,5,2.380952380952381,21.62
9314,4308,7,4308,2185,4,3,50.0,99.93
9315,1032,50,1032,436,40,10,2.702702702702702,42.32
9316,76200,42,0,3417,38,4,50.0,0.0
9317,123048,51,0,4960,46,5,50.0,0.0
9318,2087652,42,0,102432,33,9,50.0,0.0
9319,78252,35,0,3206,34,1,50.0,0.0
9320,23304,24,23304,873,20,4,8.333333333333334,78.79
9321,1044,29,1044,511,29,0,3.4482758620689653,73.23
9322,3145344,1552,3145344,60200,833,719,1.098901098901099,67.35
9323,14916,2,14916,420,2,0,25.0,7.13
9324,300,5,300,60,4,1,20.0,74.86
9325,3730956,2498,0,863349,1494,1004,1.0,0.0
9326,5124,79,5124,814,69,10,1.5384615384615383,43.3
9327,7404,247,0,1965,141,106,100.0,0.0
9328,276,26,84,32,17,9,7.6923076923076925,65.49
9329,223860,599,123654,11035,419,180,1.0,13.64
9330,309972,664,119644,11848,442,222,1.0,32.19
9331,396324,628,209712,10541,438,190,1.0,22.57
9332,921492,18,462048,512752,12,6,11.11111111111111,0.0
9333,12096,19,12096,1024,17,2,6.666666666666667,91.4
9334,612,43,612,367,41,2,2.380952380952381,32.02
9335,88800,54,0,4483,49,5,50.0,0.0
9336,504,121,276,100,56,65,4.0,72.99
9337,1378524,63,1289220,82175,39,24,4.3478260869565215,0.0
9338,29412,29,0,8556,26,3,100.0,0.0
9339,19788,41,19788,1648,40,1,5.2631578947368425,36.03
9340,3741528,2972,45468,38086,1634,1338,1.0,0.0
9341,26388,22,26388,1807,21,1,4.761904761904762,78.7
9342,22008,38,0,2538,35,3,50.0,0.0
9343,504,38,504,210,38,0,2.5641025641025643,50.47
9344,3510072,840,0,50918,464,376,1.4285714285714286,0.0
9345,16344,67,0,2581,60,7,100.0,0.0
9346,85104,54,0,2922,41,13,50.0,0.0
9347,32736,50,0,1549,39,11,50.0,0.0
9348,228,0,228,0,0,0,50.0,78.0
9349,31368,50,0,1332,36,14,50.0,0.0
9350,3544728,1662,0,259812,934,728,1.0101010101010102,0.0
9351,2597460,54,0,145469,37,17,25.0,0.0
9352,5592,34,5592,904,33,1,25.0,22.83
9353,2208,20,2208,388,15,5,9.090909090909092,66.68
9354,679860,459,423362,239079,446,13,12.5,99.88
9355,732,65,732,234,57,8,1.818181818181818,54.86
9356,137148,14,17724,25662,6,8,25.0,4.78
9357,57204,304,0,3802,235,69,100.0,0.0
9358,108,2,108,0,2,0,25.0,60.16
9359,396,2,396,246,2,0,25.0,65.51
9360,3751668,3382,0,507756,1976,1406,1.0,2.75
9361,45492,9,45492,2237,9,0,10.0,60.81
9362,2064,60,2064,1721,54,6,1.851851851851852,22.46
9363,636,125,636,45,115,10,1.0,32.07
9364,50376,177,0,1436,107,70,100.0,0.0
9365,1608,363,1608,343,180,183,1.1764705882352942,41.47
9366,2704260,262,2704260,32815,130,132,2.702702702702702,78.93
9367,1548,67,1548,66,55,12,1.96078431372549,33.6
9368,3160932,740,0,36394,409,331,1.492537313432836,0.0
9369,1356,3,1356,300,3,0,33.333333333333336,98.34
9370,54180,0,54180,0,0,0,100.0,100.0
9371,52776,63,0,6080,33,30,5.555555555555555,0.0
9372,1956,17,1956,736,16,1,6.666666666666667,46.75
9373,1692,36,1620,646,30,6,4.166666666666667,74.55
9374,1920,2,1920,0,2,0,25.0,74.8
9375,132,3,132,0,3,0,20.0,59.43
9376,924,96,0,158,62,34,50.0,0.0
9377,384,37,324,128,24,13,4.3478260869565215,45.2
9378,5604,264,0,1572,201,63,100.0,0.0
9379,58080,243,0,1650,144,99,50.0,0.0
9380,60,13,60,0,13,0,6.666666666666667,43.2
9381,3331500,16,276,1457507,10,6,33.333333333333336,76.48
9382,567300,16,567300,2807,16,0,6.666666666666667,94.81
9383,1224,60,348,225,52,8,1.851851851851852,29.44
9384,16428,36,16428,1158,35,1,33.333333333333336,21.1
9385,2196,9,2196,778,5,4,16.666666666666668,92.72
9386,1092,51,1092,380,35,16,3.571428571428572,6.41
9387,831132,93,0,70583,41,52,6.25,0.0
9388,64416,15,64416,3244,15,0,7.142857142857143,63.75
9389,3602400,1156,0,267183,646,510,1.2048192771084338,0.0
9390,5124,6,5124,3846,6,0,12.5,90.32
9391,228396,25,228396,9240,21,4,5.2631578947368425,24.68
9392,2196,48,2196,1059,46,2,2.083333333333333,34.43
9393,19452,22,19452,476,17,5,7.6923076923076925,2.13
9394,3764208,891,0,1533453,481,410,1.0,0.0
9395,39012,21,39012,854,18,3,6.666666666666667,77.74
9396,44112,34,0,4659,31,3,50.0,0.0
9397,8784,8,8784,2361,7,1,12.5,71.53
9398,1492656,506,537808,10778,404,102,2.631578947368421,15.54
9399,0,0,0,0,0,0,50.0,0.0
9400,19428,48,19428,3713,38,10,2.9411764705882355,34.34
9401,1428,51,1428,828,51,0,1.8867924528301887,23.98
9402,10884,11,10884,2253,8,3,16.666666666666668,21.13
9403,3488868,1608,663060,398792,811,797,1.0,0.0
9404,477600,112,360,8621,73,39,1.8867924528301887,32.31
9405,341532,44,64308,16840,39,5,2.702702702702702,38.93
9406,96,18,96,1,18,0,5.0,47.47
9407,3343356,1854,0,65138,1039,815,1.0638297872340423,0.0
9408,1368,9,900,425,8,1,12.5,21.3
9409,8268,5,8268,458,3,2,25.0,91.12
9410,2145084,822,1615956,206258,414,408,1.2658227848101269,0.0
9411,31116,12,336,2696,10,2,8.333333333333334,30.63
9412,1044,20,1044,655,20,0,4.761904761904762,81.75
9413,58620,22,58620,17464,18,4,5.555555555555555,85.12
9414,876,175,876,125,127,48,1.098901098901099,41.55
9415,3713412,2040,1609092,328890,1091,949,1.0,4.89
9416,168,29,168,33,21,8,5.555555555555555,44.86
9417,3144084,848,0,116728,470,378,1.3888888888888888,0.0
9418,357612,23,357612,3976,21,2,5.882352941176471,6.62
9419,3722568,1255,0,354188,686,569,1.0,0.0
9420,1284,28,1284,1128,26,2,3.703703703703704,47.98
9421,3774864,648,779892,1135101,326,322,1.0,12.64
9422,480,2,480,192,2,0,25.0,64.85
9423,100176,1,100176,8832,1,0,14.285714285714286,57.97
9424,10476,61,10476,217,55,6,1.96078431372549,34.53
9425,3439572,644,0,19152,345,299,1.3333333333333333,3.83
9426,3089976,784,0,101473,436,348,1.1764705882352942,0.0
9427,2844,109,2844,659,71,38,2.631578947368421,45.76
9428,2028,23,0,615,20,3,100.0,0.0
9429,17880,134,0,257,107,27,1.0101010101010102,0.0
9430,636,24,636,131,19,5,6.25,51.86
9431,3143496,1488,0,58307,818,670,1.0,1.2
9432,2850792,676,0,56089,368,308,1.351351351351351,0.0
9433,2891628,546,0,47471,298,248,1.408450704225352,6.33
9434,180,15,180,44,14,1,6.25,39.16
9435,108,17,108,39,12,5,11.11111111111111,21.39
9436,3620232,1197,0,273347,643,554,1.0526315789473684,0.0
9437,348,26,204,70,17,9,9.090909090909092,56.75
9438,155232,139,0,3251,67,72,5.2631578947368425,0.0
9439,516,7,516,200,7,0,11.11111111111111,93.51
9440,252,66,252,56,45,21,3.333333333333333,48.8
9441,3501132,774,0,225423,413,361,1.3888888888888888,0.0
9442,996,2,996,90,2,0,25.0,61.61
9443,696,24,696,386,22,2,4.761904761904762,22.33
9444,68796,3,68796,492,1,2,50.0,99.61
9445,3320208,214,0,69617,104,110,2.9411764705882355,0.0
9446,3340356,1366,0,88854,762,604,1.0,0.45
9447,3200832,131,3200832,2719,63,68,4.0,84.45
9448,32340,4,32340,2406,2,2,33.333333333333336,99.08
9449,96,103,96,19,71,32,1.7857142857142858,10.56
9450,3730860,2049,0,272145,1119,930,1.0,0.0
9451,682476,166,682476,157236,160,6,1.3888888888888888,94.11
9452,1067580,306,0,12383,156,150,3.0303030303030303,0.0
9453,5880,165,0,2185,120,45,100.0,0.0
9454,42216,50,0,1986,38,12,50.0,0.0
9455,2977764,254,0,43776,128,126,2.2222222222222223,0.0
9456,23532,20,23532,2085,15,5,33.333333333333336,99.98
9457,1524,7,1524,466,6,1,12.5,24.7
9458,552,68,468,244,44,24,3.0303030303030303,58.77
9459,108,1,108,0,1,0,33.333333333333336,0.0
9460,3774696,1853,0,156284,1020,833,1.0,0.0
9461,175836,58,0,10667,43,15,25.0,0.0
9462,336,5,336,112,5,0,14.285714285714286,44.89
9463,3251004,270,0,37078,130,140,3.125,0.0
9464,816,36,288,84,23,13,7.142857142857143,46.74
9465,273024,55,0,26138,47,8,5.555555555555555,0.0
9466,1129512,9,276,376593,5,4,50.0,51.25
9467,37068,23,37068,3625,19,4,5.555555555555555,83.82
9468,3763620,3142,2249712,782885,1717,1425,1.0,0.0
9469,12096,72,456,309,36,36,7.142857142857143,85.28
9470,3775680,5408,0,244628,3033,2375,1.0,0.0
9471,3775680,5370,0,145736,2966,2404,1.0,0.0
9472,3327540,699,0,36538,385,314,1.4705882352941178,0.0
9473,240264,7,240264,221,7,0,12.5,81.35
9474,26868,119,26868,216,81,38,1.5384615384615383,32.34
9475,1428,24,0,458,19,5,100.0,0.0
9476,64824,17,0,4965,15,2,50.0,0.0
9477,456,7,456,77,7,0,11.11111111111111,43.6
9478,72912,25,72912,1285,23,2,6.25,67.76
9479,504,0,504,0,0,0,50.0,61.33
9480,1536,24,1536,327,22,2,4.761904761904762,62.87
9481,3756804,35,0,1686777,35,0,33.333333333333336,99.93
9482,22896,8,12468,14362,4,4,20.0,82.71
9483,1044,0,1044,0,0,0,100.0,100.0
9484,54168,72,0,6505,59,13,100.0,0.0
9485,71892,40,0,3438,36,4,50.0,0.0
9486,3526644,680,0,1109894,345,335,1.36986301369863,0.0
9487,78900,83,78900,1629,68,15,1.5625,17.44
9488,2266632,2,2266632,222,2,0,25.0,97.97
9489,47664,12,0,6301,7,5,14.285714285714286,20.0
9490,39036,0,39036,0,0,0,100.0,100.0
9491,432,4,432,249,4,0,20.0,47.89
9492,32772,10,32772,32418,6,4,16.666666666666668,87.09
9493,12684,23,12684,445,20,3,5.2631578947368425,83.15
9494,3736452,16,0,1626524,16,0,8.333333333333334,98.99
9495,3799680,19,0,1385830,19,0,5.882352941176471,90.0
9496,33936,8,33936,973,8,0,16.666666666666668,89.63
9497,1824,0,1824,0,0,0,50.0,77.5
9498,600,31,600,307,29,2,3.4482758620689653,60.38
9499,2997924,20,0,1048806,20,0,12.5,98.99
9500,537384,6,537384,221228,6,0,16.666666666666668,92.58
9501,3806664,86916,891283,1084393,47818,39098,1.0,0.0
9502,1193496,35,1193496,53040,33,2,3.125,24.46
9503,27420,16,27420,2667,12,4,11.11111111111111,91.57
9504,89556,91,4596,3941,78,13,100.0,0.0
9505,61320,50,30804,56573,48,2,2.0408163265306123,0.0
9506,312,3,312,120,2,1,33.333333333333336,22.47
9507,3689388,900,3031351,1996989,900,0,7.6923076923076925,99.81
9508,7704,27,0,1316,24,3,100.0,0.0
9509,408,33,408,156,31,2,3.125,31.4
9510,528,81,528,84,53,28,2.380952380952381,46.17
9511,14088,23,14088,504,20,3,5.882352941176471,85.69
9512,228,3,228,36,3,0,20.0,58.16
9513,19356,18,19356,772,14,4,9.090909090909092,81.43
9514,576,33,576,228,33,0,2.857142857142857,53.63
9515,3322104,57,3322104,2131,21,36,20.0,95.29
9516,625440,9,625368,171678,6,3,11.11111111111111,20.0
9517,3810828,8842,1183848,1495771,4895,3947,1.0,0.0
9518,62856,48,0,2123,38,10,50.0,0.0
9519,148152,21,7272,7526,18,3,6.25,84.11
9520,46476,34,46476,1442,34,0,50.0,17.46
9521,3808944,1440,0,50246,828,612,1.098901098901099,0.0
9522,72684,40,0,6252,34,6,50.0,0.0
9523,6600,24,720,393,20,4,5.2631578947368425,61.49
9524,381300,4,381300,21597,2,2,100.0,100.0
9525,69312,45,0,4904,38,7,50.0,0.0
9526,39708,0,39708,0,0,0,100.0,100.0
9527,150204,9,0,30942,5,4,25.0,0.0
9528,67332,47,0,2065,35,12,50.0,0.0
9529,3782232,4178,0,629561,2291,1887,1.0,1.74
9530,432,6,432,174,6,0,12.5,50.14
9531,75012,34,0,6946,28,6,100.0,0.0
9532,1214844,11,1214616,163094,8,3,50.0,0.0
9533,26112,49,0,1612,35,14,50.0,0.0
9534,3760836,1534,0,243812,853,681,1.0,0.0
9535,193896,370,193896,104387,206,164,10.0,23.87
9536,305820,59,0,143801,29,30,50.0,0.0
9537,528,151,528,179,81,70,2.380952380952381,69.98
9538,456,5,456,295,3,2,33.333333333333336,77.07
9539,50040,46,0,3829,41,5,50.0,0.0
9540,2583060,58,4188,262424,43,15,25.0,0.0
9541,3048,3,3048,736,3,0,20.0,66.85
9542,492,33,492,289,31,2,3.125,47.59
9543,792,42,792,286,42,0,2.9411764705882355,51.13
9544,30336,66,0,1311,49,17,50.0,0.0
9545,840,55,840,270,47,8,2.4390243902439024,0.0
9546,13152,206,564,206,76,130,1.8867924528301887,47.08
9547,132,21,132,30,18,3,5.555555555555555,42.96
9548,1243968,258,0,39346,130,128,5.0,0.0
9549,3826212,4742,0,539180,2626,2116,1.0,0.0
9550,2616,58,0,1014,46,12,100.0,0.0
9551,146256,133,0,4788,72,61,100.0,0.0
9552,204,15,204,48,13,2,7.6923076923076925,42.7
9553,192,70,192,59,43,27,3.225806451612903,47.84
9554,1092,19,0,382,16,3,100.0,0.0
9555,224772,68,0,19667,56,12,50.0,0.0
9556,62016,26,62016,499,20,6,7.6923076923076925,3.11
9557,16692,51,0,1404,39,12,50.0,0.0
9558,1008,60,1008,513,58,2,1.7241379310344829,19.22
9559,2405868,52,0,139689,38,14,25.0,0.0
9560,56712,17,56712,4192,12,5,7.142857142857143,79.65
9561,574164,60,0,25429,51,9,33.333333333333336,0.0
9562,636,27,636,226,27,0,3.571428571428572,79.1
9563,15072,49,0,1178,39,10,50.0,0.0
9564,492,36,492,254,36,0,2.631578947368421,37.72
9565,132,76,132,30,58,18,1.96078431372549,44.82
9566,65328,12,65328,3693,8,4,25.0,95.25
9567,12636,41,12636,1325,40,1,50.0,27.33
9568,61116,4,61116,3,4,0,16.666666666666668,70.45
9569,4524,2,4524,96,2,0,33.333333333333336,99.85
9570,5280,17,5280,292,14,3,7.6923076923076925,0.76
9571,4968,19,0,675,16,3,50.0,0.0
9572,8436,2,0,5028,2,0,25.0,23.0
9573,32004,27,32004,1680,23,4,6.666666666666667,68.63
9574,120,9,120,34,6,3,20.0,57.47
9575,644496,23,644496,195634,23,0,50.0,99.95
9576,2580,36,2580,396,36,0,2.702702702702702,52.81
9577,1110648,440,0,6149,235,205,2.0,0.0
9578,1608,25,1608,561,24,1,4.3478260869565215,82.69
9579,1548,65,1548,1183,61,4,1.639344262295082,18.41
9580,56100,1,56100,60,1,0,33.333333333333336,48.55
9581,0,0,0,0,0,0,50.0,23.0
9582,984,91,0,128,82,9,1.25,0.0
9583,470520,97,112800,12316,71,26,2.702702702702702,4.47
9584,120,0,120,0,0,0,50.0,80.0
9585,65952,231,0,2107,173,58,100.0,0.0
9586,4644,3,0,2348,1,2,50.0,0.0
9587,4224,21,4224,298,18,3,6.25,0.72
9588,67848,28,37932,4024,22,6,5.2631578947368425,62.54
9589,48,2,0,24,1,1,100.0,0.0
9590,575004,16,575004,162372,16,0,11.11111111111111,92.3
9591,3543924,3251,2216190,1007750,1818,1433,1.0,0.0
9592,12396,120,12396,1074,95,25,1.2048192771084338,46.56
9593,53052,13,53052,612,13,0,6.666666666666667,52.17
9594,1800,59,1800,1350,57,2,1.694915254237288,20.13
9595,3456,0,3456,0,0,0,100.0,100.0
9596,63432,7,63432,2223,7,0,16.666666666666668,97.05
9597,51768,220,0,2350,133,87,50.0,0.0
9598,624,3,0,316,2,1,50.0,0.0
9599,741396,1118,741048,32141,803,315,1.0,0.0
9600,1080,53,1080,734,53,0,1.818181818181818,9.89
9601,276,20,276,21,20,0,4.545454545454546,34.35
9602,135024,22,135024,5802,18,4,7.6923076923076925,77.3
9603,16584,15,0,4775,6,9,100.0,0.0
9604,3156,105,0,192,90,15,100.0,0.0
9605,3786600,1121,1691076,355005,582,539,1.0,0.0
9606,8772,17,8772,283,15,2,7.142857142857143,0.75
9607,732,24,732,79,22,2,5.0,47.72
9608,1812,29,1812,300,27,2,3.571428571428572,59.77
9609,3312,0,3312,0,0,0,100.0,100.0
9610,7716,44,7716,1389,32,12,5.555555555555555,76.03
9611,3900,14,3900,2366,12,2,11.11111111111111,0.0
9612,1741980,486,1693104,14871,222,264,2.380952380952381,0.0
9613,9816,6,9816,3966,6,0,16.666666666666668,10.59
9614,2040,20,1992,854,19,1,5.0,78.98
9615,3815304,5546,0,364994,3407,2139,1.0,0.0
9616,57180,4,57180,1284,4,0,16.666666666666668,89.97
9617,69852,8,11892,14677,6,2,20.0,71.41
9618,4272,5,4272,962,4,1,20.0,79.9
9619,16452,4,16452,627,4,0,16.666666666666668,83.28
9620,10104,11,10104,593,10,1,10.0,36.18
9621,5052,17,5052,1027,17,0,5.882352941176471,17.69
9622,6444,42,6204,2990,42,0,2.857142857142857,25.9
9623,6312,0,6312,0,0,0,100.0,100.0
9624,500976,69,0,104223,32,37,100.0,100.0
9625,3805428,1895,0,453206,1198,697,1.0,0.0
9626,3846768,366,1695276,493650,205,161,1.0,0.0
9627,0,0,0,0,0,0,50.0,90.0
9628,5856,8,5856,2439,8,0,10.0,37.55
9629,69768,42,69768,1741,39,3,2.5,27.9
9630,3841716,1577,0,77881,925,652,1.0,0.0
9631,468,32,468,4,32,0,2.9411764705882355,34.96
9632,2318544,24,2318544,26727,24,0,5.2631578947368425,62.95
9633,707868,831,406719,202297,831,0,1.0,18.51
9634,60420,3,60420,2184,3,0,20.0,84.59
9635,1776,54,1776,1056,54,0,1.818181818181818,9.17
9636,18516,13,18516,761,12,1,11.11111111111111,72.27
9637,12384,250,0,2877,161,89,100.0,0.0
9638,5484,227,0,1365,177,50,100.0,0.0
9639,44316,20,44316,1620,17,3,8.333333333333334,80.7
9640,8832,31,8832,790,30,1,4.0,30.57
9641,4368,3,4368,1512,3,0,25.0,95.88
9642,9720,1,9720,192,1,0,33.333333333333336,96.05
9643,3796212,5768,1668,243556,3379,2389,1.0,0.0
9644,68124,4,68124,15333,4,0,25.0,96.89
9645,708,11,708,96,9,2,10.0,67.7
9646,11232,43,11232,2972,43,0,2.380952380952381,12.73
9647,2496576,19,2496576,2869,10,9,25.0,45.66
9648,348,2,0,348,2,0,25.0,0.0
9649,2622552,159,0,129566,91,68,3.0303030303030303,0.0
9650,22056,6,22056,5622,3,3,100.0,100.0
9651,42192,17,0,20783,15,2,100.0,0.0
9652,23652,7,23652,1817,5,2,25.0,91.3
9653,3656040,1021,0,37199,567,454,1.9230769230769231,0.0
9654,3569544,954,1702596,66901,501,453,1.0309278350515465,0.33
9655,161916,31,0,8070,27,4,100.0,0.0
9656,1716,1,0,1716,1,0,11.11111111111111,0.0
9657,3609072,292,0,33588,150,142,3.225806451612903,0.0
9658,324,5,132,124,5,0,16.666666666666668,54.42
9659,1164,31,1164,109,24,7,4.545454545454546,41.72
9660,93360,36,93360,10478,16,20,12.5,90.63
9661,3432,38,3432,878,34,4,2.857142857142857,31.28
9662,66516,15,66516,39464,5,10,25.0,81.21
9663,732,27,732,360,27,0,3.4482758620689653,45.96
9664,1752,0,1752,0,0,0,50.0,60.63
9665,3156,1,3156,1176,1,0,25.0,46.31
9666,3861648,1473,0,1612839,898,575,1.0,0.0
9667,1752,39,1752,1621,37,2,2.631578947368421,65.26
9668,3409572,111,0,144770,55,56,7.142857142857143,0.0
9669,360,24,360,261,20,4,5.0,83.24
9670,3792,72,3792,125,62,10,1.7543859649122806,36.43
9671,72336,283,0,1945,157,126,100.0,0.0
9672,5652,28,5652,892,25,3,3.703703703703704,69.47
9673,3240720,813,0,33836,347,466,2.272727272727273,0.0
9674,176916,0,176916,0,0,0,100.0,100.0
9675,25704,3,25704,25556,1,2,50.0,84.5
9676,3828048,2490,0,97529,1197,1293,1.0,0.0
9677,12012,1,12012,11928,1,0,33.333333333333336,68.0
9678,9168,1,9168,1236,1,0,33.333333333333336,97.06
9679,828,3,828,500,2,1,33.333333333333336,52.51
9680,7020,32,7020,2255,28,4,5.0,70.17
9681,11616,1,11616,1668,1,0,33.333333333333336,96.17
9682,37356,51,0,2666,44,7,100.0,0.0
9683,36324,51,0,1394,35,16,50.0,0.0
9684,3711144,778,0,89035,418,360,2.0,0.0
9685,360,7,360,164,7,0,12.5,42.29
9686,13104,22,13104,675,19,3,5.882352941176471,81.99
9687,5592,43,5592,922,38,5,2.7777777777777777,32.85
9688,12876,27,12876,2552,26,1,3.571428571428572,31.23
9689,384,10,276,192,9,1,9.090909090909092,40.78
9690,4776,5,4776,813,5,0,14.285714285714286,79.5
9691,7116,4,7116,3930,2,2,50.0,39.16
9692,5400,23,5400,468,19,4,5.882352941176471,86.51
9693,16920,21,16920,896,17,4,7.6923076923076925,70.73
9694,9552,36,0,2135,35,1,100.0,0.0
9695,71340,35,0,3632,26,9,50.0,0.0
9696,3872124,1955,0,2607510,1075,880,1.0,6.62
9697,10572,25,0,3454,23,2,100.0,0.0
9698,27492,3,27492,20824,3,0,33.333333333333336,98.8
9699,25980,25,25980,670,21,4,7.142857142857143,79.08
9700,1128372,156,0,44068,60,96,10.0,0.0
9701,2724,2,2724,84,2,0,33.333333333333336,99.22
9702,1260,96,1044,836,74,22,1.408450704225352,41.21
9703,0,0,0,0,0,0,50.0,99.78
9704,1036416,0,1036416,0,0,0,100.0,100.0
9705,75192,64,75192,607,54,10,1.8867924528301887,10.9
9706,1836,28,0,540,23,5,100.0,0.0
9707,75372,46,0,4458,41,5,50.0,0.0
9708,6996,48,0,2368,41,7,100.0,0.0
9709,27828,119,0,977,67,52,2.3255813953488373,0.0
9710,1787220,3,1787220,254028,3,0,20.0,79.42
9711,336,10,336,111,7,3,20.0,68.92
9712,1761852,604,1011792,110387,604,0,100.0,100.0
9713,636,41,636,14,39,2,2.5,43.18
9714,3344388,9,0,520986,4,5,1.0416666666666667,0.0
9715,384,8,384,168,8,0,9.090909090909092,47.36
9716,5448,3,5448,184,3,0,20.0,94.45
9717,2618484,9,2618484,278218,8,1,100.0,95.0
9718,48156,61,0,1621,47,14,50.0,0.0
9719,3732,36,3732,40,32,4,3.125,50.02
9720,744,13,336,191,10,3,10.0,42.47
9721,504,8,504,67,7,1,12.5,44.09
9722,50580,51,0,2075,41,10,50.0,0.0
9723,49356,16,49356,1616,15,1,7.6923076923076925,19.34
9724,52716,47,0,1900,35,12,50.0,0.0
9725,152028,98,0,8784,53,45,12.5,0.0
9726,73344,44,0,7947,36,8,50.0,0.0
9727,79440,83,0,3056,73,10,100.0,0.0
9728,17592,30,17592,3783,27,3,4.761904761904762,79.6
9729,19548,50,0,1137,38,12,50.0,0.0
9730,68640,42,0,4450,37,5,50.0,0.0
9731,14712,18,14712,554,17,1,5.555555555555555,85.54
9732,34356,28,34356,879,23,5,6.666666666666667,79.04
9733,43140,4,43140,43053,4,0,20.0,93.94
9734,768,30,768,542,30,0,3.125,44.3
9735,3890724,4162,309060,967413,2097,2065,1.0,0.0
9736,4188,22,4188,457,20,2,5.0,81.87
9737,47124,2,47124,78,2,0,33.333333333333336,52.06
9738,14508,46,14508,12516,22,24,10.0,86.74
9739,300,16,300,154,12,4,8.333333333333334,45.95
9740,3675612,254,788340,219921,142,112,5.882352941176471,0.0
9741,21156,32,0,8852,27,5,100.0,0.0
9742,2922864,36,2922864,72080,15,21,3.571428571428572,74.37
9743,2412,19,2412,447,18,1,5.555555555555555,81.41
9744,21612,10,21612,1135,8,2,14.285714285714286,82.45
9745,504,3,504,144,3,0,20.0,95.46
9746,6012,23,6012,425,20,3,5.2631578947368425,85.46
9747,49416,21,49416,532,16,5,8.333333333333334,3.05
9748,91368,7,0,15905,5,2,50.0,99.98
9749,2855544,526,0,54957,303,223,2.631578947368421,0.0
9750,768,43,768,288,43,0,2.2222222222222223,41.5
9751,74772,91,74772,53895,79,12,1.3333333333333333,32.94
9752,2232,18,2232,287,16,2,7.142857142857143,0.75
9753,516,98,516,74,81,17,1.2658227848101269,20.65
9754,1092,18,1092,268,16,2,8.333333333333334,0.77
9755,912,1,912,36,1,0,33.333333333333336,44.61
9756,180,0,180,0,0,0,100.0,100.0
9757,904512,2,0,454962,2,0,20.0,0.0
9758,60,2,48,30,1,1,33.333333333333336,60.83
9759,3677508,4485,0,81750,2525,1960,1.0,0.0
9760,2460,57,0,1002,46,11,100.0,0.0
9761,2607780,138,2607780,27914,82,56,6.666666666666667,7.0
9762,4824,36,4824,2126,36,0,2.631578947368421,69.46
9763,2040,22,0,918,15,7,100.0,0.0
9764,1236,5,1236,319,5,0,14.285714285714286,93.69
9765,3432120,67,0,55213,59,8,100.0,0.0
9766,25260,48,0,1243,38,10,50.0,0.0
9767,3240,20,0,1031,14,6,100.0,0.0
9768,2328,14,2328,192,12,2,9.090909090909092,1.01
9769,2496,57,0,928,45,12,100.0,0.0
9770,1728,0,1728,0,0,0,100.0,100.0
9771,900,10,900,434,9,1,11.11111111111111,33.65
9772,26256,48,0,1354,38,10,50.0,0.0
9773,3670152,672,1754544,35357,400,272,2.3255813953488373,5.0
9774,2376,29,2376,503,19,10,8.333333333333334,0.84
9775,3732,92,0,1431,72,20,100.0,0.0
9776,648,39,648,277,39,0,2.4390243902439024,53.13
9777,25056,57,0,1269,44,13,50.0,0.0
9778,11328,167,0,1295,91,76,2.4390243902439024,0.0
9779,26160,47,0,1191,36,11,50.0,0.0
9780,19344,26,0,6369,22,4,100.0,0.0
9781,504,37,504,94,34,3,3.703703703703704,46.27
9782,37080,7,21882,2328,7,0,12.5,96.92
9783,22236,33,22236,541,32,1,33.333333333333336,52.69
9784,1008,71,1008,400,63,8,2.272727272727273,44.43
9785,12024,32,1410,1499,26,6,100.0,0.0
9786,1884,2,1884,372,2,0,25.0,92.97
9787,8112,47,8112,687,38,9,3.8461538461538463,5.19
9788,4020,65,4020,2646,65,0,1.492537313432836,38.12
9789,113160,16,113160,749,13,3,9.090909090909092,77.33
9790,254412,64,254412,9612,49,15,3.0303030303030303,32.66
9791,3688272,498,0,101270,275,223,1.7857142857142858,0.0
9792,636,32,636,343,32,0,2.9411764705882355,55.67
9793,1633116,83,1173432,198597,74,9,1.851851851851852,8.78
9794,100440,255,0,12647,168,87,50.0,0.0
9795,390456,61,0,9817,52,9,50.0,0.0
9796,1171188,43,44760,38737,36,7,2.9411764705882355,57.69
9797,4032,44,4032,1174,42,2,8.333333333333334,33.17
9798,2940,7,2940,792,7,0,11.11111111111111,82.61
9799,55212,1,0,55212,1,0,33.333333333333336,0.0
9800,3384,21,3384,1021,19,2,8.333333333333334,81.56
9801,804,92,804,281,68,24,2.3255813953488373,3.95
9802,50628,44,50628,873,38,6,2.857142857142857,27.27
9803,1860,13,1860,559,12,1,9.090909090909092,97.01
9804,8424,0,8424,0,0,0,50.0,73.64
9805,3215196,542,264,13956,241,301,1.6129032258064515,1.42
9806,3496368,423,0,51900,233,190,2.9411764705882355,0.0
9807,6732,38,0,656,26,12,4.3478260869565215,0.0
9808,1620,120,1620,1266,69,51,1.7543859649122806,19.34
9809,1188,35,1188,116,17,18,11.11111111111111,87.8
9810,63804,12,63804,1372,12,0,7.6923076923076925,24.68
9811,35472,12,35472,608,11,1,9.090909090909092,77.5
9812,51708,204,0,1575,117,87,100.0,0.0
9813,54360,263,0,2072,211,52,100.0,0.0
9814,1560,21,252,165,21,0,4.545454545454546,51.59
9815,744,29,744,507,27,2,3.571428571428572,73.34
9816,2292,4,2292,318,4,0,20.0,97.64
9817,2508,33,612,83,33,0,2.9411764705882355,0.0
9818,504,104,324,83,52,52,3.8461538461538463,76.01
9819,336,0,336,0,0,0,33.333333333333336,96.2
9820,804,1,804,300,1,0,100.0,32.68
9821,1548,54,1548,38,44,10,2.5641025641025643,0.0
9822,1380,0,1380,0,0,0,50.0,98.0
9823,2232,31,2232,96,31,0,3.0303030303030303,49.78
9824,864,4,864,198,3,1,33.333333333333336,97.26
9825,2777268,1281,24204,55088,700,581,1.1494252873563218,2.38
9826,1344,0,1344,0,0,0,100.0,100.0
9827,3393876,629,0,84537,330,299,2.1739130434782608,0.0
9828,3797784,2237,1381008,389340,1024,1213,1.0,0.0
9829,1214460,132,0,32152,54,78,5.2631578947368425,5.0
9830,288,52,288,93,48,4,2.083333333333333,29.95
9831,21144,190,0,940,147,43,100.0,0.0
9832,659424,579,0,13758,236,343,100.0,0.0
9833,47208,26,47208,2994,22,4,7.6923076923076925,67.75
9834,276,8,276,66,4,4,100.0,100.0
9835,8376,11,8376,649,10,1,10.0,81.9
9836,4968,0,4968,0,0,0,100.0,100.0
9837,300,9,300,74,9,0,9.090909090909092,82.59
9838,4632,26,4632,1100,22,4,5.555555555555555,80.91
9839,1464,10,1464,415,7,3,20.0,52.88
9840,3312,106,3312,2308,77,29,1.6666666666666667,54.47
9841,9024,156,0,784,94,62,100.0,0.0
9842,3938544,5746,1586880,799666,3270,2476,1.0,0.0
9843,924,37,924,33,35,2,2.7777777777777777,46.48
9844,1092,0,1092,0,0,0,50.0,60.1
9845,7068,47,7068,1149,47,0,50.0,17.15
9846,78144,10,78144,925,10,0,8.333333333333334,45.77
9847,78672,7,78672,421,7,0,12.5,78.65
9848,2745480,34,0,250122,28,6,33.333333333333336,0.0
9849,3275484,1347,253404,88773,695,652,1.0,0.0
9850,11580,14,11580,3180,11,3,14.285714285714286,49.81
9851,372,6,372,158,6,0,12.5,43.46
9852,312,8,312,192,8,0,11.11111111111111,62.74
9853,5256,47,5256,9,44,3,2.272727272727273,59.72
9854,84,0,84,0,0,0,50.0,80.0
9855,889116,304,0,6040,150,154,4.166666666666667,0.0
9856,747204,14,747204,24852,11,3,7.6923076923076925,95.88
9857,1680,50,1680,1001,50,0,1.9230769230769231,15.19
9858,22392,27,0,1582,24,3,100.0,0.0
9859,3765012,760,0,68863,434,326,1.075268817204301,0.0
9860,86832,3,86832,33016,3,0,16.666666666666668,39.29
9861,3842616,5087,1169160,1965719,3018,2069,1.0,0.0
9862,5172,51,0,1121,41,10,100.0,100.0
9863,3780,38,0,1228,20,18,16.666666666666668,0.0
9864,360,12,360,185,11,1,10.0,39.45
9865,3000,118,0,905,81,37,100.0,0.0
9866,918876,40,918876,28367,28,12,4.166666666666667,60.57
9867,6924,69,6924,47,41,28,3.4482758620689653,65.27
9868,2172,8,2172,57,6,2,14.285714285714286,91.05
9869,857664,262,0,10040,132,130,2.9411764705882355,0.0
9870,3536700,93,0,127940,49,44,4.761904761904762,0.0
9871,1876836,164,1792344,57856,72,92,7.142857142857143,1.83
9872,3950628,19789,204012,1426624,11029,8760,1.0,0.0
9873,1420944,175,0,34060,73,102,4.166666666666667,0.0
9874,2352,10,2352,72,10,0,9.090909090909092,85.24
9875,3876864,875,0,73307,500,375,1.0,0.0
9876,14988,5,14988,242,5,0,16.666666666666668,93.7
9877,2509968,577,0,17503,327,250,1.5873015873015872,0.0
9878,3941304,1804,0,2299473,1007,797,1.0,0.0
9879,8472,9,8472,389,3,6,25.0,85.64
9880,1683192,159,0,22136,81,78,3.8461538461538463,0.0
9881,180,1,180,12,1,0,33.333333333333336,78.05
9882,28920,5,28920,4824,5,0,14.285714285714286,95.14
9883,336,122,216,111,87,35,1.3888888888888888,17.85
9884,1019220,174,360,11810,132,42,1.0,21.02
9885,5796,118,5796,3534,106,12,1.0,23.68
9886,288,6,0,74,4,2,100.0,0.0
9887,29892,12,15732,3354,10,2,12.5,82.79
9888,1520172,51,0,59069,41,10,20.0,0.0
9889,2856,36,2856,605,33,3,2.9411764705882355,35.59
9890,80568,36,0,5211,35,1,50.0,0.0
9891,462432,50,0,29416,39,11,20.0,0.0
9892,1800324,1067,1800324,7580,777,290,1.0,0.0
9893,59292,21,59292,811,18,3,7.142857142857143,72.66
9894,3950304,1629,0,128070,882,747,1.0,0.0
9895,1440,33,0,507,27,6,100.0,0.0
9896,15648,157,0,1167,88,69,100.0,0.0
9897,217152,26,8964,20172,21,5,5.555555555555555,83.54
9898,192,3,192,32,2,1,33.333333333333336,56.29
9899,1008,20,1008,211,11,9,25.0,59.02
9900,3627720,267,0,145105,134,133,2.5641025641025643,0.0
9901,504,5,432,304,4,1,16.666666666666668,53.58
9902,2136,19,2136,352,15,4,6.666666666666667,80.98
9903,13128,5,13128,2858,3,2,2.5641025641025643,2.36
9904,2220,41,0,884,32,9,100.0,0.0
9905,1666860,53,0,112725,45,8,16.666666666666668,0.0
9906,780,35,780,24,31,4,3.225806451612903,6.71
9907,19320,162,0,988,120,42,100.0,0.0
9908,132,7,132,10,5,2,20.0,69.37
9909,44916,50,0,1744,39,11,50.0,0.0
9910,948,36,948,31,32,4,3.125,55.32
9911,3963276,19706,0,1027513,10995,8711,1.0,1.44
9912,108,0,108,0,0,0,100.0,100.0
9913,504,88,504,261,36,52,8.333333333333334,80.6
9914,3151908,789,0,35642,428,361,1.1764705882352942,0.0
9915,3648,7,3648,389,7,0,12.5,92.92
9916,3641148,1678,1538736,633064,748,930,1.0,1.5
9917,276,5,276,9,5,0,14.285714285714286,90.06
9918,21648,18,0,3662,15,3,100.0,0.0
9919,348,10,348,148,10,0,7.6923076923076925,38.69
9920,48960,49,0,1674,37,12,50.0,0.0
9921,708,26,708,111,19,7,7.142857142857143,49.4
9922,312,53,312,65,49,4,2.0408163265306123,55.27
9923,11892,14,11892,1703,13,1,11.11111111111111,76.16
9924,7200,19,7200,358,17,2,5.882352941176471,84.99
9925,3967704,2546,0,3347998,1470,1076,1.0,0.0
9926,3770640,684,0,15400,389,295,1.408450704225352,0.0
9927,884676,35,4116,35202,27,8,33.333333333333336,0.0
9928,9648,182,0,6475,164,18,1.0,0.0
9929,468,39,468,27,33,6,2.9411764705882355,56.43
9930,336,15,336,187,11,4,10.0,43.73
9931,3799512,127,0,739538,87,40,3.125,0.0
9932,660,49,660,35,43,6,2.380952380952381,61.03
9933,9252,45,9252,45,38,7,2.7777777777777777,56.85
9934,1449432,39,1449432,151472,37,2,2.7777777777777777,31.51
9935,217560,36,0,30126,26,10,5.882352941176471,0.0
9936,10800,17,10800,4465,13,4,2.083333333333333,8.8
9937,24552,4,24552,234,3,1,33.333333333333336,85.37
9938,6384,35,2616,2478,32,3,33.333333333333336,0.0
9939,1620,10,1488,673,7,3,2.3255813953488373,10.92
9940,468,57,468,154,43,14,2.631578947368421,51.75
9941,1080,0,1080,0,0,0,100.0,100.0
9942,24660,27,24660,1267,23,4,5.0,81.9
9943,456,9,408,192,7,2,11.11111111111111,35.83
9944,86604,56,0,6281,47,9,100.0,0.0
9945,51636,18,51432,9042,14,4,9.090909090909092,50.79
9946,505476,29,36780,45352,22,7,7.6923076923076925,80.49
9947,2112,17,1500,592,12,5,2.380952380952381,18.14
9948,100008,151,0,5495,112,39,50.0,0.0
9949,2592816,87,2592816,10869,63,24,11.11111111111111,4.0
9950,1184652,440,0,27428,233,207,3.0303030303030303,0.0
9951,10752,17,10752,884,16,1,7.6923076923076925,78.92
9952,3741876,811,1820856,42330,423,388,1.3333333333333333,9.0
9953,3492,13,3492,494,12,1,8.333333333333334,85.08
9954,1704,25,0,630,22,3,50.0,86.11
9955,3564,0,3564,0,0,0,100.0,0.0
9956,1379244,2,1379244,45114,1,1,50.0,99.97
9957,184356,22,184356,557,19,3,8.333333333333334,64.17
9958,69024,23,13356,3403,21,2,5.0,83.21
9959,3792,14,0,1104,9,5,33.333333333333336,0.0
9960,91380,45,0,3098,33,12,50.0,0.0
9961,9900,28,0,2695,23,5,33.333333333333336,0.0
9962,240,8,240,103,5,3,25.0,54.24
9963,14700,55,0,2706,47,8,33.333333333333336,0.0
9964,130692,19,1548,24793,16,3,7.6923076923076925,88.94
9965,120,0,120,0,0,0,50.0,58.44
9966,324,16,324,161,10,6,14.285714285714286,50.56
9967,420,44,420,294,32,12,3.4482758620689653,51.22
9968,29088,14,29088,650,13,1,9.090909090909092,36.98
9969,9792,23,9792,395,20,3,5.2631578947368425,88.01
9970,8976,26,8976,780,21,5,6.25,40.18
9971,276,47,276,73,40,7,2.631578947368421,48.92
9972,1260,6,1260,312,6,0,12.5,50.56
9973,3623604,322,0,93769,182,140,2.7777777777777777,0.0
9974,108024,44,0,4557,36,8,100.0,0.0
9975,3968856,1608,0,328023,860,748,1.3157894736842106,0.0
9976,2593296,51,0,111450,36,15,20.0,0.0
9977,372,57,372,88,41,16,2.7777777777777777,51.04
9978,16680,124,16680,13726,110,14,1.0,23.32
9979,26940,49,0,1185,36,13,50.0,0.0
9980,408,9,288,114,6,3,16.666666666666668,21.99
9981,1066452,33,759036,63012,28,5,5.2631578947368425,24.4
9982,684,36,660,431,34,2,2.9411764705882355,56.19
9983,12156,13,12144,8457,11,2,2.0,4.77
9984,540,65,540,7,55,10,1.9230769230769231,32.86
9985,357672,51,0,7986,30,21,100.0,0.0
9986,13680,19,13680,438,15,4,10.0,84.6
9987,2136,51,0,880,40,11,50.0,58.33
9988,13092,17,4732,787,9,8,33.333333333333336,0.0
9989,15792,27,15792,934,22,5,8.333333333333334,84.76
9990,143928,5,143928,143851,2,3,50.0,99.63
9991,3993912,21654,529821,575830,11820,9834,1.0,0.0
9992,2220408,80,0,178074,69,11,20.0,0.0
9993,105624,756,52944,13409,502,254,1.0,14.56
9994,1836816,5,938334,1305,4,1,16.666666666666668,89.51
9995,660,42,660,333,38,4,2.631578947368421,43.75
9996,3977940,105,0,2163289,82,23,10.0,0.0
9997,146736,948,41007,16995,649,299,1.0,1.38
9998,3612,92,0,1363,71,21,100.0,0.0
9999,2136,65,2136,1688,45,20,2.702702702702702,65.72
10000,81828,9,81828,7596,4,5,14.285714285714286,0.0
10001,40584,42,0,3864,37,5,50.0,0.0
10002,11448,36,11448,1555,36,0,5.882352941176471,31.46
10003,6744,4,6744,3288,3,1,20.0,86.1
10004,13632,35,0,4785,31,4,100.0,0.0
10005,3768120,95,0,190392,75,20,33.333333333333336,0.0
10006,192,100,192,46,74,26,3.8461538461538463,70.25
10007,2073672,54,0,39812,41,13,20.0,0.0
10008,50028,36,50028,359,27,9,5.0,0.78
10009,43764,32,0,3117,20,12,50.0,0.0
10010,96,5,96,0,5,0,16.666666666666668,95.0
10011,35916,48,0,1469,36,12,50.0,0.0
10012,408192,51,0,27114,40,11,50.0,0.0
10013,1092,64,1092,208,51,13,2.2222222222222223,45.47
10014,3779496,84,0,241447,52,32,7.142857142857143,0.0
10015,17496,47,0,1121,37,10,50.0,0.0
10016,5448,43,5448,1429,42,1,3.703703703703704,23.42
10017,12240,58,0,2675,51,7,100.0,0.0
10018,395088,5,60,217869,3,2,1.0,0.0
10019,11556,6,11556,2488,5,1,20.0,95.9
10020,64932,62,0,4992,52,10,100.0,0.0
10021,3998916,680,2712,1860030,384,296,1.0,0.0
10022,612,37,612,58,31,6,3.333333333333333,60.36
10023,38844,11,38844,4693,8,3,12.5,91.22
10024,3588,40,3588,963,39,1,11.11111111111111,30.01
10025,21780,53,0,1039,42,11,50.0,0.0
10026,363000,56,0,7458,34,22,100.0,0.0
10027,2508,40,2508,1035,31,9,8.333333333333334,0.0
10028,39936,66,0,3193,40,26,3.333333333333333,0.0
10029,528,37,528,307,35,2,2.7777777777777777,53.44
10030,9828,39,9828,636,28,11,5.0,0.77
10031,3830064,2169,0,523950,1264,905,1.0,0.0
10032,11076,2,11076,48,1,1,100.0,99.88
10033,37872,21,37872,1134,16,5,9.090909090909092,55.89
10034,101532,161,75312,6156,114,47,1.7857142857142858,5.83
10035,863124,797,416326,290447,797,0,1.0,71.48
10036,53784,8,480,11571,7,1,14.285714285714286,94.6
10037,1725480,109,1197288,214911,99,10,1.5625,6.54
10038,3937596,3365,1184472,445651,1925,1440,1.0,0.0
10039,108,2,108,0,2,0,25.0,69.48
10040,3036,52,3036,629,41,11,3.4482758620689653,0.65
10041,2593500,97,0,29571,69,28,1.96078431372549,0.0
10042,2624256,304,2624256,15639,192,112,5.0,0.0
10043,40620,34,40620,889,29,5,5.0,30.59
10044,4416,19,4416,1028,18,1,5.2631578947368425,87.97
10045,468,34,468,114,32,2,4.545454545454546,81.21
10046,3037620,852,1860312,54653,448,404,1.0,5.07
10047,5220,15,5220,963,13,2,8.333333333333334,71.31
10048,528,24,528,61,22,2,4.3478260869565215,72.24
10049,0,0,0,0,0,0,100.0,0.0
10050,682044,204,0,34196,109,95,3.4482758620689653,0.0
10051,2359632,1573,9348,30944,1044,529,1.2195121951219512,0.0
10052,9864,38,9864,2302,38,0,3.8461538461538463,29.56
10053,55644,7,55644,608,7,0,11.11111111111111,45.95
10054,247764,2,247764,21618,2,0,20.0,49.21
10055,4656,51,4656,735,39,12,3.703703703703704,0.65
10056,480,44,480,87,35,9,3.703703703703704,44.66
10057,13776,56,13776,5345,25,31,33.333333333333336,98.84
10058,50904,229,0,1874,134,95,50.0,0.0
10059,3903312,2344,0,336752,1320,1024,1.098901098901099,0.0
10060,40824,28,0,1658,23,5,50.0,0.0
10061,66288,2,66288,0,2,0,25.0,76.81
10062,1280664,5,1280664,67708,5,0,14.285714285714286,92.86
10063,14424,39,14424,25,36,3,2.702702702702702,48.58
10064,720,41,720,103,34,7,4.0,54.23
10065,2820,54,2820,580,42,12,3.225806451612903,0.63
10066,260172,65,31500,44413,50,15,4.545454545454546,62.4
10067,3840132,585,1867224,539113,336,249,1.6666666666666667,0.0
10068,2065908,1626,1869060,8708,1105,521,1.0,0.0
10069,4404,83,4404,523,64,19,1.818181818181818,44.11
10070,432,3,432,300,1,2,50.0,78.73
10071,564,50,564,304,46,4,2.1739130434782608,36.66
10072,948,18,948,752,16,2,5.0,59.1
10073,984,34,984,483,34,0,12.5,23.64
10074,51120,14,51120,1189,13,1,9.090909090909092,80.5
10075,24492,6,24492,2110,6,0,12.5,94.63
10076,54180,44,0,2447,32,12,50.0,0.0
10077,8076,27,8076,368,23,4,5.2631578947368425,0.72
10078,3160860,68,0,196021,40,28,6.25,0.0
10079,252,19,252,38,15,4,7.6923076923076925,49.97
10080,6324,16,6324,384,16,0,5.882352941176471,82.14
10081,2436,11,2436,2354,7,4,20.0,57.92
10082,753456,53,0,16616,41,12,25.0,0.0
10083,3252,55,3252,588,43,12,3.225806451612903,1.63
10084,804,96,804,250,42,54,6.25,19.83
10085,2774148,104,0,227795,34,70,16.666666666666668,0.0
10086,27768,52,27768,61,39,13,3.0303030303030303,60.53
10087,178488,852,56724,13784,584,268,1.0,35.18
10088,4020,5,4020,1608,4,1,25.0,94.21
10089,89976,659,56076,10472,461,198,1.0,9.09
10090,288,13,288,127,11,2,8.333333333333334,42.05
10091,9432,21,9432,654,20,1,5.0,86.2
10092,42000,60,0,2353,55,5,50.0,0.0
10093,888,17,720,364,14,3,7.142857142857143,48.41
10094,552,35,552,1,35,0,2.702702702702702,55.3
10095,1822920,531,534132,154820,481,50,1.1235955056179776,11.76
10096,58872,16,58872,645,14,2,12.5,31.45
10097,2160,21,2148,757,16,5,100.0,0.0
10098,1308,6,1308,438,4,2,20.0,97.14
10099,1608,5,1608,734,4,1,50.0,50.0
10100,3516,46,3516,533,38,8,3.333333333333333,1.4
10101,2272524,434,0,21456,234,200,3.0303030303030303,0.0
10102,77160,2,1608,876,2,0,25.0,99.83
10103,34704,40,0,3595,32,8,100.0,0.0
10104,5352,19,5352,496,18,1,5.555555555555555,80.55
10105,344676,118,0,8640,104,14,50.0,0.0
10106,29280,49,0,1194,37,12,50.0,0.0
10107,184344,12,184344,162834,12,0,2.9411764705882355,42.82
10108,444,52,444,280,40,12,2.857142857142857,41.14
10109,5028,21,5028,462,19,2,5.2631578947368425,86.35
10110,185352,2,185352,5166,2,0,14.285714285714286,32.25
10111,3159744,75,0,226596,59,16,16.666666666666668,0.0
10112,2712,27,2712,565,24,3,5.882352941176471,89.78
10113,42768,106,0,2555,80,26,50.0,0.0
10114,36780,0,36780,0,0,0,50.0,56.25
10115,23508,21,23508,1230,17,4,9.090909090909092,85.52
10116,258420,3,258420,352,3,0,25.0,29.79
10117,3080304,92,2484054,28313,34,58,10.0,85.62
10118,3708,76,0,1501,61,15,100.0,0.0
10119,384,10,384,176,9,1,11.11111111111111,39.12
10120,8148,43,0,1598,38,5,100.0,0.0
10121,16896,24,16896,587,21,3,5.2631578947368425,80.22
10122,64332,22,64332,1106,18,4,8.333333333333334,24.45
10123,4932,12,4932,40,12,0,7.142857142857143,64.01
10124,19956,10,19956,500,9,1,12.5,88.59
10125,444,12,396,212,10,2,7.142857142857143,40.78
10126,40032,55,0,1511,43,12,50.0,0.0
10127,73392,14,73392,1036,12,2,11.11111111111111,39.56
10128,1465620,68,0,27930,59,9,50.0,0.0
10129,14016,5,14016,1010,5,0,20.0,0.17
10130,576,54,576,256,44,10,2.4390243902439024,38.03
10131,466464,21,6888,22872,19,2,5.555555555555555,42.72
10132,31860,20,31860,988,16,4,10.0,77.21
10133,1800,6,1800,614,5,1,20.0,0.17
10134,3264,11,3264,304,8,3,14.285714285714286,97.53
10135,773436,501,611376,407353,501,0,1.0,75.43
10136,9312,19,9312,374,17,2,5.882352941176471,84.84
10137,68340,50,0,2433,31,19,100.0,0.0
10138,46176,49,0,1526,35,14,50.0,0.0
10139,169800,80,0,4421,68,12,100.0,0.0
10140,668880,17,40476,40183,16,1,7.142857142857143,79.8
10141,1740,4,1740,381,3,1,25.0,93.78
10142,4956,0,4956,0,0,0,100.0,100.0
10143,4061580,13989,103416,1102367,7816,6173,1.0,0.0
10144,6528,24,0,1226,21,3,100.0,0.0
10145,1286520,183,0,60466,89,94,5.882352941176471,0.0
10146,1200,7,1200,348,5,2,33.333333333333336,99.49
10147,3923424,416,2235488,662982,415,1,1.0,77.95
10148,4080,23,4080,475,20,3,5.555555555555555,85.67
10149,22080,54,0,3699,45,9,100.0,0.0
10150,16656,24,16656,452,21,3,5.2631578947368425,83.53
10151,301452,77,144660,146279,76,1,1.2987012987012987,31.75
10152,30612,60,0,9589,49,11,50.0,0.0
10153,24072,57,0,1291,43,14,50.0,0.0
10154,65100,63,0,10248,54,9,100.0,0.0
10155,225816,20,0,107859,9,11,14.285714285714286,0.0
10156,636,60,636,268,52,8,2.1739130434782608,30.52
10157,58992,49,0,2240,32,17,100.0,0.0
10158,3480,12,3480,387,8,4,25.0,82.42
10159,4055232,749,0,387828,442,307,1.0309278350515465,1.33
10160,3543852,726,0,94921,381,345,2.857142857142857,1.99
10161,35424,36,0,4306,21,15,50.0,0.0
10162,4076856,29681,2669024,2003455,16606,13075,1.0,0.0
10163,44172,11,44172,605,10,1,14.285714285714286,40.2
10164,3419232,58,0,266750,40,18,20.0,0.0
10165,1972176,573,0,30458,314,259,2.631578947368421,0.0
10166,18624,69,0,1305,44,25,100.0,0.0
10167,41628,198,0,20666,152,46,50.0,0.0
10168,40548,55,40548,548,43,12,3.125,1.28
10169,27408,53,0,1251,38,15,50.0,0.0
10170,24960,4,24960,654,4,0,20.0,1.02
10171,2736,30,2736,408,28,2,3.703703703703704,0.61
10172,87000,47,0,3729,39,8,25.0,0.0
10173,4452,7,4452,1044,7,0,12.5,93.0
10174,1032,1,1032,36,1,0,33.333333333333336,97.41
10175,708,18,708,303,9,9,20.0,70.95
10176,46536,35,46536,104,33,2,2.9411764705882355,31.67
10177,2325420,29,0,82533,26,3,25.0,0.0
10178,2623956,22,2623956,29912,8,14,25.0,98.52
10179,3562500,1121,0,115817,647,474,1.0101010101010102,0.0
10180,255540,93,255540,69162,74,19,3.571428571428572,2.05
10181,2952,53,0,1208,44,9,100.0,0.0
10182,1200,8,1200,382,7,1,14.285714285714286,87.26
10183,2184,49,2184,621,39,10,3.571428571428572,0.6
10184,624,1,624,180,1,0,50.0,99.9
10185,21984,48,0,1170,34,14,50.0,0.0
10186,57000,34,57000,2139,33,1,100.0,31.34
10187,840,40,840,637,38,2,2.5641025641025643,34.2
10188,3991524,497,1927524,1218862,207,290,2.0408163265306123,0.0
10189,21348,49,0,1184,39,10,50.0,0.0
10190,44184,20,44184,1818,16,4,11.11111111111111,82.39
10191,2196,6,2196,1870,6,0,12.5,97.3
10192,1355424,64,0,96566,48,16,4.545454545454546,0.0
10193,32076,39,32076,30,31,8,3.4482758620689653,62.98
10194,528,43,528,173,31,12,4.0,61.9
10195,3864,35,3852,3535,28,7,4.166666666666667,48.01
10196,21048,51,0,1636,32,19,100.0,0.0
10197,5712,45,5712,1093,45,0,14.285714285714286,19.19
10198,924,1,924,156,1,0,50.0,99.99
10199,1805940,81,1375488,282975,71,10,2.127659574468085,10.53
10200,307776,4,307776,14700,4,0,20.0,90.0
10201,8856,53,8856,1080,40,13,3.8461538461538463,0.79
10202,288684,47,288684,241,42,5,2.380952380952381,69.31
10203,3953688,3,1416,1318184,3,0,25.0,96.17
10204,2604,34,2604,468,31,3,4.3478260869565215,26.34
10205,1164,4,1164,285,4,0,16.666666666666668,93.03
10206,137316,47,137316,2118,40,7,100.0,100.0
10207,696,34,696,145,30,4,3.703703703703704,54.83
10208,1404,55,1404,918,55,0,1.7543859649122806,11.86
10209,1356,13,1356,388,12,1,7.6923076923076925,89.59
10210,21708,71,0,1172,59,12,1.818181818181818,0.0
10211,1140,2,1140,150,2,0,33.333333333333336,99.05
10212,1128,9,1128,230,8,1,25.0,82.53
10213,2699508,11,3432,245888,10,1,10.0,95.34
10214,3627552,2232,1946796,28070,1554,678,1.0,5.0
10215,156,0,156,0,0,0,50.0,80.0
10216,1824,2,0,1824,0,2,33.333333333333336,12.84
10217,33516,367,32766,24405,152,215,1.0,0.0
10218,168,14,168,12,14,0,6.25,86.35
10219,16548,187,0,2465,127,60,100.0,0.0
10220,540,3,0,284,2,1,50.0,0.0
10221,120,13,120,19,11,2,9.090909090909092,51.74
10222,1092,22,1092,86,19,3,5.555555555555555,19.04
10223,3900,4,3900,426,4,0,20.0,90.08
10224,319716,10,319716,19320,9,1,7.6923076923076925,23.55
10225,108,16,108,16,13,3,8.333333333333334,50.79
10226,1260,65,1260,977,57,8,1.851851851851852,31.67
10227,13392,42,13392,835,36,6,3.4482758620689653,0.59
10228,106188,16,2628,7070,13,3,7.6923076923076925,76.21
10229,5496,53,5496,4776,53,0,1.818181818181818,5.04
10230,168,4,168,42,2,2,50.0,55.81
10231,82860,270,0,2807,159,111,1.2658227848101269,5.0
10232,4002168,527,1341066,1804190,296,231,1.0,0.0
10233,61512,0,61512,0,0,0,50.0,82.0
10234,8760,1,8760,264,1,0,33.333333333333336,85.9
10235,20904,30,20904,621,29,1,33.333333333333336,32.2
10236,984,41,984,6,41,0,2.3255813953488373,49.79
10237,31380,46,7500,1539,39,7,3.225806451612903,0.42
10238,0,0,0,0,0,0,50.0,10.0
10239,2028,23,2028,1642,21,2,4.545454545454546,82.04
10240,3360,3,3318,0,3,0,20.0,94.03
10241,74940,29,0,8905,19,10,100.0,0.0
10242,26208,53,0,1617,34,19,100.0,0.0
10243,20436,1,20436,1128,1,0,50.0,99.68
10244,29280,48,0,1412,36,12,50.0,0.0
10245,244224,1,244224,1020,1,0,16.666666666666668,30.87
10246,4872,43,4872,1042,41,2,3.8461538461538463,25.19
10247,3552,30,3552,399,25,5,4.761904761904762,0.64
10248,3600,57,3600,2820,57,0,1.694915254237288,7.08
10249,3641100,32,0,116726,25,7,25.0,0.0
10250,4100676,3701,1049528,233583,2042,1659,1.0,0.0
10251,8328,7,8328,555,7,0,14.285714285714286,54.46
10252,176112,37,139136,12635,37,0,2.127659574468085,30.35
10253,86832,56,0,5926,43,13,25.0,0.0
10254,1080,1,1080,84,1,0,33.333333333333336,96.16
10255,4704,43,4704,1080,42,1,25.0,19.59
10256,203316,45,203316,21035,36,9,4.166666666666667,59.67
10257,4023528,1490,32700,86965,825,665,1.0416666666666667,0.0
10258,456,11,456,142,8,3,16.666666666666668,42.56
10259,4932,27,4932,890,24,3,4.3478260869565215,0.56
10260,68028,41,68028,80,27,14,4.545454545454546,71.07
10261,97068,4,5292,96771,4,0,33.333333333333336,0.0
10262,24924,310,0,4336,188,122,1.3333333333333333,0.0
10263,144,10,144,50,6,4,25.0,76.7
10264,14040,231,0,1333,127,104,100.0,0.0
10265,3252,11,3252,540,8,3,14.285714285714286,88.66
10266,21120,29,21120,1797,23,6,8.333333333333334,63.91
10267,264,1,264,36,1,0,50.0,98.0
10268,2396352,55,0,82038,39,16,33.333333333333336,0.0
10269,72,7,72,34,5,2,25.0,90.58
10270,980160,51,0,25615,36,15,25.0,0.0
10271,3641328,13,2304,2773772,13,0,14.285714285714286,0.0
10272,26496,17,26496,472,15,2,6.666666666666667,87.79
10273,6468,37,6468,917,36,1,100.0,23.04
10274,59916,44,0,38240,38,6,100.0,0.0
10275,3560016,15,0,2141666,7,8,100.0,0.0
10276,61128,55,0,4832,52,3,50.0,0.0
10277,113928,28,113928,88584,28,0,3.703703703703704,52.82
10278,3480,8,3480,391,4,4,25.0,94.34
10279,1896240,13,1896216,148778,7,6,33.333333333333336,0.0
10280,87684,1,87684,492,1,0,50.0,75.75
10281,2364,68,0,955,52,16,100.0,0.0
10282,79620,28,79620,4367,20,8,9.090909090909092,85.37
10283,1046724,112,257688,81002,112,0,100.0,100.0
10284,17904,51,0,1071,38,13,50.0,0.0
10285,63588,31,0,5609,26,5,4.545454545454546,6.0
10286,780,11,0,493,6,5,100.0,100.0
10287,480,18,480,208,13,5,8.333333333333334,42.44
10288,600,4,600,366,4,0,16.666666666666668,46.17
10289,49812,51,0,2418,39,12,50.0,0.0
10290,118080,7,26176,18600,6,1,25.0,98.89
10291,2964,29,2964,2772,23,6,7.142857142857143,64.01
10292,11616,20,11616,613,18,2,5.555555555555555,86.54
10293,307440,44,0,11136,36,8,33.333333333333336,0.0
10294,14868,39,0,6757,35,4,100.0,0.0
10295,1795932,75,1772184,367848,68,7,1.7543859649122806,12.1
10296,2364,41,0,1040,21,20,5.0,1.06
10297,4006692,298,0,881632,99,199,1.0,0.0
10298,12336,21,5760,1025,18,3,5.555555555555555,84.21
10299,6156,9,6156,1249,7,2,16.666666666666668,94.87
10300,3427212,63,0,399064,47,16,14.285714285714286,0.0
10301,73572,59,0,2368,37,22,100.0,0.0
10302,24228,10,24228,888,10,0,10.0,90.26
10303,113244,11,113244,651,10,1,20.0,43.36
10304,2806968,874,0,73685,464,410,1.7543859649122806,0.0
10305,408,6,408,206,6,0,12.5,49.15
10306,1544688,24,8424,64736,20,4,5.2631578947368425,82.93
10307,126276,929,95592,122438,909,20,100.0,0.0
10308,200952,100,0,18654,84,16,50.0,0.0
10309,558396,42,0,23171,39,3,33.333333333333336,0.0
10310,18624,59,0,1143,41,18,50.0,0.0
10311,2563704,56,0,149644,46,10,16.666666666666668,0.0
10312,104568,13,104568,792,12,1,12.5,82.95
10313,4140756,877,0,71352,490,387,1.8867924528301887,0.0
10314,1512336,26,417408,196651,21,5,7.142857142857143,40.42
10315,60,3,60,24,2,1,33.333333333333336,58.67
10316,3097524,48,0,65650,36,12,33.333333333333336,0.0
10317,9036,34,0,2910,29,5,100.0,0.0
10318,1587480,56,0,30921,47,9,50.0,0.0
10319,422088,37,422088,15292,31,6,4.3478260869565215,23.48
10320,2309052,260,0,406981,140,120,1.4705882352941178,0.0
10321,31044,59,0,5437,52,7,50.0,0.0
10322,145464,62,0,5674,55,7,33.333333333333336,0.0
10323,3768,58,3768,2967,58,0,1.6666666666666667,6.13
10324,41904,57,41904,1097,46,11,2.857142857142857,0.84
10325,36612,40,36612,877,39,1,33.333333333333336,31.74
10326,1404,35,1404,396,33,2,2.9411764705882355,55.94
10327,28548,54,0,1252,38,16,50.0,0.0
10328,1944,26,1944,420,22,4,5.0,0.64
10329,1044,11,984,677,8,3,33.333333333333336,91.77
10330,189564,13,189564,587,11,2,10.0,72.96
10331,426348,8,394812,59338,6,2,6.25,0.0
10332,5196,2,0,2838,2,0,33.333333333333336,0.0
10333,2604,0,2604,0,0,0,50.0,87.0
10334,2052,29,2052,499,24,5,4.761904761904762,0.62
10335,2472,49,0,1031,39,10,100.0,0.0
10336,2663436,27,1866840,79783,15,12,20.0,0.0
10337,285624,47,0,33203,39,8,33.333333333333336,0.0
10338,3828,17,0,873,14,3,50.0,0.0
10339,52176,3,0,17436,2,1,50.0,0.0
10340,40152,39,0,4297,32,7,50.0,0.0
10341,42108,36,42108,12217,24,12,6.666666666666667,62.68
10342,300,7,120,231,5,2,33.333333333333336,79.21
10343,88860,51,88860,30356,41,10,5.0,1.51
10344,2964,25,2964,636,21,4,4.761904761904762,70.71
10345,672,0,672,0,0,0,100.0,100.0
10346,1119264,4,24960,279897,4,0,25.0,95.42
10347,2676,27,1920,472,23,4,5.0,58.56
10348,1152,10,1152,96,8,2,9.090909090909092,78.37
10349,4164180,1903,0,1548584,1370,533,1.0,0.0
10350,32832,57,0,4160,46,11,33.333333333333336,0.0
10351,2112,5,2112,1308,3,2,100.0,100.0
10352,1476,2,192,1452,1,1,50.0,80.0
10353,47340,12,47340,945,11,1,9.090909090909092,82.8
10354,1764,0,1764,0,0,0,50.0,55.14
10355,1140,83,1140,348,63,20,1.7857142857142858,2.5
10356,1980,12,1980,1700,12,0,7.6923076923076925,76.46
10357,648,31,648,277,31,0,3.0303030303030303,48.05
10358,504,1,504,276,1,0,33.333333333333336,95.09
10359,35484,19,4260,2789,17,2,9.090909090909092,4.17
10360,33948,54,33948,738,45,9,2.4390243902439024,58.24
10361,552,64,552,221,46,18,2.631578947368421,55.11
10362,319440,190,0,4326,132,58,100.0,100.0
10363,9276,11,96,865,10,1,8.333333333333334,57.77
10364,131580,16,131580,1194,13,3,11.11111111111111,38.85
10365,1380,83,0,125,65,18,100.0,0.0
10366,4141344,1594,2028084,1454979,850,744,1.0,34.5
10367,1200,44,1200,339,44,0,2.2222222222222223,66.43
10368,156,4,156,6,4,0,16.666666666666668,52.45
10369,1044,0,1044,0,0,0,33.333333333333336,96.0
10370,3752700,338,0,79965,193,145,2.1739130434782608,0.0
10371,2628,8,2628,2191,4,4,25.0,0.0
10372,35172,44,35172,17,43,1,2.2222222222222223,53.03
10373,175536,46,175536,143051,40,6,2.7777777777777777,65.17
10374,204720,19,204720,9363,17,2,8.333333333333334,33.44
10375,283524,61,283524,248842,56,5,1.851851851851852,43.29
10376,79584,14,79584,48743,12,2,8.333333333333334,93.29
10377,12024,2,12024,36,1,1,100.0,100.0
10378,34440,10,34440,598,9,1,11.11111111111111,85.11
10379,276,3,276,20,3,0,20.0,53.94
10380,3993108,2091,0,71756,1204,887,1.0,0.0
10381,576,47,576,49,47,0,2.0408163265306123,40.6
10382,537732,26,0,21715,21,5,100.0,100.0
10383,528,27,528,335,11,16,20.0,86.46
10384,1992,28,0,293,25,3,50.0,0.0
10385,54792,310,0,2823,174,136,100.0,0.0
10386,4076064,6499,2031432,772862,4753,1746,1.0,0.0
10387,2028,59,2028,1813,59,0,1.639344262295082,11.88
10388,4524,175,0,955,124,51,100.0,0.0
10389,2436,3,2436,2188,3,0,20.0,94.16
10390,2777304,39,2406984,6390,16,23,12.5,75.82
10391,11160,3,11160,292,3,0,20.0,4.92
10392,336,0,336,0,0,0,50.0,0.0
10393,2316,54,2316,1042,41,13,7.142857142857143,23.62
10394,256908,39,256908,8008,36,3,2.857142857142857,40.15
10395,26268,536,0,5036,314,222,1.0,0.0
10396,564,31,564,118,30,1,3.8461538461538463,42.58
10397,29964,200,0,3003,110,90,1.5151515151515151,0.0
10398,60924,292,0,2444,157,135,1.4492753623188406,5.0
10399,477456,5,477456,30112,5,0,100.0,100.0
10400,28908,37,28908,3216,34,3,16.666666666666668,26.02
10401,768,34,768,0,34,0,2.7777777777777777,45.42
10402,239544,58,239544,54311,53,5,2.7777777777777777,5.69
10403,1848,84,1848,1641,64,20,1.851851851851852,26.22
10404,4152,11,4152,1570,7,4,16.666666666666668,78.23
10405,30672,345,0,2637,197,148,100.0,0.0
10406,528,54,528,124,32,22,4.3478260869565215,71.23
10407,2663664,341,2663664,44552,126,215,2.7777777777777777,79.86
10408,252,17,252,88,10,7,20.0,50.02
10409,1716,39,1716,16,35,4,2.857142857142857,50.4
10410,4146720,4091,470376,493657,2333,1758,1.0,0.0
10411,2832,57,2832,105,37,20,3.4482758620689653,70.83
10412,912,42,912,1,42,0,2.272727272727273,59.42
10413,468,12,468,124,5,7,20.0,97.21
10414,88692,466,88692,3185,402,64,5.2631578947368425,88.02
10415,240,7,240,87,7,0,10.0,32.93
10416,73464,16,73464,1839,14,2,9.090909090909092,90.99
10417,504,49,504,47,37,12,3.0303030303030303,51.84
10418,3977664,2689,0,77361,1461,1228,1.0,1.25
10419,6936,72,0,1592,49,23,2.631578947368421,0.0
10420,5304,0,5304,0,0,0,100.0,100.0
10421,4165992,2127,2048328,98416,1121,1006,1.0,0.29
10422,300,12,300,130,9,3,12.5,47.47
10423,252,6,252,126,3,3,50.0,99.99
10424,4021896,65,0,152288,47,18,16.666666666666668,0.0
10425,72576,275,0,1704,182,93,100.0,0.0
10426,24288,26,24288,5071,23,3,7.142857142857143,4.62
10427,396,5,396,168,5,0,3.571428571428572,25.99
10428,3936,5,3936,727,4,1,25.0,83.1
10429,288,5,288,81,4,1,4.0,47.79
10430,1926144,52,0,112700,41,11,20.0,0.0
10431,69816,105,69816,1691,92,13,1.2195121951219512,10.1
10432,4212180,12488,0,1041282,6277,6211,1.0,0.0
10433,31500,21,0,4164,18,3,100.0,0.0
10434,86868,34,0,7154,24,10,50.0,0.0
10435,29856,39,0,2617,32,7,100.0,0.0
10436,160560,44,0,9257,39,5,100.0,0.0
10437,2627712,89,0,30687,42,47,16.666666666666668,0.0
10438,19368,23,19368,505,21,2,4.761904761904762,81.6
10439,1380,3,1380,312,3,0,25.0,98.85
10440,42120,59,0,3085,51,8,100.0,0.0
10441,2868396,41,408,70319,36,5,2.702702702702702,50.61
10442,1128036,17,73692,67273,15,2,11.11111111111111,84.5
10443,13092,27,13092,836,26,1,50.0,26.36
10444,504,5,504,228,5,0,14.285714285714286,47.99
10445,4189272,1716,60996,65417,1007,709,1.0,0.0
10446,2244,3,2244,468,3,0,33.333333333333336,98.8
10447,1068,33,1068,355,19,14,8.333333333333334,45.01
10448,57288,53,0,6211,43,10,50.0,0.0
10449,4009656,1162,0,427086,521,641,1.0,0.0
10450,2949720,620,0,43502,349,271,2.7777777777777777,0.0
10451,6108,13,6108,1693,10,3,3.4482758620689653,46.32
10452,16140,225,0,1253,124,101,1.5384615384615383,5.0
10453,5388,45,0,1663,38,7,33.333333333333336,0.0
10454,2889468,226,0,475873,58,168,1.075268817204301,6.74
10455,588,11,528,195,8,3,16.666666666666668,95.85
10456,47088,52,0,1734,38,14,50.0,0.0
10457,3738456,13,0,1306465,13,0,9.090909090909092,0.0
10458,2190396,49,0,137693,42,7,25.0,0.0
10459,480,12,480,62,8,4,3.703703703703704,47.38
10460,756,49,0,281,27,22,50.0,0.0
10461,120,2,120,42,1,1,50.0,58.69
10462,10044,211,0,1067,161,50,100.0,0.0
10463,2154132,29,0,80805,28,1,20.0,0.0
10464,50472,46,0,1764,31,15,50.0,0.0
10465,865932,353,865932,7638,292,61,3.703703703703704,56.39
10466,2244,133,2244,1918,72,61,1.5384615384615383,23.13
10467,55092,74,0,1919,56,18,50.0,0.0
10468,176760,165,176760,43142,146,19,1.5625,96.35
10469,9144,74,9144,179,55,19,2.1739130434782608,51.62
10470,1260,80,1260,86,34,46,7.6923076923076925,86.04
10471,2352,10,2352,2294,10,0,7.6923076923076925,93.37
10472,2244,50,2244,1160,38,12,1.6129032258064515,4.84
10473,13344,50,0,1874,43,7,100.0,0.0
10474,806028,241,0,98623,128,113,5.882352941176471,0.0
10475,14844,72,0,2642,62,10,50.0,0.0
10476,54768,14,54768,2268,14,0,8.333333333333334,71.71
10477,95988,8,95988,1606,5,3,20.0,43.9
10478,52548,36,0,4912,31,5,50.0,0.0
10479,6876,10,5952,3033,10,0,9.090909090909092,0.0
10480,228,0,228,0,0,0,50.0,36.0
10481,92472,86,92472,4596,69,17,1.5151515151515151,17.99
10482,35508,216,0,2040,126,90,50.0,0.0
10483,21948,19,21948,359,16,3,6.666666666666667,83.62
10484,516,27,516,10,25,2,3.8461538461538463,47.71
10485,2441424,98,2441424,38346,42,56,9.090909090909092,1.9
10486,3991800,669,0,45076,378,291,1.851851851851852,0.0
10487,38724,20,30504,3325,16,4,8.333333333333334,85.24
10488,42780,35,42780,29892,32,3,3.225806451612903,71.31
10489,535740,20,0,54909,19,1,50.0,0.0
10490,24456,21,24456,676,19,2,5.2631578947368425,80.89
10491,794076,12,35760,174881,8,4,14.285714285714286,0.0
10492,21948,7,21948,186,6,1,14.285714285714286,0.0
10493,21120,488,21120,10289,218,270,1.0,43.58
10494,2433096,105,0,31905,88,17,50.0,0.0
10495,792,48,792,113,48,0,2.0,43.41
10496,24132,6,24132,170,6,0,14.285714285714286,68.72
10497,1561308,974,0,71148,559,415,1.8867924528301887,0.0
10498,9780,10,9780,2258,9,1,14.285714285714286,94.04
10499,685584,24,685584,50890,22,2,4.545454545454546,39.25
10500,384,20,324,204,13,7,12.5,42.61
10501,780,1,780,0,1,0,33.333333333333336,51.83
10502,30264,40,0,5364,26,14,50.0,0.0
10503,1224,58,1224,568,58,0,1.6666666666666667,7.28
10504,117108,29,117108,23778,17,12,14.285714285714286,0.0
10505,50664,9,50664,529,8,1,14.285714285714286,85.5
10506,5592,23,5592,396,20,3,5.0,82.98
10507,1572,1,1572,984,0,1,100.0,100.0
10508,10488,20,10488,510,19,1,5.0,84.92
10509,1104,3,1104,376,3,0,50.0,0.0
10510,34332,22,34332,3367,19,3,7.6923076923076925,82.86
10511,40536,52,0,1592,41,11,50.0,0.0
10512,185052,24,185052,4511,18,6,7.6923076923076925,17.16
10513,34008,27,0,1851,20,7,50.0,0.0
10514,40308,46,0,1751,33,13,50.0,0.0
10515,81048,84,63746,33123,43,41,5.0,30.89
10516,801408,53,0,18939,45,8,25.0,0.0
10517,3207660,63,1442049,242698,37,26,2.9411764705882355,0.0
10518,31644,41,0,2472,37,4,50.0,0.0
10519,2587188,12,0,221256,5,7,20.0,4.02
10520,1320,52,1320,801,44,8,2.3255813953488373,36.72
10521,600,53,600,185,46,7,2.4390243902439024,51.29
10522,75012,5,37680,74553,3,2,25.0,0.0
10523,744,0,744,0,0,0,33.333333333333336,0.0
10524,47340,193,0,3980,115,78,50.0,0.0
10525,4059504,328,0,117840,179,149,2.702702702702702,1.01
10526,229020,458,199602,226769,431,27,100.0,0.0
10527,29832,43,29832,363,41,2,2.3255813953488373,55.29
10528,2268,41,0,848,31,10,100.0,0.0
10529,720,87,720,268,48,39,3.4482758620689653,71.53
10530,38604,1079,0,29044,134,945,100.0,0.0
10531,4200084,5751,0,374253,3321,2430,1.0,0.0
10532,1740,0,1740,0,0,0,100.0,0.0
10533,41340,82,0,1582,60,22,50.0,0.0
10534,3459504,45,0,266424,38,7,16.666666666666668,0.0
10535,1212,173,1104,468,123,50,1.1494252873563218,54.01
10536,22980,6,22980,1560,6,0,12.5,94.67
10537,42432,49,0,1665,35,14,50.0,0.0
10538,1836,90,1836,223,65,25,1.9230769230769231,40.6
10539,17676,49,0,1132,38,11,50.0,0.0
10540,0,0,0,0,0,0,100.0,0.0
10541,43668,31,43668,28,31,0,3.0303030303030303,32.79
10542,3876132,5614,472920,180815,2805,2809,1.0,0.4
10543,624,24,0,255,19,5,50.0,0.0
10544,3684,8,3684,1062,6,2,20.0,97.33
10545,108,0,108,0,0,0,50.0,80.0
10546,84,2,84,30,2,0,25.0,72.3
10547,1171008,44,0,133794,37,7,33.333333333333336,0.0
10548,4224,0,3828,0,0,0,100.0,0.0
10549,182856,25,0,9986,21,4,50.0,0.0
10550,60,0,60,0,0,0,50.0,80.0
10551,2964,21,0,1341,15,6,14.285714285714286,0.0
10552,4249980,5664,1045578,358605,3166,2498,1.0,0.0
10553,3228,80,192,149,48,32,4.166666666666667,52.93
10554,4257228,4242,2111388,1114363,2078,2164,1.0,0.0
10555,531492,28,531492,44040,25,3,4.3478260869565215,66.22
10556,139176,175,139176,1363,96,79,1.351351351351351,50.65
10557,3612,55,3612,2811,55,0,1.7543859649122806,15.0
10558,292416,83,0,4742,46,37,3.225806451612903,0.0
10559,2156544,107,0,179250,88,19,16.666666666666668,0.0
10560,22044,34,22044,1854,33,1,50.0,20.76
10561,26052,481,0,2988,271,210,100.0,0.0
10562,2328,16,2328,569,14,2,7.6923076923076925,86.13
10563,4152,4,4152,1263,4,0,25.0,86.97
10564,3221364,445,0,44588,232,213,4.761904761904762,0.0
10565,535560,39,535560,16773,31,8,4.0,22.05
10566,1080,56,1080,804,56,0,1.7241379310344829,5.99
10567,213324,20,213324,844,17,3,7.6923076923076925,58.78
10568,2376,35,2376,1977,29,6,3.703703703703704,44.59
10569,888,58,888,99,42,16,2.272727272727273,41.25
10570,35244,19,35244,660,17,2,9.090909090909092,85.42
10571,29988,15,29988,620,14,1,9.090909090909092,82.42
10572,612,25,612,94,24,1,4.3478260869565215,53.55
10573,4251300,1682,2119620,871729,876,806,1.0,1.97
10574,1356,13,1356,420,10,3,11.11111111111111,84.85
10575,87864,54,87864,2509,44,10,2.702702702702702,2.64
10576,336,8,336,108,5,3,20.0,58.43
10577,720,59,720,36,35,24,4.166666666666667,0.0
10578,196116,46,1800,11883,37,9,3.0303030303030303,58.93
10579,3372,6,3372,936,5,1,33.333333333333336,75.02
10580,540,50,540,126,44,6,2.702702702702702,29.05
10581,51276,256,0,2247,194,62,100.0,0.0
10582,312,33,252,17,29,4,2.631578947368421,0.77
10583,303564,45,303564,56892,45,0,2.4390243902439024,64.66
10584,72,29,72,14,27,2,3.8461538461538463,39.46
10585,756,0,756,0,0,0,100.0,100.0
10586,5568,3,5568,2340,3,0,25.0,92.48
10587,3396,39,3396,28,33,6,3.125,60.81
10588,12504,47,4596,1441,44,3,20.0,24.6
10589,660624,24,660624,40325,19,5,50.0,99.95
10590,3451764,421,2124024,83725,165,256,2.5,0.0
10591,6084,24,6084,25,18,6,7.142857142857143,41.98
10592,168,11,168,6,11,0,7.6923076923076925,46.51
10593,12660,20,7476,2153,17,3,8.333333333333334,85.75
10594,85416,156,1620,2817,82,74,1.4705882352941178,18.43
10595,57516,256,0,2126,142,114,50.0,0.0
10596,18432,3,18432,724,3,0,25.0,94.84
10597,16488,218,0,2635,138,80,50.0,0.0
10598,67752,67,67752,5149,58,9,1.818181818181818,18.99
10599,1308,6,1308,152,3,3,50.0,99.43
10600,144,25,144,34,22,3,5.2631578947368425,55.75
10601,3308172,442,0,60749,190,252,2.127659574468085,0.0
10602,65724,50,0,2400,42,8,50.0,0.0
10603,804,37,804,0,37,0,2.5641025641025643,45.64
10604,745848,239,0,12330,126,113,1.4705882352941178,1.15
10605,25836,202,0,1093,137,65,100.0,0.0
10606,27348,74,0,5425,41,33,5.0,0.0
10607,60924,40,0,3031,35,5,50.0,0.0
10608,502452,15,502452,284097,15,0,7.6923076923076925,93.47
10609,3773556,1572,1184040,17917,1146,426,1.0,0.0
10610,3528528,549,3528528,47586,218,331,1.694915254237288,0.51
10611,27768,7,27768,937,5,2,16.666666666666668,96.56
10612,4155840,3654,0,322407,1956,1698,1.0,0.0
10613,2512728,26,0,122095,13,13,20.0,0.0
10614,1200276,26,0,48344,24,2,33.333333333333336,0.0
10615,11544,10,11544,825,8,2,14.285714285714286,96.6
10616,59424,22,59424,645,18,4,7.6923076923076925,85.7
10617,169452,15,91962,13408,15,0,6.25,31.46
10618,5172,3,5172,1300,3,0,16.666666666666668,71.57
10619,840,2,840,546,1,1,100.0,100.0
10620,863856,199,0,152846,88,111,7.6923076923076925,0.0
10621,0,0,0,0,0,0,100.0,0.0
10622,3824328,685,0,54518,385,300,1.492537313432836,0.0
10623,396,4,0,144,3,1,100.0,0.0
10624,1626828,255,1626828,7569,125,130,3.0303030303030303,0.0
10625,57588,62,0,2416,51,11,50.0,0.0
10626,14052,17,14052,1324,16,1,9.090909090909092,84.69
10627,25596,41,0,849,33,8,50.0,0.0
10628,1777560,59,0,84422,49,10,16.666666666666668,0.0
10629,184944,3,10164,62052,2,1,11.11111111111111,5.51
10630,51492,54,0,2329,41,13,50.0,0.0
10631,979224,47,0,22228,40,7,33.333333333333336,0.0
10632,372,3,372,156,3,0,25.0,98.26
10633,339612,1,339612,2760,1,0,50.0,99.1
10634,3382692,1484,0,56815,868,616,1.020408163265306,0.0
10635,171744,0,171744,0,0,0,100.0,100.0
10636,2762736,60,0,361807,46,14,14.285714285714286,0.0
10637,11784,0,11784,0,0,0,33.333333333333336,80.0
10638,15504,1,15504,96,1,0,50.0,99.68
10639,31488,55,0,2488,47,8,100.0,0.0
10640,70188,30,70188,500,26,4,3.703703703703704,60.05
10641,2695896,0,2695896,0,0,0,100.0,100.0
10642,36264,14,36264,4363,14,0,6.25,4.55
10643,17868,19,17868,437,18,1,5.2631578947368425,79.84
10644,42396,50,0,1621,38,12,50.0,0.0
10645,42540,48,0,1626,38,10,50.0,0.0
10646,61272,21,61272,654,17,4,7.6923076923076925,85.89
10647,18108,323,18108,17772,114,209,1.0,30.79
10648,2205276,8,0,1107085,6,2,16.666666666666668,17.95
10649,704208,111,0,33746,95,16,33.333333333333336,0.0
10650,5304,245,0,1521,195,50,100.0,0.0
10651,32760,12,32760,646,10,2,11.11111111111111,77.98
10652,119280,6,119280,48892,6,0,16.666666666666668,32.35
10653,4311240,316,2756856,2740324,146,170,1.0,0.0
10654,1820844,81,0,185429,68,13,20.0,0.0
10655,9828,18,9828,439,17,1,5.555555555555555,84.6
10656,1068,4,1068,177,3,1,50.0,98.07
10657,59388,336,59388,13098,201,135,5.2631578947368425,38.49
10658,67896,45,4884,1861,39,6,2.702702702702702,44.46
10659,2396304,179,0,22161,85,94,5.2631578947368425,0.5
10660,4157256,496,0,321321,266,230,2.1739130434782608,0.0
10661,11220,48,0,1910,42,6,100.0,0.0
10662,1704,4,1704,894,3,1,50.0,0.0
10663,288,0,288,0,0,0,100.0,100.0
10664,14076,57,0,781,36,21,50.0,0.0
10665,6252,5,6252,592,5,0,14.285714285714286,94.58
10666,91992,502,91992,12381,412,90,1.7857142857142858,13.48
10667,2700,12,2700,2606,12,0,7.142857142857143,92.62
10668,3006756,85,0,77908,72,13,33.333333333333336,0.0
10669,305328,97,3840,3755,62,35,4.166666666666667,9.94
10670,3660,12,3660,479,10,2,12.5,0.0
10671,37524,5,37524,624,4,1,25.0,91.15
10672,21312,16,21312,665,13,3,14.285714285714286,70.4
10673,14328,22,14328,665,19,3,5.882352941176471,86.06
10674,45096,61,45096,4875,29,32,6.666666666666667,87.23
10675,46524,23,46524,3844,20,3,7.6923076923076925,24.1
10676,71904,24,0,4613,19,5,50.0,0.0
10677,20412,55,0,2139,48,7,100.0,0.0
10678,1171668,22,23532,107028,17,5,11.11111111111111,77.37
10679,18000,48,18000,1437,43,5,2.3255813953488373,27.92
10680,2268,7,2268,485,7,0,12.5,91.01
10681,1296480,73,0,47175,55,18,12.5,0.0
10682,3833892,77,0,64265,66,11,50.0,0.0
10683,4181268,2477,0,154923,1377,1100,1.0,0.0
10684,8040,22,8040,855,18,4,7.142857142857143,82.52
10685,37248,43,0,2213,39,4,50.0,0.0
10686,18216,19,18216,817,18,1,5.2631578947368425,82.12
10687,40668,235,0,23595,131,104,50.0,0.0
10688,3457164,22,5136,309516,18,4,9.090909090909092,62.31
10689,84,6,84,2,6,0,12.5,54.64
10690,6624,23,6624,619,18,5,7.6923076923076925,83.83
10691,8268,8,8268,475,7,1,16.666666666666668,87.17
10692,2412192,99,0,54833,53,46,11.11111111111111,0.0
10693,17340,22,17340,458,19,3,5.882352941176471,80.24
10694,28908,69,0,1281,49,20,50.0,0.0
10695,5856,19,5856,1440,11,8,100.0,100.0
10696,2856,12,2856,859,11,1,12.5,67.73
10697,396,11,396,253,8,3,12.5,51.79
10698,16788,6,16788,4698,5,1,25.0,95.33
10699,25356,1,25356,180,1,0,20.0,90.39
10700,1860,11,1860,814,9,2,11.11111111111111,76.3
10701,144,1,144,84,1,0,25.0,63.0
10702,4324428,2641,2177136,264021,1371,1270,1.0,0.0
10703,47568,0,47568,0,0,0,100.0,100.0
10704,42312,60,0,4252,47,13,33.333333333333336,0.0
10705,4227276,1482,0,79021,855,627,1.0,2.95
10706,1356,2,1356,384,2,0,25.0,95.64
10707,17364,56,0,2740,46,10,100.0,0.0
10708,35364,50,0,1611,43,7,50.0,0.0
10709,780,17,780,154,9,8,33.333333333333336,0.0
10710,2093436,579,742552,336437,359,220,1.351351351351351,66.48
10711,169656,43,0,5961,34,9,100.0,0.0
10712,384,12,384,111,12,0,8.333333333333334,57.48
10713,11904,18,11904,816,16,2,8.333333333333334,84.2
10714,3936,1,3936,120,1,0,33.333333333333336,95.25
10715,70068,41,56808,2697,40,1,33.333333333333336,20.75
10716,20220,19,20220,947,15,4,10.0,87.18
10717,19356,44,0,3217,38,6,50.0,0.0
10718,103992,14,103992,607,13,1,9.090909090909092,26.47
10719,702708,67,0,35079,58,9,25.0,0.0
10720,534312,814,47700,16079,560,254,1.0,36.45
10721,173412,669,68649,47262,456,213,1.0,0.0
10722,24660,22,24660,896,19,3,9.090909090909092,55.41
10723,851868,46,0,19869,42,4,25.0,0.0
10724,4860,12,4860,327,12,0,7.6923076923076925,40.6
10725,42768,49,0,1649,36,13,50.0,0.0
10726,32748,34,0,9525,30,4,100.0,0.0
10727,456,8,456,157,8,0,11.11111111111111,71.43
10728,34812,0,34812,0,0,0,100.0,100.0
10729,1201740,886,1114728,33926,489,397,1.3888888888888888,10.97
10730,720,9,720,222,9,0,10.0,63.54
10731,3910260,433,0,66531,255,178,2.2222222222222223,0.51
10732,96,2,96,42,2,0,33.333333333333336,95.04
10733,2652,58,2652,2409,44,14,2.5641025641025643,76.32
10734,2977884,319,0,50331,158,161,4.0,0.0
10735,2328,25,2328,1954,19,6,4.166666666666667,48.08
10736,804,19,804,223,12,7,8.333333333333334,59.07
10737,2742000,365,0,42502,195,170,1.96078431372549,0.0
10738,1729104,0,1729104,0,0,0,33.333333333333336,80.0
10739,2773668,62,0,135830,46,16,33.333333333333336,0.0
10740,2340,0,2124,0,0,0,100.0,100.0
10741,2256,9,2256,1638,9,0,9.090909090909092,44.26
10742,5640,2,5640,2628,1,1,100.0,100.0
10743,47880,50,0,1643,38,12,50.0,0.0
10744,36768,21,0,2488,17,4,50.0,0.0
10745,54744,36,54744,157,28,8,4.761904761904762,75.38
10746,35076,51,0,4111,44,7,50.0,0.0
10747,75324,106,75324,4205,79,27,2.4390243902439024,11.86
10748,8112,7,480,1318,5,2,14.285714285714286,71.98
10749,2969220,47,226416,102046,38,9,3.4482758620689653,28.57
10750,74400,6,0,14658,5,1,100.0,0.0
10751,3086568,207,3086568,18721,104,103,4.545454545454546,68.81
10752,156,12,156,18,10,2,10.0,59.48
10753,4124340,2902,0,209453,1620,1282,1.0,0.0
10754,621432,62,530040,30670,55,7,2.380952380952381,29.91
10755,324,12,324,128,9,3,14.285714285714286,91.26
10756,3720,0,3720,0,0,0,100.0,100.0
10757,24168,218,0,2962,146,72,50.0,0.0
10758,72,21,72,22,15,6,7.142857142857143,45.76
10759,192,0,192,0,0,0,50.0,64.0
10760,5388,48,0,1867,41,7,100.0,0.0
10761,65700,328,0,4206,184,144,50.0,0.0
10762,156,40,156,41,28,12,3.8461538461538463,7.17
10763,240,0,240,0,0,0,50.0,61.23
10764,27744,439,0,3591,265,174,100.0,0.0
10765,78972,183,3588,3594,66,117,1.5384615384615383,5.57
10766,3072,3,3072,1472,2,1,33.333333333333336,95.03
10767,161172,78,161172,7447,67,11,1.7543859649122806,75.16
10768,816708,12,39264,141788,6,6,100.0,100.0
10769,2064,3,2064,1956,2,1,33.333333333333336,54.73
10770,499512,254,342336,156599,227,27,50.0,0.1
10771,37416,23,37416,1377,20,3,6.666666666666667,81.86
10772,14952,34,14952,927,33,1,25.0,32.51
10773,62796,108,0,3456,85,23,100.0,0.0
10774,852,0,852,0,0,0,50.0,59.29
10775,300,0,300,0,0,0,100.0,100.0
10776,132,16,132,24,14,2,6.666666666666667,44.05
10777,1320,30,1320,193,29,1,3.8461538461538463,47.97
10778,8892,40,8892,103,38,2,2.5641025641025643,28.49
10779,168,0,168,0,0,0,50.0,64.0
10780,1632,1,1632,300,1,0,33.333333333333336,97.57
10781,408,4,408,108,4,0,14.285714285714286,59.04
10782,3735708,169,0,62914,90,79,5.0,0.0
10783,228,4,228,129,3,1,25.0,57.87
10784,4353444,544,0,883940,290,254,1.1764705882352942,9.99
10785,792,83,792,217,71,12,1.3157894736842106,49.52
10786,4142604,2921,0,180456,1554,1367,1.0,0.44
10787,2814564,36,2514744,100299,17,19,11.11111111111111,0.0
10788,636,55,636,432,55,0,1.7543859649122806,8.05
10789,2638344,32,2638344,3742,12,20,12.5,44.83
10790,39264,17,39264,1140,16,1,7.6923076923076925,68.51
10791,168,0,168,0,0,0,50.0,59.29
10792,5280,167,0,1574,104,63,100.0,0.0
10793,74004,6,38382,458,6,0,12.5,66.14
10794,16212,6,16212,1714,6,0,11.11111111111111,64.71
10795,2100624,529,1094976,15718,444,85,2.0,52.49
10796,3408,4,3408,1875,4,0,16.666666666666668,21.41
10797,4093548,749,0,43648,412,337,1.4492753623188406,0.0
10798,3374604,1789,2219364,64444,1143,646,1.0,0.33
10799,3961608,1247,0,41704,615,632,1.1111111111111112,5.67
10800,5640,6,5640,1762,4,2,25.0,92.17
10801,190296,28,10572,18969,24,4,8.333333333333334,71.42
10802,23676,156,23676,1135,82,74,1.851851851851852,66.82
10803,1500,104,1500,461,69,35,2.5641025641025643,10.96
10804,136608,78,0,3295,73,5,1.2987012987012987,20.99
10805,4383960,6157,804690,1207274,3082,3075,1.0,0.0
10806,1284,8,1284,0,8,0,11.11111111111111,90.89
10807,3729492,265,0,79323,137,128,3.333333333333333,0.0
10808,23160,55,23160,85,41,14,2.702702702702702,37.49
10809,4207284,2378,0,148915,1397,981,1.0,0.0
10810,20904,0,20706,0,0,0,100.0,100.0
10811,11076,9,11076,1130,9,0,11.11111111111111,97.23
10812,708,47,708,40,38,9,2.857142857142857,56.3
10813,1032,0,1032,0,0,0,50.0,63.36
10814,4216836,800,514416,472882,435,365,1.851851851851852,0.0
10815,6888,14,6888,3000,14,0,6.25,96.17
10816,3938388,4179,0,1554625,2731,1448,1.0,0.0
10817,6384,8,6384,1449,8,0,11.11111111111111,65.22
10818,11484,4,11484,6816,4,0,25.0,99.28
10819,43380,21,0,5574,17,4,100.0,0.0
10820,1657236,70,110640,48177,57,13,1.96078431372549,22.3
10821,43068,57,0,1728,40,17,50.0,0.0
10822,1500,145,1500,1187,62,83,1.6129032258064515,9.93
10823,23928,23,23928,647,19,4,5.882352941176471,84.89
10824,158292,2,158292,144,2,0,33.333333333333336,99.18
10825,4383768,3421,0,649190,1966,1455,1.0,2.04
10826,25380,19,25380,1251,16,3,6.666666666666667,84.79
10827,22296,18,22296,1586,16,2,9.090909090909092,81.29
10828,876,39,0,249,34,5,50.0,0.0
10829,2629368,426,0,200115,226,200,6.666666666666667,0.0
10830,1560,59,1560,1178,57,2,1.7241379310344829,6.97
10831,4275456,55,0,289240,42,13,25.0,0.0
10832,4408392,1433,0,2584919,749,684,1.0,2.07
10833,504,57,504,348,57,0,1.694915254237288,6.47
10834,2509776,98,0,141941,82,16,50.0,0.0
10835,5952,18,5952,567,15,3,7.142857142857143,87.06
10836,1068,59,1068,699,57,2,1.7241379310344829,7.46
10837,3120,4,3120,534,4,0,16.666666666666668,83.62
10838,1500,153,1500,1143,66,87,1.639344262295082,12.47
10839,2400,6,2400,190,6,0,14.285714285714286,60.0
10840,6648,26,6648,518,22,4,5.0,84.76
10841,36492,15,36492,36362,11,4,9.090909090909092,84.71
10842,854556,16,854556,276,16,0,5.882352941176471,65.68
10843,2234064,203,6708,32953,159,44,1.0,71.52
10844,7860,17,7860,989,16,1,9.090909090909092,84.69
10845,1488,75,1488,1006,65,10,1.6129032258064515,10.12
10846,4404,17,4404,612,17,0,5.555555555555555,83.66
10847,3380976,138,0,260154,79,59,2.272727272727273,0.0
10848,14940,45,0,4028,41,4,100.0,0.0
10849,1059852,74,0,27223,64,10,50.0,0.0
10850,444,5,444,170,5,0,14.285714285714286,5.56
10851,70956,144,0,14190,117,27,50.0,0.0
10852,782856,22,782856,97834,20,2,5.555555555555555,41.44
10853,252,23,252,119,15,8,7.142857142857143,41.54
10854,79632,19,79632,1438,17,2,7.6923076923076925,79.57
10855,75756,42,0,6206,34,8,50.0,0.0
10856,52404,62,52404,3366,41,21,20.0,97.24
10857,3276,4,3276,1599,2,2,33.333333333333336,97.99
10858,312,24,288,69,20,4,5.2631578947368425,4.22
10859,1872,16,1872,1675,12,4,8.333333333333334,88.04
10860,72828,9,72828,316,9,0,10.0,66.36
10861,56928,40,56928,4242,39,1,25.0,28.02
10862,61512,42,61512,61254,42,0,2.272727272727273,43.1
10863,84576,58,0,5016,51,7,50.0,0.0
10864,7116,6,4302,1268,5,1,20.0,93.5
10865,76056,47,0,2447,36,11,50.0,0.0
10866,723960,52,0,16383,40,12,25.0,0.0
10867,88020,59,88020,212,48,11,2.272727272727273,66.95
10868,468,40,468,74,40,0,3.0303030303030303,50.84
10869,2389092,68,0,92986,51,17,33.333333333333336,0.0
10870,40152,7,0,5934,6,1,100.0,0.0
10871,696,33,696,186,31,2,3.125,48.33
10872,40272,51,0,1568,38,13,50.0,0.0
10873,672,42,588,148,41,1,3.225806451612903,45.36
10874,1284,6,1284,472,3,3,50.0,60.24
10875,816,2,816,570,2,0,50.0,99.99
10876,82980,59,0,2718,46,13,50.0,0.0
10877,1272,111,0,751,100,11,50.0,0.0
10878,480,8,480,229,6,2,9.090909090909092,67.47
10879,360,10,360,76,4,6,50.0,98.07
10880,3328152,230,0,52720,130,100,3.703703703703704,0.0
10881,76560,2,76560,492,2,0,25.0,86.99
10882,265536,49,0,9102,43,6,50.0,0.0
10883,408,42,408,107,39,3,2.4390243902439024,48.49
10884,4170288,1610,0,550998,917,693,1.2345679012345678,0.0
10885,636,15,636,181,10,5,12.5,78.87
10886,32388,27,32388,1752,22,5,7.6923076923076925,79.06
10887,18240,115,0,1522,80,35,100.0,0.0
10888,2244,18,768,280,13,5,7.6923076923076925,66.53
10889,864,42,864,269,40,2,2.5641025641025643,43.05
10890,23472,16,23472,1102,15,1,7.6923076923076925,94.04
10891,456,0,456,0,0,0,50.0,82.9
10892,143148,141,73980,12578,107,34,1.7241379310344829,12.93
10893,3842928,234,2593896,134144,133,101,3.125,83.4
10894,57288,70,57288,32,42,28,3.333333333333333,0.0
10895,21204,30,21204,612,29,1,33.333333333333336,45.75
10896,492,2,492,54,2,0,25.0,59.46
10897,106908,30,0,8772,24,6,100.0,0.0
10898,1356,96,1356,337,56,40,2.5641025641025643,12.26
10899,1824,15,1824,1697,13,2,7.142857142857143,68.29
10900,4330788,266,43200,312536,106,160,1.96078431372549,0.0
10901,44100,311,0,2786,202,109,100.0,0.0
10902,1788,1,1788,996,1,0,100.0,100.0
10903,168,3,168,104,1,2,50.0,99.8
10904,6324,14,6324,1087,13,1,9.090909090909092,75.5
10905,7560,4,7560,261,4,0,16.666666666666668,93.69
10906,388248,38,388248,25107,31,7,5.555555555555555,67.07
10907,92892,15,92892,1221,15,0,5.882352941176471,67.01
10908,91608,7,91608,30233,7,0,11.11111111111111,89.38
10909,2847768,7,6636,407108,7,0,14.285714285714286,80.22
10910,2508,16,2508,847,14,2,10.0,89.91
10911,4285344,103,130308,236017,48,55,2.1739130434782608,63.22
10912,1260,54,0,224,40,14,2.857142857142857,0.0
10913,2916,1,2916,84,1,0,25.0,91.86
10914,4435836,329,0,480431,92,237,2.857142857142857,0.02
10915,4454868,1185,0,2219470,691,494,1.0,0.0
10916,13128,3,13128,2268,2,1,100.0,0.0
10917,2208,15,2208,565,7,8,20.0,56.12
10918,98976,10,98976,43550,10,0,10.0,68.79
10919,2609052,59,2609052,161731,36,23,10.0,85.52
10920,2704392,1992,1301130,95544,1073,919,1.0,0.0
10921,308796,64,0,34968,48,16,100.0,100.0
10922,2640,2,2640,624,1,1,50.0,99.6
10923,4437060,533,2305740,88264,250,283,1.818181818181818,0.0
10924,3434904,619,2307660,43817,284,335,2.1739130434782608,2.0
10925,3467076,19,0,1214591,19,0,50.0,99.92
10926,288,8,288,100,7,1,11.11111111111111,41.24
10927,100632,1,100632,624,1,0,50.0,99.67
10928,1305288,1358,494121,363865,1357,1,1.0,3.08
10929,138492,12,138492,705,10,2,12.5,85.42
10930,444,17,444,276,12,5,10.0,40.16
10931,3127500,469,0,154177,159,310,2.5641025641025643,0.0
10932,14124,0,14124,0,0,0,50.0,95.0
10933,349272,44,0,9190,30,14,100.0,0.0
10934,3438408,1193,0,81086,675,518,1.3157894736842106,0.0
10935,313584,5,90864,65894,5,0,16.666666666666668,18.76
10936,2040,24,2040,900,20,4,5.2631578947368425,43.32
10937,3604716,2011,0,77738,1162,849,1.0,0.0
10938,589488,52,589488,11420,45,7,2.2222222222222223,16.59
10939,3705936,1714,2313456,24821,1178,536,1.0,0.0
10940,3867672,845,0,40041,397,448,2.0408163265306123,0.0
10941,2496,95,0,1240,66,29,100.0,0.0
10942,46284,20,0,2897,16,4,50.0,0.0
10943,2667888,2,2667888,2334,2,0,20.0,54.4
10944,28416,182,0,2572,106,76,100.0,0.0
10945,4458324,2228,1634172,663545,1147,1081,1.0,0.0
10946,38436,30,0,4876,25,5,100.0,0.0
10947,4468236,2054,2292583,619621,730,1324,1.6129032258064515,0.0
10948,30504,62,0,3671,50,12,100.0,0.0
10949,7812,14,7812,351,13,1,7.142857142857143,85.81
10950,132696,683,79050,12778,467,216,1.0,15.77
10951,57780,54,0,2334,48,6,50.0,0.0
10952,114516,0,114516,0,0,0,50.0,97.0
10953,26508,18,26508,843,17,1,8.333333333333334,80.2
10954,9132,224,9132,2855,128,96,11.11111111111111,25.97
10955,45720,50,0,1696,37,13,50.0,0.0
10956,171912,1,171912,102756,1,0,16.666666666666668,61.58
10957,1932,3,1932,516,3,0,20.0,81.09
10958,4052772,56,0,218626,40,16,25.0,0.0
10959,588,2,588,246,2,0,33.333333333333336,95.79
10960,46512,55,0,1944,47,8,50.0,0.0
10961,1488,31,1488,760,21,10,20.0,62.87
10962,444,9,444,170,6,3,20.0,52.49
10963,10320,15,10320,763,12,3,10.0,80.79
10964,4128,21,4128,577,19,2,5.2631578947368425,82.66
10965,852,161,852,510,92,69,20.0,79.13
10966,0,0,0,0,0,0,50.0,99.7
10967,8436,26,8436,749,21,5,5.555555555555555,80.07
10968,29376,27,29376,1092,21,6,6.25,86.39
10969,1893696,178,0,21400,142,36,33.333333333333336,0.0
10970,3012,178,3012,2345,100,78,14.285714285714286,37.62
10971,73692,28,7656,8922,25,3,9.090909090909092,73.97
10972,240,24,240,103,20,4,6.25,38.66
10973,792,3,792,720,3,0,33.333333333333336,99.74
10974,146196,29,146196,1767,23,6,5.882352941176471,84.13
10975,40752,34,0,4705,32,2,50.0,0.0
10976,83292,52,0,3197,40,12,50.0,0.0
10977,99996,611,99978,12570,478,133,1.6129032258064515,55.28
10978,384,44,384,70,44,0,2.1739130434782608,65.67
10979,396,12,384,194,8,4,20.0,47.99
10980,2108760,99,0,32635,87,12,50.0,0.0
10981,372,17,372,167,13,4,7.6923076923076925,79.15
10982,1956,29,1956,976,23,6,4.545454545454546,64.25
10983,56892,55,0,1982,41,14,50.0,0.0
10984,2523396,2,731040,1359672,2,0,100.0,100.0
10985,24048,288,0,7401,160,128,100.0,0.0
10986,622044,189,622044,51912,106,83,4.761904761904762,0.0
10987,143844,37,143844,35936,32,5,4.3478260869565215,3.49
10988,3624,2,0,2214,2,0,33.333333333333336,78.98
10989,41772,4,41772,138,2,2,20.0,0.0
10990,86016,6,86016,14550,5,1,20.0,0.0
10991,3465564,6,0,3410330,6,0,50.0,99.54
10992,853368,23,853368,53850,22,1,4.761904761904762,41.06
10993,6660,25,6660,762,22,3,4.761904761904762,75.73
10994,2061408,58,0,88151,40,18,25.0,0.0
10995,72252,32,72252,37866,32,0,3.703703703703704,62.76
10996,1820076,52,0,73904,44,8,25.0,0.0
10997,27264,31,0,7419,26,5,100.0,0.0
10998,4270920,1249,1526472,1137410,726,523,1.0,0.0
10999,10008,21,10008,1296,20,1,5.0,78.25
11000,252,9,252,100,7,2,12.5,52.96
11001,234180,50,0,6147,38,12,25.0,0.0
11002,16776,23,16776,1642,18,5,9.090909090909092,78.32
11003,20844,30,20844,1530,23,7,9.090909090909092,77.04
11004,10020,5,6042,2510,5,0,1.818181818181818,45.07
11005,280608,9,280608,9968,5,4,50.0,99.99
11006,3807000,812,0,53294,428,384,3.225806451612903,0.0
11007,977124,25,786684,75079,24,1,4.166666666666667,38.7
11008,4656,162,4656,1224,121,41,1.098901098901099,34.68
11009,33420,19,33420,462,15,4,8.333333333333334,34.43
11010,53436,24,53436,53376,24,0,4.0,60.28
11011,188172,26,188172,1093,21,5,9.090909090909092,60.59
11012,807168,68,0,50582,47,21,25.0,0.0
11013,35664,11,35664,2741,6,5,25.0,94.34
11014,4013472,721,320940,324169,373,348,2.380952380952381,0.0
11015,4460124,6215,0,294542,3490,2725,1.0,0.0
11016,294336,25,294336,229428,25,0,5.2631578947368425,82.78
11017,24408,50,0,1165,36,14,50.0,0.0
11018,50940,37,50940,476,36,1,25.0,37.0
11019,1191744,14,0,94683,13,1,33.333333333333336,0.0
11020,38220,17,38220,1681,14,3,9.090909090909092,50.17
11021,235476,120,0,8929,87,33,100.0,0.0
11022,166104,1,166104,24,1,0,50.0,86.75
11023,16392,45,0,2550,37,8,100.0,0.0
11024,18240,11,18240,523,9,2,12.5,82.96
11025,4295268,184,4295268,1110299,144,40,1.7543859649122806,0.0
11026,3644448,1588,0,105460,891,697,1.0,2.99
11027,92736,154,92736,1140,115,39,1.0309278350515465,19.59
11028,20232,47,0,1058,34,13,50.0,0.0
11029,3480804,1050,0,600611,591,459,2.127659574468085,0.0
11030,4519836,275,1123200,1845862,249,26,1.2987012987012987,5.66
11031,25116,53,0,1144,39,14,50.0,0.0
11032,536640,34,536640,24681,29,5,3.8461538461538463,29.78
11033,50880,37,0,2584,32,5,100.0,0.0
11034,0,0,0,0,0,0,33.333333333333336,25.0
11035,43956,15,43956,1237,13,2,11.11111111111111,67.66
11036,30732,259,0,3936,152,107,1.2195121951219512,0.0
11037,47412,35,47412,3065,28,7,5.2631578947368425,26.83
11038,76008,81,76008,7093,66,15,2.4390243902439024,8.5
11039,9804,40,9804,44,32,8,3.571428571428572,41.14
11040,5580,87,5580,46,55,32,2.5641025641025643,48.15
11041,1176,26,1176,277,21,5,3.8461538461538463,50.31
11042,1809432,163,0,22711,79,84,5.2631578947368425,0.0
11043,2562120,350,2562120,28867,181,169,3.125,80.41
11044,444,256,0,296,130,126,100.0,0.0
11045,192,65,168,45,45,20,2.631578947368421,8.1
11046,4538772,3321,0,639267,1808,1513,1.0,0.0
11047,1574292,25,83748,70195,24,1,4.166666666666667,48.12
11048,120,0,120,0,0,0,50.0,80.0
11049,156,10,156,57,4,6,33.333333333333336,1.93
11050,984,43,984,20,43,0,2.2222222222222223,58.18
11051,1953012,17850,1495824,920337,11111,6739,1.0,0.0
11052,14748,17,14748,717,14,3,11.11111111111111,76.53
11053,347520,304,233772,99831,303,1,1.639344262295082,0.37
11054,40728,4,15348,17730,2,2,33.333333333333336,46.95
11055,34824,29,34824,2297,26,3,6.25,73.54
11056,14940,4,14940,1008,4,0,20.0,99.6
11057,4502424,1177,832272,298758,649,528,1.1235955056179776,0.0
11058,600,7,600,87,7,0,10.0,46.27
11059,77172,9,0,32257,4,5,50.0,0.0
11060,3849864,758,0,24857,343,415,1.492537313432836,0.0
11061,47916,149,0,2154,109,40,100.0,0.0
11062,3074124,218,2387052,99262,112,106,4.3478260869565215,0.0
11063,73908,24,73908,2242,24,0,4.545454545454546,10.06
11064,570144,0,570144,0,0,0,100.0,100.0
11065,0,0,0,0,0,0,100.0,0.0
11066,432,1,432,372,1,0,33.333333333333336,99.06
11067,11004,148,11004,10421,63,85,1.6666666666666667,10.34
11068,456,11,420,194,9,2,12.5,42.51
11069,2388636,730,2388636,5023,470,260,1.0,0.0
11070,4526328,2802,0,417319,1544,1258,1.0,0.0
11071,5148,186,5148,1019,133,53,1.6666666666666667,0.0
11072,1604172,129,0,39019,61,68,4.761904761904762,0.0
11073,240,0,240,0,0,0,100.0,76.25
11074,816,17,504,544,16,1,6.666666666666667,0.0
11075,9396,3,9396,440,3,0,12.5,16.55
11076,3313512,192,0,55879,115,77,3.8461538461538463,0.0
11077,1068,68,288,99,52,16,2.2222222222222223,3.0
11078,2232,12,672,880,11,1,9.090909090909092,0.0
11079,144,0,144,0,0,0,50.0,80.0
11080,324,14,264,116,12,2,7.142857142857143,36.44
11081,1563720,23,37140,70763,19,4,7.6923076923076925,77.94
11082,1829580,33,0,241134,26,7,33.333333333333336,0.0
11083,804,2,804,792,2,0,12.5,16.79
11084,81180,101,0,13735,74,27,100.0,0.0
11085,72492,51,0,9368,27,24,100.0,0.0
11086,6756,10,6756,2479,10,0,7.6923076923076925,7.16
11087,1150932,231,0,52321,120,111,8.333333333333334,0.0
11088,33648,8,33648,4312,8,0,7.142857142857143,23.04
11089,173232,1,136722,132,1,0,33.333333333333336,90.93
11090,648,7,648,521,6,1,12.5,60.21
11091,4349640,1002,78300,43222,506,496,1.0,4.5
11092,62964,31,62964,8343,23,8,9.090909090909092,41.66
11093,168216,6,168216,226,3,3,100.0,100.0
11094,4529436,5989,0,166648,2627,3362,1.0,0.0
11095,144,0,144,0,0,0,100.0,100.0
11096,17172,89,0,3012,56,33,100.0,0.0
11097,228,4,228,174,4,0,11.11111111111111,65.58
11098,2141316,505,340164,159262,438,67,1.3888888888888888,91.81
11099,3000,29,3000,613,29,0,12.5,49.93
11100,51024,378,0,6058,207,171,100.0,0.0
11101,373716,19,373716,287594,19,0,11.11111111111111,91.12
11102,2088,48,1752,1701,27,21,5.555555555555555,0.0
11103,30408,38,0,2094,35,3,100.0,0.0
11104,4536012,1718,2401416,690905,1089,629,1.0,0.0
11105,4356312,354,0,86806,150,204,2.4390243902439024,0.0
11106,36,10,36,16,6,4,33.333333333333336,99.39
11107,7164,1,7164,2076,1,0,33.333333333333336,96.78
11108,97392,4,97392,2670,3,1,25.0,75.27
11109,360,49,360,144,25,24,6.25,61.71
11110,60,7,48,20,5,2,16.666666666666668,90.99
11111,4450668,694,0,61018,359,335,1.818181818181818,10.0
11112,58692,8,58692,19980,7,1,3.0303030303030303,0.0
11113,47616,23,0,27269,19,4,33.333333333333336,0.0
11114,11100,21,11100,938,18,3,7.142857142857143,63.16
11115,9420,16,9420,318,15,1,6.25,82.66
11116,3968328,384,0,26172,201,183,2.4390243902439024,5.0
11117,39516,51,0,1649,36,15,50.0,0.0
11118,130968,56,0,5900,40,16,50.0,0.0
11119,1548,68,1548,45,54,14,2.0408163265306123,41.08
11120,3348,128,3348,3041,101,27,1.3157894736842106,72.7
11121,28080,44,28080,3602,37,7,4.545454545454546,69.58
11122,3252,15,3252,316,13,2,7.6923076923076925,86.65
11123,26640,17,26640,879,15,2,7.142857142857143,68.16
11124,4080,17,4080,572,10,7,20.0,76.57
11125,4499832,9,0,3003629,5,4,5.2631578947368425,0.0
11126,660,51,660,299,43,8,2.5641025641025643,41.04
11127,367800,27,367800,16887,26,1,6.25,6.83
11128,694164,2,694164,25854,2,0,33.333333333333336,99.03
11129,8976,344,0,2049,201,143,100.0,0.0
11130,240,21,240,46,18,3,5.555555555555555,45.96
11131,2890464,188,0,93878,101,87,5.882352941176471,0.0
11132,1488,13,0,453,8,5,16.666666666666668,10.0
11133,42180,627,0,5911,349,278,1.0,0.0
11134,54612,0,54612,0,0,0,100.0,100.0
11135,10356,17,10356,413,16,1,6.25,76.54
11136,8028,17,8028,455,17,0,5.2631578947368425,80.6
11137,2895036,233,0,136217,119,114,4.0,0.0
11138,35640,23,35640,28025,21,2,6.25,81.76
11139,15516,1,15516,2520,1,0,50.0,99.5
11140,215748,13,0,161606,10,3,100.0,0.0
11141,216,8,96,60,6,2,20.0,92.17
11142,766872,18,766872,11185,18,0,5.0,51.39
11143,3163188,64,0,104310,53,11,16.666666666666668,0.0
11144,552,30,552,344,24,6,4.761904761904762,63.52
11145,4492716,1056,0,777765,611,445,1.0,0.0
11146,59796,9,59796,2033,8,1,14.285714285714286,84.0
11147,20940,1,20940,0,1,0,50.0,91.69
11148,119856,34,84792,17797,31,3,4.761904761904762,4.09
11149,16908,48,0,1112,34,14,50.0,0.0
11150,9552,641,0,3536,359,282,100.0,0.0
11151,4539768,1376,980076,1389852,910,466,1.0,1.29
11152,9360,15,9360,482,14,1,6.666666666666667,83.37
11153,3792528,581,0,63588,320,261,2.3255813953488373,0.0
11154,45852,14,45852,833,13,1,11.11111111111111,36.11
11155,780,0,780,0,0,0,33.333333333333336,77.0
11156,720,5,720,69,4,1,25.0,55.13
11157,11712,18,11712,380,15,3,7.6923076923076925,86.62
11158,34932,2,34932,108,2,0,50.0,0.0
11159,3096,20,3096,475,17,3,6.25,82.59
11160,4334268,61,0,486783,45,16,14.285714285714286,0.0
11161,2024844,107,1043352,198098,98,9,8.333333333333334,0.04
11162,115068,57,0,3348,49,8,50.0,0.0
11163,575760,25,575760,12949,24,1,4.166666666666667,23.1
11164,28944,51,0,1748,37,14,50.0,0.0
11165,396,9,396,61,6,3,20.0,55.1
11166,0,0,0,0,0,0,100.0,0.0
11167,119304,50,0,3573,39,11,50.0,0.0
11168,624900,41,624900,15238,39,2,2.702702702702702,23.57
11169,1176,24,1176,321,17,7,7.6923076923076925,87.59
11170,517968,22,517968,4547,18,4,6.666666666666667,58.15
11171,0,0,0,0,0,0,100.0,0.0
11172,1736772,270,0,38198,138,132,5.2631578947368425,0.0
11173,53448,946,0,10104,492,454,100.0,0.0
11174,37968,21,37968,1540,16,5,10.0,30.31
11175,59052,4,59052,5466,3,1,25.0,94.37
11176,442092,170,0,9884,93,77,2.857142857142857,0.0
11177,123228,52,0,3462,41,11,50.0,0.0
11178,103944,1,0,103944,0,1,50.0,0.0
11179,105204,25,0,16955,13,12,50.0,0.0
11180,20544,74,0,1320,53,21,50.0,0.0
11181,89376,26,89376,817,24,2,6.666666666666667,37.67
11182,24384,18,24384,1314,16,2,7.142857142857143,75.5
11183,3621360,1271,0,60211,726,545,1.0,0.0
11184,1513512,61,0,100748,48,13,33.333333333333336,0.0
11185,1560,4,1560,1152,3,1,25.0,95.75
11186,17232,51,0,1014,36,15,50.0,0.0
11187,168,0,168,0,0,0,50.0,80.0
11188,1584,35,1584,1371,21,14,5.882352941176471,89.15
11189,444,0,444,0,0,0,50.0,90.44
11190,8676,22,8676,712,17,5,10.0,42.33
11191,50928,119,0,7427,79,40,100.0,0.0
11192,4272240,388,1355964,1862781,217,171,1.0,6.24
11193,6852,5,6852,590,4,1,20.0,41.9
11194,540,0,540,0,0,0,50.0,82.0
11195,15504,29,15504,1628,24,5,8.333333333333334,34.23
11196,1116,221,1116,591,143,78,1.0638297872340423,21.69
11197,444,9,0,73,6,3,50.0,0.0
11198,492,23,492,162,21,2,4.3478260869565215,61.99
11199,540,42,540,153,36,6,3.8461538461538463,63.26
11200,51276,36,51276,6324,29,7,7.142857142857143,60.44
11201,228,0,228,0,0,0,50.0,80.0
11202,828,42,828,139,32,10,4.545454545454546,65.44
11203,60444,48,60444,1931,47,1,16.666666666666668,19.13
11204,81540,31,81540,2431,26,5,5.882352941176471,39.47
11205,744,15,744,393,13,2,7.6923076923076925,79.86
11206,876,67,876,159,56,11,2.1739130434782608,35.66
11207,0,0,0,0,0,0,50.0,99.99
11208,612,5,612,60,3,2,33.333333333333336,62.89
11209,80160,141,80160,3825,103,38,1.6129032258064515,11.32
11210,59892,197,0,4398,136,61,100.0,0.0
11211,23376,51,0,2262,40,11,50.0,0.0
11212,3235632,598,144588,62155,310,288,2.083333333333333,0.0
11213,43392,36,43392,1805,29,7,5.555555555555555,23.7
11214,3215448,79,3215448,48565,47,32,7.142857142857143,91.34
11215,11580,22,11580,829,22,0,25.0,49.21
11216,1935804,692,0,9404,511,181,1.0,0.0
11217,55332,0,55332,0,0,0,50.0,75.0
11218,1536,4,1536,855,3,1,33.333333333333336,52.15
11219,1640772,171,217588,115430,170,1,1.492537313432836,2.98
11220,208224,31,208224,44580,27,4,4.166666666666667,38.08
11221,252840,28,252840,12575,15,13,16.666666666666668,99.36
11222,34284,28,34284,1358,23,5,8.333333333333334,54.61
11223,15456,20,15456,5028,17,3,6.666666666666667,85.68
11224,996,58,996,133,53,5,3.225806451612903,68.67
11225,6276,0,6276,0,0,0,100.0,100.0
11226,21696,27,21696,1848,23,4,7.142857142857143,95.25
11227,2400,28,2400,1048,23,5,5.555555555555555,75.89
11228,984,67,984,216,57,10,2.631578947368421,66.99
11229,555576,60,0,31047,45,15,25.0,0.0
11230,35496,55,0,1523,40,15,50.0,0.0
11231,1279956,1987,718008,448406,1987,0,1.3157894736842106,39.87
11232,12060,64,12060,1089,63,1,25.0,14.71
11233,36768,51,0,1488,37,14,50.0,0.0
11234,37152,55,0,1567,41,14,50.0,0.0
11235,179244,871,53688,16254,582,289,1.0,22.92
11236,113220,528,57824,9438,382,146,1.0,37.07
11237,44160,34,44160,2582,31,3,5.0,56.05
11238,3821760,4783,1172700,229469,2757,2026,1.0,38.81
11239,636,105,0,93,97,8,1.0526315789473684,0.0
11240,360,40,360,0,40,0,2.380952380952381,58.2
11241,96,0,96,0,0,0,100.0,100.0
11242,7344,3,7344,324,3,0,25.0,98.52
11243,1032,1,1032,144,1,0,33.333333333333336,61.19
11244,864324,19,37872,47864,19,0,11.11111111111111,30.04
11245,3908520,254,0,115858,144,110,4.3478260869565215,0.0
11246,625512,15,20292,127220,14,1,9.090909090909092,89.37
11247,4582332,2467,0,152912,1434,1033,1.0,0.0
11248,18408,36,18408,9447,24,12,4.3478260869565215,74.67
11249,392700,21,0,53893,11,10,33.333333333333336,0.0
11250,6612,19,6612,388,18,1,5.2631578947368425,84.28
11251,516144,33,516144,18271,31,2,3.4482758620689653,25.35
11252,4668840,15008,472447,977729,8415,6593,1.0,0.0
11253,348,16,348,72,11,5,12.5,64.16
11254,3544872,51,435600,188286,43,8,3.333333333333333,38.8
11255,213372,23,213372,28811,19,4,7.142857142857143,1.25
11256,68520,52,0,4060,39,13,50.0,0.0
11257,6744,19,6744,440,17,2,5.882352941176471,85.13
11258,83364,8,0,22798,4,4,100.0,0.0
11259,4581948,52,0,156951,39,13,20.0,0.0
11260,70800,47,0,2714,37,10,50.0,0.0
11261,17316,25,17316,604,22,3,5.0,78.65
11262,10608,1,10608,744,0,1,100.0,100.0
11263,29124,58,0,3619,46,12,33.333333333333336,0.0
11264,80796,75,0,3468,53,22,25.0,0.0
11265,4214196,265,0,78703,140,125,4.761904761904762,0.0
11266,143016,35,143016,12041,29,6,4.3478260869565215,28.48
11267,32184,55,0,2351,44,11,50.0,0.0
11268,440028,10,0,114069,5,5,14.285714285714286,10.0
11269,34080,51,0,1571,39,12,50.0,0.0
11270,480,13,432,203,10,3,10.0,48.65
11271,20760,18,20760,2665,17,1,11.11111111111111,91.46
11272,240,3,240,8,3,0,20.0,74.01
11273,240,7,240,80,7,0,11.11111111111111,87.87
11274,108720,1,108720,108624,1,0,50.0,98.0
11275,42852,64,42852,1458,63,1,12.5,24.48
11276,699204,34,455736,25154,29,5,4.545454545454546,19.27
11277,109356,3,109356,109252,2,1,50.0,97.18
11278,700284,42,700284,44572,37,5,3.333333333333333,20.46
11279,93120,562,0,12721,336,226,1.0,0.0
11280,44952,22,44952,936,19,3,6.666666666666667,82.59
11281,2666796,194,2666796,59690,127,67,3.125,0.0
11282,4187436,109,0,93258,66,43,5.882352941176471,0.0
11283,4135188,10,4135188,72133,5,5,25.0,5.0
11284,4344480,407,2470344,525897,159,248,1.8867924528301887,0.0
11285,85068,2,85068,35076,1,1,50.0,86.98
11286,76992,260,0,23744,172,88,100.0,0.0
11287,219048,28,219048,52675,15,13,20.0,87.5
11288,840,47,0,511,33,14,33.333333333333336,0.0
11289,3645324,129,0,82798,55,74,5.0,5.0
11290,828,47,828,531,40,7,2.5641025641025643,55.7
11291,2761056,46,2760948,79317,28,18,9.090909090909092,0.0
11292,4162560,806,0,29759,433,373,1.2987012987012987,0.0
11293,648,11,0,270,9,2,50.0,0.0
11294,2592,7,0,1246,4,3,20.0,8.04
11295,384,20,384,249,14,6,7.6923076923076925,28.62
11296,2807040,221,0,56054,117,104,3.8461538461538463,0.0
11297,75180,12,75180,18275,7,5,5.882352941176471,55.46
11298,120,0,120,0,0,0,50.0,85.0
11299,564,7,564,149,6,1,16.666666666666668,75.92
11300,487488,73,58908,20145,55,18,2.272727272727273,24.03
11301,4012524,501,0,45052,252,249,1.2345679012345678,0.65
11302,61092,34,61092,16,33,1,2.857142857142857,48.33
11303,216,27,216,43,25,2,3.703703703703704,30.37
11304,43152,11,43152,592,10,1,12.5,89.62
11305,4199172,1091,1622508,89145,599,492,1.098901098901099,1.95
11306,10032,58,10032,1164,56,2,9.090909090909092,20.1
11307,2340,8,2340,669,8,0,10.0,10.05
11308,476964,32,476964,64061,28,4,3.571428571428572,25.57
11309,20484,526,0,3384,280,246,1.0,0.0
11310,8904,34,8904,576,29,5,3.8461538461538463,76.39
11311,82224,4,82224,19125,4,0,16.666666666666668,66.0
11312,2040216,112,0,22035,50,62,7.6923076923076925,0.0
11313,260232,48,0,6403,31,17,100.0,0.0
11314,141468,957,0,8880,472,485,33.333333333333336,0.0
11315,392700,10,40020,43023,9,1,14.285714285714286,73.91
11316,90204,253,0,2923,177,76,100.0,0.0
11317,480,7,0,137,6,1,50.0,0.0
11318,3224472,430,0,31085,233,197,2.5,0.0
11319,236736,66,0,36189,56,10,33.333333333333336,0.0
11320,48900,48,0,1775,35,13,50.0,0.0
11321,4733016,3983,2060208,1193557,2166,1817,1.0,0.0
11322,49872,51,0,1813,38,13,50.0,0.0
11323,182700,155,0,36850,116,39,50.0,0.0
11324,7092,20,7092,401,18,2,5.882352941176471,82.92
11325,1394952,253,697608,47677,73,180,1.818181818181818,0.0
11326,11196,1,0,11196,0,1,50.0,0.0
11327,4694004,2730,0,343338,1666,1064,1.0,0.0
11328,4431516,3560,837480,855977,1433,2127,1.0,0.0
11329,185016,58,185016,995,49,9,2.0408163265306123,22.33
11330,258012,16,258012,236488,5,11,1.0,0.0
11331,71604,21,71604,967,17,4,10.0,86.12
11332,348,1,288,96,1,0,33.333333333333336,67.13
11333,504,3,504,320,3,0,20.0,66.67
11334,11784,10,11784,664,9,1,11.11111111111111,87.02
11335,1167384,47,0,25513,41,6,50.0,0.0
11336,8724,3,8724,0,3,0,20.0,59.2
11337,49992,36,49992,5200,32,4,5.0,3.57
11338,63180,12,63180,586,12,0,10.0,65.46
11339,516,40,516,0,40,0,2.380952380952381,58.2
11340,15108,60,15108,1218,58,2,33.333333333333336,22.21
11341,93840,24,93840,1257,19,5,6.666666666666667,37.24
11342,600,44,600,85,35,9,3.125,58.38
11343,384528,647,0,5707,371,276,1.0,0.0
11344,86364,15,86364,594,14,1,9.090909090909092,30.77
11345,16368,19,11304,1423,17,2,5.555555555555555,79.57
11346,74316,38,0,3073,31,7,50.0,0.0
11347,65172,51,0,2514,38,13,50.0,0.0
11348,13020,18,13020,318,15,3,7.6923076923076925,85.05
11349,146916,34,0,7439,26,8,50.0,0.0
11350,4208340,427,0,91181,228,199,3.125,0.0
11351,7836,16,7836,398,15,1,6.25,79.43
11352,1306164,53,0,91499,42,11,33.333333333333336,0.0
11353,1800,24,1800,277,23,1,9.090909090909092,27.38
11354,3661620,8,0,3000198,3,5,20.0,0.01
11355,3612552,8,1274727,1475835,3,5,1.0,0.0
11356,129132,21,129132,94106,19,2,5.882352941176471,88.36
11357,4730364,843,0,80359,463,380,1.4705882352941178,0.0
11358,592092,32,592092,21453,27,5,4.761904761904762,34.38
11359,344184,39,344184,30750,36,3,2.9411764705882355,21.58
11360,20916,44,0,1145,33,11,50.0,0.0
11361,4733208,352,0,102947,185,167,4.545454545454546,0.0
11362,238668,21,238668,1424,20,1,5.882352941176471,20.49
11363,689364,25,6000,55323,21,4,5.2631578947368425,83.05
11364,4200216,197,188328,370367,106,91,2.631578947368421,2.08
11365,132552,43,0,4241,33,10,50.0,0.0
11366,7848,25,7848,409,21,4,5.882352941176471,78.53
11367,2976,8,2976,1653,7,1,2.272727272727273,9.57
11368,144,1,144,0,1,0,4.3478260869565215,46.54
11369,228,2,228,78,2,0,4.166666666666667,48.37
11370,624,10,624,164,8,2,4.0,48.06
11371,10404,22,10404,615,20,2,5.2631578947368425,86.08
11372,10932,49,0,1498,36,13,50.0,0.0
11373,29220,58,0,1507,43,15,50.0,0.0
11374,7260,46,0,807,36,10,50.0,0.0
11375,72924,22,72924,1299,20,2,6.666666666666667,64.44
11376,552,8,552,348,4,4,20.0,61.22
11377,94836,56,0,3084,44,12,50.0,0.0
11378,39540,11,39540,458,10,1,10.0,89.01
11379,23772,54,23772,804,53,1,7.6923076923076925,30.43
11380,89436,51,0,3137,42,9,50.0,0.0
11381,779736,36,510828,21485,31,5,4.166666666666667,30.29
11382,4526004,428,0,104488,249,179,2.380952380952381,0.0
11383,20076,52,0,1787,43,9,50.0,0.0
11384,29916,35,0,7056,31,4,100.0,0.0
11385,20784,41,0,1732,33,8,50.0,0.0
11386,3447372,895,0,63831,496,399,1.5384615384615383,0.0
11387,145104,44,92988,16018,36,8,3.571428571428572,10.0
11388,32844,0,32844,0,0,0,100.0,100.0
11389,338688,16,210084,67998,15,1,6.666666666666667,83.5
11390,264,12,264,26,12,0,7.142857142857143,45.8
11391,552,8,0,270,5,3,100.0,0.0
11392,4097820,53,0,226210,40,13,25.0,0.0
11393,2691528,52,0,266370,36,16,25.0,0.0
11394,303696,37,240852,23253,31,6,3.8461538461538463,50.74
11395,39384,15,39384,1366,11,4,12.5,82.04
11396,35172,28,35172,2532,25,3,6.25,70.23
11397,36168,39,36168,78,35,4,2.857142857142857,49.34
11398,14460,21,14460,948,18,3,8.333333333333334,82.63
11399,307800,27,226836,17483,23,4,5.555555555555555,59.86
11400,240,12,240,30,11,1,8.333333333333334,47.95
11401,17976,16,17976,798,14,2,9.090909090909092,81.99
11402,15792,87,15792,5432,59,28,2.127659574468085,62.4
11403,327468,15,327468,75753,8,7,20.0,61.89
11404,15600,38,15600,532,37,1,12.5,35.14
11405,40560,0,40560,0,0,0,100.0,100.0
11406,47688,286,0,2533,212,74,100.0,0.0
11407,7716,63,0,861,60,3,100.0,100.0
11408,316680,43,0,14241,27,16,100.0,0.0
11409,60720,685,0,7033,419,266,1.0,0.0
11410,900,19,900,581,17,2,6.25,47.34
11411,8436,28,8436,1456,25,3,6.25,77.27
11412,66672,8,0,9529,7,1,50.0,0.0
11413,2268,14,2268,664,11,3,9.090909090909092,0.0
11414,777852,415,369254,211581,415,0,1.0,66.34
11415,372,64,372,95,46,18,2.5641025641025643,20.77
11416,5364,3,5364,436,3,0,20.0,60.26
11417,17580,5,17580,3972,3,2,25.0,99.17
11418,5244,2,2472,1062,2,0,33.333333333333336,99.85
11419,27132,6,27132,550,6,0,14.285714285714286,87.96
11420,22872,13,22872,1284,11,2,12.5,89.22
11421,281940,29,0,16991,23,6,100.0,0.0
11422,63084,31,0,10509,29,2,100.0,0.0
11423,4782780,193,0,2467822,100,93,3.0303030303030303,0.0
11424,3782448,67,0,118621,32,35,6.666666666666667,0.0
11425,4440,37,0,1343,32,5,100.0,0.0
11426,1373940,49,1373940,1991,43,6,2.3255813953488373,30.81
11427,315636,4,315636,213405,4,0,33.333333333333336,99.81
11428,900,8,900,325,8,0,10.0,92.01
11429,10668,41,10668,778,21,20,10.0,90.27
11430,2004,52,2004,1806,28,24,5.555555555555555,88.17
11431,264,17,264,51,17,0,5.0,54.25
11432,4814448,1373,0,2033360,767,606,1.0,0.0
11433,6804,15,5376,2668,10,5,100.0,0.0
11434,71928,36,71928,853,33,3,3.0303030303030303,86.72
11435,26088,6,26088,1808,6,0,14.285714285714286,99.76
11436,2479656,317,0,38468,166,151,2.0,0.0
11437,4810368,1033,337032,1380512,462,571,1.0,0.0
11438,4534848,424,2659512,323670,196,228,1.7241379310344829,5.0
11439,4612860,1452,0,77082,647,805,1.5151515151515151,0.0
11440,5064,0,5064,0,0,0,100.0,100.0
11441,3132,1,3132,1176,1,0,33.333333333333336,60.67
11442,3175728,59,0,164732,27,32,7.6923076923076925,0.0
11443,57756,0,57756,0,0,0,100.0,100.0
11444,776172,677,522813,164330,638,39,1.0,30.01
11445,32028,21,32028,833,19,2,7.6923076923076925,79.48
11446,1680,3,1680,664,2,1,33.333333333333336,99.4
11447,3930468,208,0,304121,119,89,1.0,3.0
11448,955620,533,545523,311393,482,51,10.0,99.85
11449,10152,22,10152,436,20,2,5.555555555555555,80.54
11450,4749600,59,0,419803,47,12,11.11111111111111,0.0
11451,328884,12,328884,34512,11,1,8.333333333333334,0.25
11452,9936,125,0,2644,79,46,1.8867924528301887,0.0
11453,60084,29,2496,2692,29,0,4.761904761904762,37.95
11454,51492,50,0,2159,36,14,50.0,0.0
11455,77436,351,0,6255,179,172,1.2658227848101269,0.0
11456,12000,19,12000,431,17,2,5.882352941176471,76.76
11457,9720,96,0,4738,60,36,2.5,0.0
11458,960,4,960,183,4,0,16.666666666666668,59.6
11459,52164,52,0,3416,46,6,50.0,0.0
11460,420,6,0,170,5,1,50.0,0.0
11461,4477092,1164,0,197578,645,519,1.1363636363636365,0.0
11462,45600,43,45600,158,38,5,2.631578947368421,56.0
11463,18996,46,0,4722,38,8,100.0,0.0
11464,0,0,0,0,0,0,50.0,99.97
11465,3516,4,3516,3348,4,0,16.666666666666668,98.51
11466,23220,28,23220,1493,24,4,7.6923076923076925,75.14
11467,384,88,384,89,76,12,1.7857142857142858,46.1
11468,4201440,1214,0,779411,668,546,1.1904761904761905,0.0
11469,7368,54,7368,1072,53,1,4.545454545454546,29.33
11470,5604,441,0,2363,241,200,1.0,0.0
11471,492840,382,0,226249,340,42,100.0,0.0
11472,14196,25,14196,1074,22,3,6.666666666666667,82.48
11473,4517568,2025,0,435744,1022,1003,1.0,0.0
11474,241560,4,241560,447,4,0,14.285714285714286,73.17
11475,371184,71,0,25838,59,12,33.333333333333336,0.0
11476,4836252,649,3185616,1931910,407,242,1.0,2.09
11477,3324,18,3324,395,17,1,5.555555555555555,76.99
11478,4844688,621,1165448,2644084,433,188,1.0,4.0
11479,2280,0,2280,0,0,0,50.0,80.0
11480,10464,44,0,2811,35,9,33.333333333333336,0.0
11481,414384,4,1944,166590,3,1,50.0,99.99
11482,457056,14,457056,274407,14,0,5.882352941176471,54.3
11483,384,7,384,94,6,1,14.285714285714286,53.79
11484,192,10,192,26,10,0,8.333333333333334,41.71
11485,4017528,2003,794796,206891,1095,908,1.0,6.2
11486,9096,21,9096,428,19,2,5.2631578947368425,80.5
11487,272004,71,272004,108330,58,13,3.4482758620689653,41.05
11488,32172,42,32172,1368,39,3,2.5,38.84
11489,4829136,1828,0,379332,1041,787,1.0,2.37
11490,3815412,71,0,251123,33,38,2.9411764705882355,0.03
11491,2183460,102,0,133838,81,21,25.0,0.0
11492,16848,21,11352,1313,19,2,5.0,82.22
11493,4782864,2507,0,523134,1411,1096,1.0,0.0
11494,4364832,41,11100,1087415,33,8,4.761904761904762,81.9
11495,349536,40,349536,26718,38,2,3.225806451612903,23.2
11496,1801044,171,0,34411,93,78,4.3478260869565215,0.0
11497,314868,16,2268,20298,10,6,2.631578947368421,24.21
11498,11748,15,5712,1637,12,3,9.090909090909092,85.15
11499,1364988,100,0,60923,86,14,33.333333333333336,0.0
11500,1322856,1,256764,1322856,1,0,100.0,100.0
11501,16476,18,16476,610,15,3,10.0,80.94
11502,30372,13,0,15200,12,1,100.0,0.0
11503,2580,4,2580,228,3,1,50.0,99.96
11504,2892312,47,0,194738,36,11,25.0,0.0
11505,33156,49,0,2675,37,12,50.0,0.0
11506,1512,0,1512,0,0,0,100.0,100.0
11507,5808,24,5808,832,20,4,6.666666666666667,74.89
11508,816,1,0,816,0,1,100.0,0.0
11509,45684,18,0,3388,15,3,100.0,0.0
11510,109068,658,45915,11544,458,200,1.0,29.03
11511,13440,150,0,3105,80,70,2.380952380952381,0.0
11512,27864,43,27864,1162,41,2,11.11111111111111,11.9
11513,35292,57,0,1936,44,13,50.0,0.0
11514,10176,6,10176,2216,2,4,100.0,100.0
11515,34740,48,0,1819,44,4,50.0,0.0
11516,12948,675,0,5779,363,312,1.0,0.0
11517,86508,54,0,3912,40,14,50.0,0.0
11518,389064,27,389064,33047,21,6,7.142857142857143,51.11
11519,151908,51,0,9488,40,11,25.0,0.0
11520,2364,149,2364,632,112,37,1.075268817204301,37.0
11521,60792,21,60792,2176,20,1,7.6923076923076925,84.13
11522,828,13,828,79,10,3,11.11111111111111,54.19
11523,5652,44,0,2448,39,5,100.0,0.0
11524,1243536,126,11928,11245,88,38,2.0408163265306123,60.5
11525,9744,57,9744,825,55,2,9.090909090909092,23.21
11526,3275976,153,0,110717,77,76,5.0,0.0
11527,528,0,528,0,0,0,50.0,80.0
11528,2556,10,2556,963,9,1,14.285714285714286,89.79
11529,252,15,252,90,15,0,5.882352941176471,85.0
11530,222984,23,0,34909,15,8,100.0,0.0
11531,43872,24,43872,2135,19,5,8.333333333333334,76.22
11532,1656,1,1656,1368,1,0,33.333333333333336,42.76
11533,5028,60,5028,727,59,1,5.555555555555555,15.5
11534,83652,5,83652,900,5,0,14.285714285714286,62.58
11535,29088,585,0,6544,375,210,1.0,0.0
11536,2280,4,0,1056,2,2,100.0,0.0
11537,1212,38,1212,74,36,2,3.703703703703704,49.12
11538,5280,39,5280,311,36,3,2.631578947368421,49.67
11539,288,9,0,65,7,2,50.0,0.0
11540,108,17,108,26,13,4,7.6923076923076925,46.53
11541,3253848,126,86532,33418,93,33,1.7241379310344829,6.33
11542,264,65,264,44,43,22,2.631578947368421,24.47
11543,2400,14,2400,415,13,1,10.0,86.26
11544,2928,249,2928,1903,74,175,1.5873015873015872,14.42
11545,153792,2,0,76992,1,1,50.0,0.0
11546,25044,24,25044,2174,21,3,8.333333333333334,80.42
11547,7608,48,7608,27,40,8,2.631578947368421,0.0
11548,480,29,480,28,23,6,4.545454545454546,82.72
11549,154932,5,0,32013,4,1,50.0,0.0
11550,2795544,418,0,80391,254,164,1.408450704225352,0.0
11551,396,31,396,0,31,0,3.0303030303030303,45.47
11552,7176,70,7176,1037,67,3,4.0,24.34
11553,4591716,768,0,181564,313,455,1.1904761904761905,0.0
11554,11256,272,0,3065,127,145,1.7857142857142858,0.0
11555,58464,1,58464,240,1,0,50.0,99.69
11556,4404,22,4404,1001,19,3,7.142857142857143,98.27
11557,4775220,654,1174236,369345,336,318,1.1904761904761905,0.0
11558,35304,49,35304,860,45,4,2.1739130434782608,37.09
11559,4813848,1050,0,478498,516,534,1.9230769230769231,0.0
11560,212568,32,212568,1074,26,6,4.0,16.93
11561,1957020,558,0,10319,295,263,100.0,0.0
11562,8568,3,8568,368,3,0,12.5,56.15
11563,62484,8,62484,825,8,0,11.11111111111111,98.24
11564,40836,85,180,543,42,43,4.545454545454546,66.09
11565,4684116,453,0,105540,225,228,2.0,0.0
11566,4540920,166,0,583673,110,56,1.5625,39.15
11567,419016,5,1080,163917,3,2,50.0,99.91
11568,3324,43,3324,0,43,0,2.2222222222222223,55.03
11569,6504,8,0,1665,5,3,100.0,0.0
11570,168,55,168,34,46,9,2.4390243902439024,29.02
11571,216,46,216,35,34,12,3.225806451612903,5.41
11572,4016712,2600,0,74438,890,1710,100.0,100.0
11573,5364,53,5364,508,50,3,2.380952380952381,97.38
11574,216252,21,216252,13,21,0,4.3478260869565215,17.64
11575,112644,39,112644,10257,31,8,4.166666666666667,26.29
11576,1992,1,1992,1740,1,0,33.333333333333336,98.0
11577,4832160,6255,1526340,1227454,3451,2804,1.0,3.51
11578,4270392,475,602724,413162,297,178,1.1111111111111112,0.0
11579,384,84,384,63,66,18,1.7241379310344829,28.63
11580,1224,12,1224,194,11,1,5.882352941176471,46.37
11581,49092,126,0,953,96,30,100.0,0.0
11582,6900,68,6900,2023,65,3,5.0,32.87
11583,6432,21,6432,1560,20,1,6.25,82.99
11584,552,2,552,0,2,0,25.0,72.17
11585,168336,8,101328,32469,6,2,16.666666666666668,42.41
11586,6936,20,6936,1068,18,2,6.666666666666667,82.71
11587,252,12,0,78,9,3,50.0,0.0
11588,30564,31,30564,2361,29,2,3.4482758620689653,58.37
11589,4180368,398,0,34794,254,144,1.0,1.5
11590,13524,1,13524,900,1,0,33.333333333333336,88.91
11591,4140,28,4140,471,28,0,100.0,35.19
11592,236616,44,0,47725,34,10,100.0,0.0
11593,1051716,23,0,139192,18,5,33.333333333333336,0.0
11594,4771296,232,0,58600,114,118,2.0408163265306123,12.0
11595,2796,0,2796,0,0,0,100.0,0.0
11596,6288,23,6288,5676,21,2,4.545454545454546,74.92
11597,4608684,18,71220,1517004,13,5,50.0,0.0
11598,70920,19,70920,1891,17,2,16.666666666666668,73.05
11599,18792,3,18792,1808,3,0,20.0,82.48
11600,4392384,522,0,32387,299,223,1.1494252873563218,3.0
11601,3848652,506,0,216340,287,219,2.0408163265306123,0.0
11602,3768,2,3768,2208,1,1,100.0,100.0
11603,4164,1,4164,2376,1,0,50.0,97.59
11604,3324,25,3324,1042,17,8,11.11111111111111,38.7
11605,4632912,4472,849000,915393,2253,2219,1.0,0.21
11606,514308,24,514308,45925,14,10,25.0,97.42
11607,430884,1,255834,82368,1,0,50.0,99.85
11608,2522328,471,0,30036,198,273,1.0526315789473684,0.5
11609,516276,18,516276,66626,10,8,25.0,97.49
11610,4875816,167,0,1347715,88,79,3.125,0.0
11611,88296,36,88296,2909,29,7,3.4482758620689653,44.8
11612,4759104,2717,0,91507,1328,1389,1.0,0.07
11613,348,10,348,280,10,0,8.333333333333334,95.27
11614,44808,60,0,7411,49,11,33.333333333333336,0.0
11615,528,21,528,461,21,0,4.545454545454546,87.11
11616,264,1,264,192,1,0,33.333333333333336,95.28
11617,86148,40,86148,1904,36,4,2.702702702702702,21.12
11618,15984,42,15984,1093,41,1,1.818181818181818,64.15
11619,16320,41,0,9420,38,3,100.0,0.0
11620,2196,5,1908,1876,4,1,20.0,0.0
11621,188052,73,0,18065,43,30,100.0,0.0
11622,396,10,396,151,8,2,12.5,43.09
11623,9480,773,9444,8871,377,396,1.0,63.06
11624,11640,84,11640,2533,81,3,2.5641025641025643,18.09
11625,14172,28,14172,6754,28,0,3.703703703703704,59.69
11626,26148,907,19980,9499,492,415,100.0,0.0
11627,1580064,7,1580064,1375170,7,0,11.11111111111111,82.3
11628,2868,3,2868,1420,3,0,33.333333333333336,99.38
11629,734028,20,6504,39093,15,5,2.9411764705882355,45.69
11630,1512,0,1512,0,0,0,100.0,100.0
11631,2021280,53,746800,44596,50,3,5.555555555555555,95.31
11632,26568,19,26568,6555,18,1,6.25,7.13
11633,161280,24,24156,8329,23,1,4.3478260869565215,78.23
11634,2524476,48,0,95382,42,6,25.0,0.0
11635,4920240,4130,15420,1295442,2296,1834,1.0,0.0
11636,107340,31,107340,19550,30,1,4.0,3.13
11637,1788,26,1788,506,19,7,33.333333333333336,1.08
11638,34260,598,0,6937,362,236,1.0,0.0
11639,1908,42,1908,584,41,1,20.0,38.35
11640,4839792,667,0,533947,414,253,1.098901098901099,2.88
11641,4440,9,4440,504,7,2,3.703703703703704,46.2
11642,382584,90,0,7094,85,5,100.0,100.0
11643,5304,6,5304,754,6,0,16.666666666666668,89.22
11644,1276308,72,0,37409,34,38,7.142857142857143,0.0
11645,23364,44,0,2866,36,8,100.0,0.0
11646,2016,11,2016,590,8,3,3.571428571428572,46.67
11647,228,7,228,72,6,1,3.571428571428572,42.67
11648,1704,67,0,799,63,4,100.0,100.0
11649,3204,44,3204,82,36,8,2.9411764705882355,55.77
11650,6456,19,6456,402,18,1,5.2631578947368425,74.62
11651,6048,127,5052,539,113,14,1.0,20.85
11652,300,11,300,97,9,2,10.0,32.13
11653,4829652,88,0,65462,73,15,33.333333333333336,0.0
11654,14412,764,0,5445,438,326,1.0,0.0
11655,87468,294,0,8226,225,69,100.0,0.0
11656,9468,19,9468,401,18,1,5.2631578947368425,77.85
11657,780,201,780,516,201,0,1.0,0.0
11658,10908,23,10908,468,20,3,5.2631578947368425,76.21
11659,3730632,26,5016,144523,23,3,7.6923076923076925,80.33
11660,6372,17,6372,835,14,3,3.0303030303030303,43.45
11661,408,0,408,0,0,0,50.0,64.72
11662,180,9,180,48,9,0,9.090909090909092,49.53
11663,2988,23,2988,385,19,4,5.882352941176471,79.57
11664,1120332,111,0,37243,107,4,100.0,100.0
11665,6384,36,6384,1346,30,6,4.761904761904762,66.62
11666,2904,48,2904,881,38,10,3.703703703703704,46.35
11667,7572,47,816,5172,31,16,50.0,0.0
11668,69924,51,0,3779,37,14,50.0,0.0
11669,419436,45,386682,53285,42,3,2.702702702702702,19.45
11670,68292,35,0,3017,29,6,50.0,0.0
11671,37824,20,7080,3913,17,3,16.666666666666668,52.13
11672,5424,21,5424,424,18,3,5.882352941176471,79.23
11673,5184,26,5184,1350,17,9,100.0,100.0
11674,190872,19,190872,762,18,1,8.333333333333334,56.36
11675,148128,16,148128,11805,13,3,11.11111111111111,53.27
11676,623988,56,0,33548,26,30,11.11111111111111,0.0
11677,5820,23,5820,975,20,3,7.142857142857143,80.87
11678,7152,22,7152,504,20,2,5.555555555555555,77.78
11679,740784,29,0,83669,24,5,50.0,0.0
11680,4942356,6456,95052,430169,3668,2788,1.0,0.0
11681,74448,51,0,3402,41,10,50.0,0.0
11682,12972,32,12972,921,25,7,6.25,37.51
11683,2378508,28,0,86006,23,5,33.333333333333336,0.0
11684,2154804,191,0,44140,95,96,4.0,0.0
11685,269280,46,269280,1582,38,8,2.7777777777777777,14.94
11686,45348,42,45348,45012,20,22,9.090909090909092,89.69
11687,877452,55,0,21002,42,13,33.333333333333336,0.0
11688,46188,10,46188,46105,8,2,11.11111111111111,92.68
11689,264612,740,145428,14325,524,216,1.0,36.26
11690,2880,8,2880,1147,5,3,100.0,0.0
11691,75060,19,75060,3042,17,2,7.6923076923076925,80.33
11692,10212,90,0,1327,68,22,50.0,0.0
11693,2568,47,0,884,45,2,100.0,100.0
11694,202788,1,0,202788,0,1,50.0,0.0
11695,4663128,2078,138718,78193,1158,920,1.0,3.35
11696,828,41,828,451,41,0,50.0,16.92
11697,1428,5,1428,684,5,0,33.333333333333336,66.41
11698,73104,46,0,4936,39,7,50.0,0.0
11699,72,1,72,0,1,0,33.333333333333336,62.4
11700,9552,53,0,3480,49,4,100.0,0.0
11701,319428,5,319428,196,5,0,8.333333333333334,0.0
11702,480,3,480,48,3,0,25.0,94.0
11703,1572,29,1572,588,29,0,16.666666666666668,17.25
11704,3348,84,0,1065,81,3,100.0,100.0
11705,20484,39,0,2474,32,7,33.333333333333336,0.0
11706,19764,22,19764,560,17,5,8.333333333333334,44.15
11707,2796,359,0,782,274,85,50.0,0.0
11708,3096,100,3096,1214,100,0,33.333333333333336,7.16
11709,576,85,0,141,45,40,50.0,0.0
11710,17064,92,17064,545,68,24,2.272727272727273,0.0
11711,70080,66,0,9327,52,14,100.0,0.0
11712,479040,64,380934,68383,53,11,3.0303030303030303,8.74
11713,4817448,6697,1114008,1106424,3956,2741,1.0,0.31
11714,204,42,96,32,37,5,2.7777777777777777,0.0
11715,3737592,401,0,48233,204,197,3.125,0.0
11716,3372,112,576,526,67,45,2.1739130434782608,0.0
11717,1680,68,1578,815,68,0,7.142857142857143,18.01
11718,44316,16,44316,327,6,10,33.333333333333336,93.22
11719,117672,28,117672,15792,14,14,14.285714285714286,72.83
11720,1296,71,1296,616,70,1,14.285714285714286,12.92
11721,96,0,96,0,0,0,50.0,80.0
11722,36612,51,36612,94,38,13,3.0303030303030303,55.85
11723,21024,15,21024,1883,12,3,11.11111111111111,28.68
11724,1464,69,1464,728,69,0,14.285714285714286,15.57
11725,9636,33,0,2472,28,5,100.0,0.0
11726,2746104,64,0,164657,51,13,25.0,0.0
11727,20568,18,20568,453,14,4,7.6923076923076925,85.33
11728,164196,3,164196,24824,2,1,50.0,99.99
11729,40944,15,40944,13581,14,1,7.6923076923076925,4.23
11730,1584,60,1584,791,58,2,9.090909090909092,28.39
11731,456,79,456,162,59,20,2.5641025641025643,70.84
11732,24468,327,0,5835,197,130,1.0,0.0
11733,4370628,30,9792,759326,22,8,8.333333333333334,74.43
11734,312,30,0,92,20,10,50.0,0.0
11735,5532,47,5532,3269,37,10,2.5641025641025643,50.66
11736,492,39,492,66,33,6,3.125,61.22
11737,432,42,432,5,42,0,2.272727272727273,59.84
11738,60024,38,60024,903,30,8,3.703703703703704,89.45
11739,489348,21,361890,22045,17,4,8.333333333333334,45.34
11740,624,151,504,98,113,38,1.0,3.71
11741,28068,27,17358,1469,24,3,6.666666666666667,77.58
11742,494784,100,494784,180710,100,0,25.0,94.9
11743,1382628,91,0,124960,82,9,100.0,100.0
11744,9216,0,9216,0,0,0,100.0,100.0
11745,4948704,8408,0,492736,4921,3487,1.0,0.0
11746,3816,52,3816,55,38,14,3.0303030303030303,0.0
11747,360,0,360,0,0,0,50.0,85.0
11748,23412,21,23412,2098,18,3,8.333333333333334,92.53
11749,491508,65,414204,66366,55,10,2.631578947368421,16.13
11750,4644,44,4644,35,38,6,2.702702702702702,0.0
11751,1816896,945,0,13926,544,401,16.666666666666668,0.0
11752,492672,38,385602,44117,34,4,3.333333333333333,22.69
11753,552,69,0,194,48,21,50.0,0.0
11754,110064,146,0,21874,134,12,100.0,0.0
11755,48972,44,48972,827,41,3,2.5,37.7
11756,498960,59,498960,205317,59,0,3.333333333333333,93.09
11757,2520420,155,2520420,5747,61,94,6.25,0.0
11758,4776,20,4776,1136,18,2,9.090909090909092,83.65
11759,72060,9,72060,7958,9,0,9.090909090909092,78.58
11760,17364,96,0,2062,66,30,2.127659574468085,0.0
11761,3047676,530,0,59251,226,304,1.7857142857142858,0.0
11762,468,49,468,65,37,12,3.0303030303030303,25.34
11763,5016,464,5016,1019,178,286,1.0,48.18
11764,5376,19,5376,1230,18,1,6.25,96.46
11765,87768,382,38196,7715,222,160,2.380952380952381,73.76
11766,1488,1,1488,84,1,0,50.0,95.25
11767,120,18,120,18,15,3,7.142857142857143,40.36
11768,5556,2,5556,1194,2,0,33.333333333333336,99.34
11769,444,23,0,164,19,4,50.0,0.0
11770,3788304,592,0,24298,345,247,1.0,5.28
11771,2251044,279,0,27748,156,123,1.5625,0.0
11772,94680,23,0,15343,12,11,50.0,0.0
11773,4332,12,4332,1860,12,0,9.090909090909092,21.34
11774,4922160,5255,402081,494453,3078,2177,1.0,3.0
11775,4980840,11275,1181352,2896743,7448,3827,1.0,2.8
11776,1812,118,0,246,104,14,100.0,0.0
11777,1656,287,1656,885,87,200,1.3157894736842106,13.0
11778,4470420,325,0,173117,174,151,3.225806451612903,0.0
11779,3348,6,3348,404,6,0,14.285714285714286,56.99
11780,56700,34,56700,688,29,5,3.333333333333333,9.12
11781,5328,88,5328,2254,41,47,4.166666666666667,74.12
11782,3987420,246,0,94844,142,104,2.1739130434782608,0.0
11783,6960,39,6960,555,35,4,2.857142857142857,42.22
11784,11844,132,0,2296,79,53,2.0,0.0
11785,14148,13,14148,626,13,0,9.090909090909092,79.68
11786,7656,5,7656,4053,5,0,25.0,82.22
11787,8388,71,8388,3953,71,0,2.5641025641025643,29.6
11788,4680,14,4680,1036,14,0,20.0,99.43
11789,5544,17,5544,802,15,2,9.090909090909092,82.36
11790,2590992,122,0,47865,62,60,6.25,8.0
11791,86196,25,86196,9810,23,2,4.761904761904762,32.66
11792,9420,25,9420,1614,23,2,8.333333333333334,81.92
11793,4461672,996,409236,12515,637,359,1.0,0.0
11794,140016,4,140016,2160,3,1,50.0,99.98
11795,61188,66,61188,1440,57,9,1.7857142857142858,23.39
11796,4554264,1565,399888,182182,822,743,1.0,0.0
11797,1032,68,1032,316,49,19,3.225806451612903,46.49
11798,4974144,2769,506112,325262,1599,1170,1.0,0.0
11799,85380,40,85380,2874,40,0,2.5641025641025643,64.63
11800,1644,1,0,1644,1,0,33.333333333333336,99.9
11801,22668,26,22668,1145,22,4,6.666666666666667,79.06
11802,4269516,166,0,58347,84,82,5.0,0.0
11803,3586272,213,2131036,1511391,213,0,1.0,6.76
11804,24420,23,0,9877,22,1,100.0,0.0
11805,6396,6,3234,1188,4,2,20.0,49.85
11806,3566520,809,0,123557,487,322,3.0303030303030303,0.0
11807,348,3,348,136,2,1,33.333333333333336,78.12
11808,936,42,936,347,30,12,6.666666666666667,74.54
11809,2377596,73,0,107025,60,13,25.0,0.0
11810,471240,39,428406,83190,39,0,2.9411764705882355,24.16
11811,204360,92,204360,23972,50,42,3.703703703703704,77.33
11812,49320,11,49320,424,11,0,8.333333333333334,46.88
11813,17856,26,17856,1498,25,1,4.3478260869565215,73.4
11814,468,1,0,468,1,0,50.0,0.0
11815,50112,12,50112,277,8,4,20.0,81.4
11816,27864,45,0,2868,38,7,100.0,0.0
11817,18576,1,18576,4884,1,0,50.0,99.77
11818,28608,15,28608,28328,12,3,7.6923076923076925,72.0
11819,8616,11,8616,1254,10,1,12.5,87.41
11820,4996032,6694,1601648,529613,3946,2748,1.0,0.52
11821,51576,56,0,3485,50,6,100.0,0.0
11822,69156,17,64656,14376,15,2,8.333333333333334,43.27
11823,9312,554,0,1054,234,320,1.3888888888888888,0.0
11824,261036,46,0,7510,29,17,100.0,0.0
11825,14208,25,14208,1036,21,4,6.666666666666667,73.47
11826,1788384,49,0,76874,19,30,14.285714285714286,0.0
11827,15060,19,15060,884,16,3,10.0,76.58
11828,16788,56,16788,3624,51,5,1.9230769230769231,10.73
11829,6000,41,6000,2275,27,14,2.7777777777777777,43.98
11830,4813488,1459,0,234920,819,640,1.0,3.21
11831,0,0,0,0,0,0,50.0,0.0
11832,4811100,780,744720,177818,308,472,6.666666666666667,0.0
11833,1032,19,0,649,17,2,50.0,0.0
11834,11604,17,11604,11515,12,5,9.090909090909092,86.85
11835,211260,15,211260,11229,13,2,8.333333333333334,55.61
11836,4376544,986,0,71148,571,415,1.4492753623188406,0.0
11837,9696,27,9696,466,23,4,5.2631578947368425,74.55
11838,3595356,57,0,67738,50,7,33.333333333333336,0.0
11839,14664,26,14664,854,24,2,5.2631578947368425,76.97
11840,18804,30,18804,1576,27,3,5.0,79.97
11841,774936,25,774936,821,11,14,12.5,83.21
11842,156,0,156,0,0,0,50.0,80.0
11843,57000,384,57000,4434,211,173,50.0,0.01
11844,18336,58,0,3209,48,10,50.0,0.0
11845,8400,68,8400,1930,58,10,1.7857142857142858,3.7
11846,2812152,48,2812152,96421,21,27,11.11111111111111,87.6
11847,192,1,0,192,1,0,33.333333333333336,0.0
11848,1686924,82,0,83228,41,41,6.666666666666667,0.0
11849,27936,36,27936,1024,33,3,3.0303030303030303,40.14
11850,61668,52,0,2507,49,3,50.0,0.0
11851,120876,62,0,4984,52,10,100.0,0.0
11852,4108200,327,0,501085,216,111,1.075268817204301,0.0
11853,420,41,420,6,41,0,2.3255813953488373,59.81
11854,62844,48,0,2557,43,5,50.0,0.0
11855,17340,41,0,8361,38,3,100.0,0.0
11856,1076904,13,1076904,112939,11,2,25.0,48.23
11857,923112,32,20184,29678,28,4,4.166666666666667,75.27
11858,10260,71,10260,1468,60,11,1.851851851851852,27.23
11859,11424,321,0,4712,179,142,1.3888888888888888,0.0
11860,15816,16,15816,4607,14,2,3.0303030303030303,2.47
11861,87672,9,87672,8493,4,5,1.0,0.0
11862,4618224,764,0,411936,475,289,1.0,0.0
11863,372,0,372,0,0,0,50.0,82.18
11864,637164,7,637164,207077,7,0,10.0,65.9
11865,9324,23,9324,406,21,2,5.2631578947368425,72.17
11866,588,10,588,58,7,3,3.8461538461538463,45.96
11867,19836,19,19836,774,17,2,11.11111111111111,82.13
11868,63084,511,0,5239,297,214,100.0,0.0
11869,4320684,168,562545,562337,103,65,2.7777777777777777,5.35
11870,13692,32,13692,628,29,3,4.3478260869565215,83.0
11871,2193516,266,0,31025,153,113,2.5,0.0
11872,8196,59,8196,1730,55,4,1.818181818181818,30.26
11873,111288,15,111288,69288,15,0,6.25,17.19
11874,24432,82,0,2721,72,10,100.0,0.0
11875,7260,30,7260,473,26,4,4.545454545454546,73.98
11876,4052832,168,0,72868,94,74,5.882352941176471,0.0
11877,4596,22,4596,392,20,2,5.882352941176471,78.25
11878,7860,24,7860,443,21,3,5.882352941176471,78.28
11879,30864,17,30864,748,15,2,10.0,82.8
11880,14724,73,0,3034,64,9,50.0,0.0
11881,25692,23,25692,1102,19,4,8.333333333333334,93.58
11882,1350120,82,1764,17861,52,30,2.631578947368421,58.21
11883,44028,30,44028,1022,26,4,25.0,99.82
11884,288,9,288,77,9,0,9.090909090909092,37.69
11885,15552,46,0,2769,40,6,100.0,0.0
11886,17232,66,0,2062,58,8,50.0,0.0
11887,2830056,186,0,31758,97,89,4.3478260869565215,0.0
11888,5280,41,5280,3103,34,7,20.0,99.71
11889,3328644,502,0,49964,284,218,1.6129032258064515,0.0
11890,297588,68,297588,25883,54,14,5.0,20.31
11891,4748268,252,0,266531,109,143,7.6923076923076925,0.0
11892,237024,16,237024,933,11,5,9.090909090909092,0.06
11893,245316,36,245316,21019,31,5,3.8461538461538463,48.4
11894,98016,714,48678,14077,519,195,1.0,7.07
11895,27732,40,0,2853,33,7,50.0,0.0
11896,768,16,0,478,13,3,50.0,0.0
11897,33360,21,33360,876,18,3,9.090909090909092,74.59
11898,660,6,552,220,5,1,14.285714285714286,54.2
11899,4759452,624,0,545249,350,274,1.639344262295082,0.0
11900,34068,223,0,4748,139,84,1.2345679012345678,0.0
11901,156,14,156,31,12,2,7.6923076923076925,47.18
11902,30156,97,0,2500,68,29,33.333333333333336,0.0
11903,16668,20,16668,1079,18,2,7.142857142857143,49.94
11904,684,15,0,296,14,1,50.0,0.0
11905,14796,229,14796,2798,99,130,2.272727272727273,67.02
11906,12192,66,0,2563,58,8,50.0,0.0
11907,1706700,14,17280,244175,10,4,12.5,84.61
11908,4775652,1127,0,104333,617,510,1.0,0.0
11909,17988,5,17988,427,5,0,25.0,70.19
11910,27156,27,27156,951,22,5,9.090909090909092,63.24
11911,4571196,0,4571196,0,0,0,100.0,100.0
11912,15720,36,0,3550,32,4,100.0,0.0
11913,4691184,419,0,240745,248,171,2.2222222222222223,0.0
11914,383268,49,0,17065,43,6,33.333333333333336,0.0
11915,600,0,600,0,0,0,50.0,83.34
11916,21696,13,21696,598,11,2,11.11111111111111,28.36
11917,287784,31,285048,37104,28,3,4.3478260869565215,59.66
11918,276,29,276,108,16,13,5.555555555555555,56.73
11919,29688,6,0,5854,4,2,100.0,0.0
11920,39864,186,0,5065,116,70,1.3333333333333333,0.0
11921,2940,52,2916,2821,46,6,2.272727272727273,21.79
11922,876,4,876,531,2,2,50.0,76.35
11923,5064,15,5064,649,13,2,10.0,58.75
11924,3048108,598,0,45938,342,256,1.5873015873015872,0.0
11925,571524,36,406146,30981,31,5,4.0,45.1
11926,30888,50,30888,1841,45,5,2.272727272727273,23.39
11927,8592,21,6210,868,18,3,7.6923076923076925,67.41
11928,80664,115,80664,3206,88,27,1.8867924528301887,16.07
11929,572352,49,416382,53980,45,4,2.4390243902439024,5.85
11930,4877232,1473,472644,134081,791,682,1.0,5.28
11931,12552,28,12552,985,24,4,7.6923076923076925,81.58
11932,948,139,0,188,118,21,1.0,0.0
11933,2712,147,0,221,121,26,50.0,0.0
11934,324,125,324,77,95,30,1.25,4.04
11935,9588,3,9588,812,1,2,20.0,59.41
11936,2827956,27,3804,314786,22,5,8.333333333333334,73.58
11937,408,8,408,123,8,0,9.090909090909092,88.63
11938,69864,13,69864,550,13,0,6.666666666666667,74.2
11939,1632,134,0,290,110,24,100.0,0.0
11940,1380,43,1380,15,41,2,2.380952380952381,29.04
11941,361236,36,275268,38587,32,4,3.4482758620689653,41.31
11942,5045364,737,575796,1388918,366,371,1.0,0.0
11943,46152,88,46152,2361,73,15,1.4285714285714286,6.02
11944,37068,56,37068,1302,49,7,2.1739130434782608,32.16
11945,4320,49,4320,3904,33,16,3.125,78.2
11946,1080,49,1080,43,48,1,2.0,32.06
11947,1248,259,1248,577,213,46,1.0,44.74
11948,1272,48,1272,8,48,0,2.0,53.28
11949,533784,5,0,912,5,0,14.285714285714286,10.11
11950,16800,10,16800,1287,10,0,12.5,73.13
11951,144,4,144,99,3,1,25.0,0.51
11952,44916,20,9204,4149,19,1,6.25,73.66
11953,67212,8,67212,10545,6,2,33.333333333333336,99.9
11954,55644,363,0,5558,217,146,100.0,0.0
11955,1200,48,1200,439,37,11,3.225806451612903,22.52
11956,154548,12,154548,94172,12,0,8.333333333333334,11.17
11957,19848,30,19848,1256,26,4,6.25,89.93
11958,217872,48,78456,18322,41,7,3.0303030303030303,27.98
11959,2937180,136,2937180,40121,50,86,10.0,0.0
11960,7488,27,7488,2005,15,12,14.285714285714286,89.9
11961,3066192,1511,0,22321,704,807,1.0,0.0
11962,6168,14,6168,771,13,1,9.090909090909092,58.3
11963,564,93,564,94,69,24,1.7543859649122806,57.73
11964,234744,22,234744,61756,10,12,3.703703703703704,0.0
11965,1599660,40,49800,73376,27,13,6.25,82.89
11966,4272,19,4272,1232,18,1,7.142857142857143,42.53
11967,3585576,901,0,23816,477,424,1.3888888888888888,0.0
11968,53484,113,53484,7848,95,18,1.162790697674419,19.59
11969,5062884,6594,3094854,1297864,4083,2511,1.0,0.0
11970,4817772,878,0,59815,400,478,1.36986301369863,5.0
11971,153024,55,0,17924,36,19,100.0,0.0
11972,5074272,1940,0,4249065,1136,804,1.0,0.0
11973,3035148,238,0,29033,119,119,3.571428571428572,0.0
11974,105996,109,0,3964,56,53,5.2631578947368425,0.0
11975,4027212,605,0,315354,368,237,1.0,0.0
11976,4885776,2970,941016,188300,1741,1229,1.0,5.0
11977,3360,30,3360,1654,17,13,9.090909090909092,0.0
11978,3336,2,3336,870,2,0,20.0,92.95
11979,56160,21,56160,8156,21,0,4.761904761904762,85.2
11980,216,19,216,31,16,3,7.142857142857143,13.32
11981,1584,13,1584,978,12,1,9.090909090909092,84.15
11982,4211028,700,0,261820,382,318,2.0,0.0
11983,2073624,51,0,191394,25,26,8.333333333333334,0.0
11984,2078544,6,1297176,1247982,6,0,16.666666666666668,99.87
11985,20436,21,20436,1573,19,2,7.6923076923076925,52.93
11986,4881192,337,0,1002455,145,192,1.8867924528301887,0.0
11987,5090604,15148,0,2384765,8797,6351,1.0,1.06
11988,708852,2,708852,349404,2,0,50.0,99.43
11989,42408,30,0,5012,26,4,100.0,0.0
11990,5073924,3151,2130798,942813,1944,1207,1.0,0.0
11991,660,15,0,312,10,5,50.0,0.0
11992,42180,1,0,42180,0,1,100.0,0.0
11993,0,0,0,0,0,0,50.0,10.0
11994,53196,44,0,2968,33,11,50.0,0.0
11995,231360,75,0,6092,41,34,7.142857142857143,0.0
11996,628908,3,628908,205196,3,0,25.0,99.65
11997,5085036,22433,1381392,1002448,14141,8292,1.0,0.46
11998,49056,56,0,3805,50,6,100.0,0.0
11999,4987020,2442,0,1052209,1541,901,1.0,0.0
12000,4990932,102,0,695157,47,55,3.4482758620689653,13.09
12001,249732,148,0,11215,117,31,33.333333333333336,0.0
12002,5964,45,5952,1622,30,15,2.0408163265306123,7.69
12003,6192,50,0,1489,28,22,6.25,0.0
12004,5880,2,0,3180,1,1,100.0,0.0
12005,46068,27,46068,3749,23,4,6.666666666666667,54.78
12006,37344,41,37344,1835,37,4,2.702702702702702,37.04
12007,18612,14,18612,5574,8,6,50.0,99.99
12008,75864,61,75864,32084,59,2,2.5641025641025643,51.87
12009,8904,294,0,3180,162,132,1.5625,0.0
12010,3564,5,3564,705,5,0,16.666666666666668,97.79
12011,70800,405,0,5810,233,172,100.0,0.0
12012,192,13,192,62,9,4,20.0,94.26
12013,103452,15,0,7183,11,4,100.0,0.0
12014,77688,90,0,6597,78,12,100.0,0.0
12015,61236,96,0,2739,70,26,50.0,0.0
12016,18552,13,18552,815,12,1,12.5,67.68
12017,7680,22,7680,385,21,1,5.555555555555555,77.16
12018,1381848,4,1381848,15354,4,0,100.0,99.99
12019,2664,0,2664,0,0,0,25.0,94.0
12020,2880,37,2880,1401,26,11,1.96078431372549,5.29
12021,63204,79,62628,38422,67,12,2.5641025641025643,30.38
12022,12348,134,0,2539,80,54,1.9230769230769231,0.0
12023,72948,26,7464,3199,22,4,5.555555555555555,74.9
12024,804,5,804,283,5,0,14.285714285714286,66.05
12025,5073732,901,0,157431,510,391,1.4285714285714286,0.0
12026,1552872,81,0,49238,42,39,12.5,0.0
12027,13212,27,13212,790,24,3,5.2631578947368425,75.13
12028,14904,64,0,3056,52,12,50.0,0.0
12029,1416,39,0,271,27,12,4.166666666666667,0.0
12030,96,8,96,12,8,0,10.0,51.54
12031,4236,21,4236,386,20,1,6.25,78.56
12032,529092,34,500364,95328,31,3,3.4482758620689653,28.46
12033,4907772,216,0,380025,167,49,1.0,0.0
12034,230700,31,230700,37980,26,5,4.545454545454546,84.61
12035,5088552,808,0,299980,472,336,1.0,0.0
12036,11604,14,11604,1997,13,1,10.0,83.25
12037,23256,46,0,5213,40,6,100.0,0.0
12038,360,3,0,212,2,1,50.0,0.0
12039,20124,26,20124,1362,23,3,6.666666666666667,29.94
12040,1143420,71,0,32985,35,36,5.882352941176471,0.0
12041,540984,24,22344,68524,21,3,8.333333333333334,60.92
12042,8232,51,0,1806,43,8,100.0,0.0
12043,195564,50,179976,26482,45,5,2.9411764705882355,24.68
12044,5113800,3174,31596,849077,1947,1227,1.0,0.0
12045,1584,47,1584,1414,41,6,2.5,24.94
12046,54396,25,54396,5058,15,10,14.285714285714286,91.39
12047,128340,640,76194,11824,474,166,1.0,18.05
12048,10836,213,0,4105,143,70,1.5384615384615383,0.0
12049,5073300,720,0,769149,403,317,1.4705882352941178,0.0
12050,649476,12,649476,49266,7,5,25.0,84.83
12051,176556,2,0,88554,1,1,50.0,0.0
12052,11640,24,11640,821,21,3,5.2631578947368425,27.0
12053,1020,198,0,515,132,66,50.0,0.0
12054,240,60,216,179,42,18,2.857142857142857,43.41
12055,252,47,252,59,27,20,5.2631578947368425,76.58
12056,30552,4,0,8970,3,1,100.0,0.0
12057,948,6,0,576,3,3,33.333333333333336,99.83
12058,10116,42,0,1942,36,6,100.0,0.0
12059,3335172,28,66156,473043,23,5,6.666666666666667,80.62
12060,652416,46,430206,28799,39,7,3.225806451612903,21.26
12061,39084,50,0,1929,44,6,50.0,0.0
12062,13044,34,0,3116,30,4,100.0,0.0
12063,288,13,288,76,9,4,11.11111111111111,96.25
12064,25320,36,0,1481,29,7,50.0,0.0
12065,2533836,126,0,62137,68,58,2.9411764705882355,0.0
12066,2316,8,2316,1681,7,1,16.666666666666668,59.74
12067,1936584,62,1936584,66667,33,29,5.2631578947368425,62.18
12068,2407524,302,0,33835,143,159,3.703703703703704,0.0
12069,1848,62,1428,918,49,13,2.380952380952381,47.48
12070,909852,51,0,34403,43,8,100.0,0.0
12071,4611012,101,37308,170762,79,22,1.4492753623188406,28.87
12072,4860,454,0,1372,235,219,1.4285714285714286,1.29
12073,194052,35,177324,14318,29,6,5.0,43.82
12074,80136,18,80136,340,15,3,8.333333333333334,35.69
12075,2196840,59,0,60835,50,9,50.0,0.0
12076,155760,53,155760,155635,28,25,16.666666666666668,91.56
12077,38436,17,38436,733,15,2,8.333333333333334,39.1
12078,870096,12,0,73078,6,6,25.0,0.0
12079,68220,8,68220,1018,8,0,14.285714285714286,43.72
12080,1032,0,1032,0,0,0,100.0,100.0
12081,65628,116,65628,1083,102,14,1.0309278350515465,10.95
12082,1812,11,0,552,9,2,100.0,0.0
12083,20472,197,0,2497,118,79,1.408450704225352,0.0
12084,13068,84,0,2992,58,26,2.127659574468085,0.0
12085,77124,23,77124,960,18,5,8.333333333333334,70.04
12086,3007644,79,0,811603,9,70,25.0,0.0
12087,71628,18,71628,2572,15,3,8.333333333333334,66.98
12088,20184,18,12132,1145,17,1,6.25,63.96
12089,4809576,771,0,66458,458,313,1.0,0.0
12090,288,34,288,5,32,2,3.0303030303030303,52.02
12091,156,44,156,4,42,2,2.3255813953488373,48.21
12092,42444,106,42444,2670,86,20,1.3333333333333333,6.8
12093,2364,168,0,367,143,25,100.0,0.0
12094,4633008,2631,2033184,98636,1498,1133,1.0,1.17
12095,1824492,295,0,35045,174,121,2.127659574468085,0.0
12096,74544,24,74544,1738,21,3,6.666666666666667,77.28
12097,4188,4,0,1206,3,1,100.0,0.0
12098,12996,1,12996,12960,1,0,50.0,94.8
12099,109800,80,109800,548,80,0,1.2658227848101269,17.03
12100,1404,47,1404,6,47,0,2.0408163265306123,54.57
12101,171516,92,171516,171387,54,38,2.857142857142857,72.69
12102,216,8,0,109,5,3,50.0,0.0
12103,7644,32,7644,1613,28,4,5.2631578947368425,59.2
12104,576,24,576,69,22,2,4.166666666666667,46.75
12105,96744,96,23664,18064,74,22,2.9411764705882355,36.1
12106,1476,149,0,272,121,28,100.0,0.0
12107,192,0,192,0,0,0,50.0,84.0
12108,88056,43,88056,9579,31,12,3.703703703703704,17.55
12109,18108,0,18108,0,0,0,100.0,100.0
12110,3677196,728,0,68614,323,405,1.4285714285714286,8.75
12111,341256,21,341256,229,21,0,4.3478260869565215,36.52
12112,4755876,841,0,133473,476,365,1.5873015873015872,0.0
12113,2664,2,2664,828,2,0,25.0,75.12
12114,5129868,4245,1098792,407990,2490,1755,1.0,4.52
12115,4021080,394,0,33741,180,214,5.0,2.0
12116,5035680,746,0,25049,349,397,1.1363636363636365,10.0
12117,4620240,516,0,64028,247,269,1.2987012987012987,0.0
12118,5124720,3520,579888,71620,2016,1504,1.0,0.0
12119,1142772,33,1142772,853066,29,4,16.666666666666668,28.26
12120,4909296,4890,1441188,66165,3058,1832,1.0,0.0
12121,5013012,155,1441104,55503,79,76,4.166666666666667,3.56
12122,4990404,353,0,131860,199,154,2.2222222222222223,0.0
12123,73896,26,0,3813,15,11,50.0,0.0
12124,5071980,1553,582576,85082,757,796,1.0,0.0
12125,5148912,6309,0,1650368,3422,2887,1.0,0.0
12126,17760,35,0,1402,15,20,25.0,0.0
12127,3375120,135,2047056,67519,87,48,1.4285714285714286,0.0
12128,108,0,108,0,0,0,50.0,80.0
12129,4788288,1306,583560,95162,680,626,1.0,0.0
12130,4972596,1585,0,129544,912,673,1.0,0.0
12131,5448,119,5448,146,97,22,1.1363636363636365,27.89
12132,20100,55,84,388,44,11,2.380952380952381,7.76
12133,18696,143,0,3449,95,48,1.3888888888888888,0.0
12134,4883940,2017,2050752,191495,1041,976,1.0,1.0
12135,4878720,1292,165996,52461,675,617,1.0,0.0
12136,98544,50,98544,5122,36,14,3.225806451612903,16.32
12137,83328,6,0,23592,4,2,100.0,0.0
12138,312,20,288,66,17,3,5.882352941176471,29.65
12139,3893868,18,0,666088,16,2,33.333333333333336,0.0
12140,156576,21,0,29337,10,11,100.0,0.0
12141,43668,15,43668,971,14,1,8.333333333333334,52.63
12142,3884784,58,0,73297,35,23,2.5641025641025643,0.0
12143,479856,4,289032,146886,3,1,100.0,100.0
12144,4877052,849,2053644,177710,431,418,1.0,7.96
12145,73668,3,73668,5552,3,0,25.0,86.99
12146,55416,16,0,10846,9,7,100.0,0.0
12147,581304,7,581304,83741,5,2,50.0,0.0
12148,360,29,360,213,13,16,14.285714285714286,59.2
12149,30504,57,0,3104,50,7,100.0,0.0
12150,238284,732,79184,40388,546,186,1.0,35.11
12151,182484,4,182484,306,2,2,100.0,100.0
12152,91500,27,0,16059,18,9,100.0,0.0
12153,85128,117,85128,84518,87,30,1.2987012987012987,35.67
12154,56340,486,0,4551,293,193,100.0,0.0
12155,5105160,583,0,1157394,328,255,1.36986301369863,0.0
12156,300,13,300,121,8,5,20.0,45.8
12157,6288,12,6288,678,11,1,10.0,66.14
12158,6420,15,3480,1413,15,0,11.11111111111111,96.0
12159,156828,31,94038,3848,22,9,2.0408163265306123,0.0
12160,3672,8,1560,516,7,1,16.666666666666668,94.67
12161,4336596,10,0,3052999,10,0,12.5,90.0
12162,883224,584,247584,80168,578,6,100.0,99.99
12163,7812,25,7752,2902,18,7,7.6923076923076925,82.83
12164,3828,22,0,1618,13,9,20.0,0.0
12165,4690920,1402,0,89387,759,643,1.0,0.88
12166,37416,30,37416,4054,23,7,7.142857142857143,54.84
12167,162480,101,0,32377,86,15,100.0,0.0
12168,1944612,51,0,163210,46,5,16.666666666666668,0.0
12169,29388,151,0,2872,89,62,1.6666666666666667,0.0
12170,48132,2,48132,23670,2,0,50.0,99.49
12171,11952,30,0,3474,26,4,100.0,0.0
12172,816,5,816,98,3,2,33.333333333333336,50.71
12173,34584,21,34584,1798,17,4,8.333333333333334,72.43
12174,15552,24,6240,1133,22,2,5.0,76.13
12175,35568,21,35568,1102,21,0,6.25,78.89
12176,4797384,836,0,372832,466,370,1.3157894736842106,0.0
12177,841128,48,0,39659,20,28,10.0,0.0
12178,6624,36,6624,1638,35,1,2.3255813953488373,91.16
12179,10452,27,10452,890,24,3,5.2631578947368425,75.71
12180,42408,22,42408,1679,19,3,7.6923076923076925,75.33
12181,4164,23,0,1723,19,4,100.0,0.0
12182,604872,14,604872,98160,11,3,16.666666666666668,0.0
12183,1247772,183,0,11908,142,41,33.333333333333336,0.0
12184,4971960,3009,0,165481,1519,1490,1.0,0.0
12185,264,16,192,50,11,5,11.11111111111111,66.54
12186,372,44,372,0,44,0,2.1739130434782608,57.34
12187,656244,17,468,51078,12,5,16.666666666666668,0.0
12188,13908,382,0,3294,224,158,1.3157894736842106,0.0
12189,406056,42,0,13177,35,7,50.0,0.0
12190,716952,3,716952,232528,3,0,25.0,99.5
12191,4764,22,4764,408,19,3,6.25,77.58
12192,7092,61,7092,1721,54,7,2.0408163265306123,23.77
12193,1040568,18,8772,115750,15,3,8.333333333333334,72.4
12194,20628,81,0,1741,70,11,50.0,0.0
12195,317772,22,36072,15259,18,4,8.333333333333334,73.22
12196,6360,14,6360,1004,12,2,9.090909090909092,41.32
12197,410028,51,0,25293,44,7,25.0,0.0
12198,990600,88,0,57644,78,10,33.333333333333336,0.0
12199,610860,6,610860,136548,5,1,20.0,78.24
12200,18336,12,18336,809,11,1,10.0,85.32
12201,3453492,304,0,14576,148,156,4.545454545454546,0.0
12202,8976,21,8976,589,21,0,5.0,82.62
12203,2665716,305,2664612,53186,156,149,4.166666666666667,0.0
12204,78060,434,0,5110,247,187,100.0,0.0
12205,248328,35,248328,15169,34,1,3.0303030303030303,32.65
12206,576876,24,14748,24449,21,3,5.2631578947368425,87.17
12207,56028,124,0,14801,112,12,100.0,0.0
12208,3814716,747,0,25034,414,333,1.1363636363636365,0.0
12209,11352,55,11352,1883,49,6,2.0408163265306123,21.97
12210,3528,21,3528,322,18,3,6.666666666666667,83.84
12211,2215332,22,0,101220,20,2,33.333333333333336,0.0
12212,785700,2,785700,39828,2,0,50.0,99.85
12213,1488,27,1392,636,25,2,4.166666666666667,83.05
12214,4380,26,3240,539,22,4,5.2631578947368425,80.93
12215,189768,80,0,4256,70,10,100.0,0.0
12216,7716,17,7716,623,15,2,11.11111111111111,19.39
12217,4976832,27,3240,445701,24,3,5.0,79.47
12218,5193480,3668,0,574557,2044,1624,1.0,0.0
12219,363012,40,0,10071,25,15,100.0,0.0
12220,20952,55,0,2634,46,9,100.0,0.0
12221,22512,23,15264,1627,21,2,5.555555555555555,83.07
12222,96696,57,4944,4905,25,32,10.0,0.0
12223,3024,11,3024,621,10,1,11.11111111111111,51.37
12224,38832,1,0,38832,0,1,100.0,0.0
12225,320556,49,0,7624,42,7,25.0,0.0
12226,21168,20,4032,1351,18,2,5.882352941176471,83.34
12227,12624,48,0,956,41,7,50.0,0.0
12228,5014596,55,0,191046,48,7,50.0,0.0
12229,3888,11,0,609,6,5,100.0,0.0
12230,104148,54,0,2961,35,19,100.0,0.0
12231,56028,16,56028,610,14,2,10.0,32.75
12232,168552,54,168552,19191,49,5,3.225806451612903,3.64
12233,258564,23,258564,6358,20,3,10.0,56.3
12234,7512,42,0,962,37,5,50.0,0.0
12235,213996,45,213996,9750,42,3,2.5,21.55
12236,6852,55,0,992,49,6,50.0,0.0
12237,2454636,147,0,19329,95,52,1.4492753623188406,0.0
12238,29580,27,29580,2653,20,7,8.333333333333334,49.85
12239,1932,8,0,553,5,3,100.0,0.0
12240,37596,5,37596,1286,3,2,33.333333333333336,58.27
12241,1195548,40,0,107404,33,7,33.333333333333336,0.0
12242,5175372,1485,0,296080,873,612,1.0,0.0
12243,1212,9,576,277,8,1,9.090909090909092,62.26
12244,81072,68,0,5075,63,5,50.0,0.0
12245,960,17,420,227,12,5,11.11111111111111,49.61
12246,41976,17,41976,562,14,3,12.5,72.7
12247,32712,23,32712,860,19,4,8.333333333333334,66.42
12248,454836,223,454836,7383,140,83,1.075268817204301,46.87
12249,66588,122,66588,95,106,16,1.0,20.21
12250,4752,22,4752,565,16,6,11.11111111111111,51.21
12251,38388,16,38388,484,13,3,11.11111111111111,78.28
12252,8676,17,8676,796,9,8,50.0,99.32
12253,293400,57,263058,40327,49,8,2.702702702702702,45.34
12254,43464,44,43464,857,37,7,7.142857142857143,45.48
12255,50280,448,50280,298,198,250,1.351351351351351,31.52
12256,46272,41,46272,1685,32,9,6.25,77.07
12257,504,110,504,247,82,28,1.694915254237288,52.48
12258,17676,0,17676,0,0,0,100.0,100.0
12259,21648,57,0,3353,48,9,100.0,0.0
12260,37056,271,37056,300,189,82,1.0,0.0
12261,5496,31,5496,952,25,6,7.142857142857143,39.48
12262,20772,365,13512,5597,201,164,1.0,0.0
12263,3192,16,3192,3030,10,6,16.666666666666668,78.32
12264,33720,45,33720,218,45,0,2.1739130434782608,0.0
12265,89460,46,89460,8233,40,6,2.631578947368421,96.74
12266,6780,35,6780,1322,29,6,5.555555555555555,92.44
12267,42108,318,0,4109,187,131,100.0,0.0
12268,300000,62,201744,13760,50,12,2.857142857142857,52.2
12269,1740,1,1740,1380,1,0,33.333333333333336,99.4
12270,13116,274,0,2612,164,110,1.2345679012345678,0.0
12271,5040,837,0,2583,410,427,1.0,0.0
12272,7500,32,7500,799,26,6,7.6923076923076925,49.6
12273,6552,21,6552,702,17,4,10.0,84.77
12274,3586380,95,588,37850,67,28,1.851851851851852,5.55
12275,1344,23,1344,545,21,2,5.555555555555555,50.42
12276,3539988,30,5340,212922,25,5,7.6923076923076925,75.71
12277,28032,318,0,2825,177,141,1.0,0.0
12278,122580,152,122580,13094,121,31,1.2820512820512822,7.23
12279,3588612,995,0,23033,513,482,1.0,0.0
12280,2408628,168,0,26740,131,37,50.0,0.0
12281,34020,6,0,6538,4,2,16.666666666666668,0.0
12282,3350628,35,0,440762,25,10,7.142857142857143,13.3
12283,2700,51,2700,28,51,0,1.8867924528301887,56.76
12284,35604,12,35604,494,11,1,11.11111111111111,6.7
12285,564,17,564,405,12,5,14.285714285714286,52.92
12286,5235168,4325,0,2059193,2403,1922,1.0,0.0
12287,6204,13,6204,874,10,3,14.285714285714286,86.71
12288,6156,105,6156,779,84,21,1.3888888888888888,32.0
12289,11316,21,11316,3429,18,3,7.6923076923076925,97.16
12290,2484,170,0,427,145,25,100.0,0.0
12291,22608,10,22608,6793,6,4,20.0,0.0
12292,180,4,180,78,4,0,16.666666666666668,93.42
12293,43212,57,43212,2285,52,5,2.0408163265306123,48.47
12294,41892,49,0,1982,32,17,100.0,0.0
12295,4152,12,4152,696,11,1,12.5,73.32
12296,4440,62,4440,1414,53,9,2.0,28.18
12297,104652,47,288,2228,47,0,2.083333333333333,42.67
12298,22512,19,22512,1276,17,2,7.142857142857143,61.5
12299,12528,16,12528,825,14,2,8.333333333333334,84.03
12300,5242716,348,0,1322994,246,102,12.5,0.0
12301,585576,35,0,22519,17,18,14.285714285714286,0.0
12302,4733544,2388,2496312,66102,1039,1349,1.0,0.0
12303,23580,198,0,2997,126,72,1.1235955056179776,0.0
12304,2757036,64,668328,148029,40,24,4.0,0.24
12305,2398452,193,1536,12615,158,35,1.0,26.3
12306,4508628,3831,2497428,35561,2261,1570,1.0,0.0
12307,401544,34,14304,15430,24,10,7.142857142857143,0.0
12308,62676,88,62676,2970,75,13,1.4705882352941178,5.06
12309,322272,88,322272,45488,74,14,1.8867924528301887,3.0
12310,131712,19,131712,67157,19,0,5.882352941176471,95.16
12311,13344,33,13344,1422,28,5,6.25,72.1
12312,252,1,252,0,1,0,33.333333333333336,78.0
12313,3678468,516,1779504,37147,224,292,2.083333333333333,9.25
12314,7692,16,7692,1107,15,1,10.0,72.35
12315,139752,6,139752,2596,6,0,25.0,98.78
12316,2256864,64,0,79337,56,8,25.0,0.0
12317,792,14,0,443,10,4,16.666666666666668,13.82
12318,72684,17,516,13875,12,5,14.285714285714286,96.77
12319,156,56,72,49,51,5,2.127659574468085,39.89
12320,5235624,3101,0,120890,1668,1433,1.0,0.0
12321,72732,35,72732,2324,31,4,3.225806451612903,71.43
12322,1260,11,1260,454,10,1,50.0,68.46
12323,2503524,284,0,18379,129,155,2.4390243902439024,0.0
12324,5238312,3268,1451772,1018987,1797,1471,1.0,0.0
12325,191940,7,16548,42452,6,1,16.666666666666668,99.44
12326,1170576,42,0,86511,34,8,33.333333333333336,0.0
12327,96528,7,96528,12154,7,0,11.11111111111111,81.61
12328,912,4,0,450,3,1,50.0,0.0
12329,21300,15,21300,910,14,1,11.11111111111111,82.92
12330,41100,45,0,2524,29,16,100.0,0.0
12331,31500,45,0,2166,39,6,100.0,0.0
12332,19836,25,19836,1808,25,0,4.545454545454546,4.54
12333,3057144,63,0,145202,44,19,16.666666666666668,0.0
12334,76728,21,0,17867,17,4,100.0,0.0
12335,5209752,3839,0,204390,1993,1846,1.0,0.0
12336,6804,39,6804,400,33,6,5.0,77.17
12337,153696,17,153696,9226,17,0,4.761904761904762,0.0
12338,10248,74,10248,3637,64,10,1.6666666666666667,23.65
12339,2268,1,2268,12,1,0,100.0,100.0
12340,13716,6,13716,3008,4,2,50.0,0.0
12341,4992,51,0,965,34,17,100.0,0.0
12342,25632,22,25632,1644,20,2,7.6923076923076925,99.52
12343,166476,12,166476,39018,12,0,8.333333333333334,70.63
12344,3996,31,3996,1670,23,8,100.0,100.0
12345,14520,19,14520,963,17,2,10.0,91.19
12346,4584252,1379,0,35753,763,616,1.0,0.0
12347,225552,88,0,18571,58,30,100.0,0.0
12348,3917160,38,0,212381,22,16,10.0,1.5
12349,121164,23,121164,6799,17,6,10.0,55.86
12350,4701588,558,0,496083,308,250,2.5641025641025643,0.0
12351,10320,9,10320,754,9,0,11.11111111111111,53.83
12352,503328,96,10164,8753,76,20,1.639344262295082,7.53
12353,18528,23,18528,886,20,3,9.090909090909092,72.85
12354,11016,29,11016,1588,26,3,5.882352941176471,29.99
12355,6060,25,6060,1190,22,3,7.142857142857143,76.21
12356,2136,13,2136,800,12,1,9.090909090909092,53.38
12357,10620,35,10500,4449,26,9,5.2631578947368425,0.0
12358,141324,19,141324,1640,14,5,12.5,7.9
12359,330156,727,126759,45206,536,191,1.0,32.17
12360,2766804,429,0,45560,227,202,1.851851851851852,0.0
12361,5040,4,0,1302,3,1,25.0,0.0
12362,17580,30,17580,1541,28,2,4.166666666666667,75.17
12363,31848,23,31848,1518,20,3,7.142857142857143,47.43
12364,7068,41,7068,1163,34,7,5.2631578947368425,36.74
12365,15888,53,15888,1548,48,5,2.3255813953488373,34.15
12366,4800,27,4800,1288,23,4,6.25,81.24
12367,2004,5,0,1867,3,2,50.0,0.08
12368,15372,56,0,1186,40,16,100.0,0.0
12369,3784176,192,0,81987,92,100,3.8461538461538463,0.0
12370,3276,27,3276,1214,19,8,12.5,53.85
12371,793932,466,425700,163709,466,0,1.0,71.65
12372,1128,39,1128,233,26,13,7.142857142857143,5.28
12373,18528,40,0,5081,36,4,100.0,0.0
12374,1269732,36,23988,38464,32,4,3.8461538461538463,67.61
12375,18828,60,0,4216,50,10,100.0,0.0
12376,3804132,184,576,68348,140,44,25.0,0.0
12377,3035760,493,0,55853,206,287,2.5,3.0
12378,192,12,192,40,9,3,11.11111111111111,49.08
12379,66864,25,66864,4593,24,1,4.545454545454546,36.16
12380,174084,0,174084,0,0,0,100.0,100.0
12381,3252756,318,0,32837,168,150,4.3478260869565215,0.0
12382,1259160,21,9288,60339,20,1,5.2631578947368425,77.47
12383,11796,24,11796,2476,21,3,7.6923076923076925,51.82
12384,2868,28,1884,1329,19,9,9.090909090909092,0.0
12385,408,52,396,200,30,22,6.25,66.96
12386,9336,26,9336,1072,22,4,7.142857142857143,74.68
12387,3280380,72,0,151806,59,13,25.0,0.0
12388,15084,25,15084,1266,21,4,9.090909090909092,60.76
12389,150156,27,15168,6388,25,2,4.3478260869565215,82.72
12390,45084,167,0,3099,130,37,100.0,0.0
12391,14016,31,14016,1142,26,5,6.666666666666667,68.33
12392,3330552,32,8220,391941,26,6,5.0,80.91
12393,13968,57,13968,1997,49,8,2.1739130434782608,35.55
12394,103908,23,2928,4851,20,3,6.25,80.99
12395,2627700,98,0,82821,86,12,25.0,0.0
12396,4212,12,4212,640,11,1,11.11111111111111,67.01
12397,232656,99,232656,37225,88,11,1.36986301369863,11.38
12398,22224,0,11634,0,0,0,100.0,100.0
12399,36612,179,0,4389,115,64,1.2987012987012987,0.0
12400,8424,28,0,3714,24,4,100.0,0.0
12401,8136,23,8136,379,21,2,5.555555555555555,81.6
12402,487524,0,487524,0,0,0,100.0,100.0
12403,5171688,3004,796245,286420,1670,1334,1.0,0.0
12404,896784,9,2100,100076,9,0,11.11111111111111,65.8
12405,5217900,455,1486056,369990,244,211,5.2631578947368425,0.0
12406,5017992,1197,0,589236,675,522,1.818181818181818,0.0
12407,1757664,102,0,54556,89,13,50.0,0.0
12408,5197164,1718,108948,1169109,949,769,1.0,0.0
12409,2844,15,2844,904,14,1,11.11111111111111,66.37
12410,12492,36,12492,1502,29,7,7.142857142857143,65.08
12411,5290200,19099,257050,494256,10552,8547,1.0,0.0
12412,32808,61,0,1896,43,18,100.0,0.0
12413,5225616,4865,0,297309,2879,1986,1.0,0.0
12414,2598408,290,0,45697,150,140,4.545454545454546,0.0
12415,78360,23,78360,5436,20,3,8.333333333333334,52.68
12416,116904,9,116904,14502,8,1,10.0,8.35
12417,61992,26,3936,3307,23,3,11.11111111111111,50.62
12418,1542996,218,33036,9142,143,75,1.0101010101010102,0.37
12419,25104,191,120,316,127,64,1.1494252873563218,20.06
12420,5074560,284,0,147051,128,156,5.2631578947368425,0.0
12421,28260,18,28260,1073,15,3,10.0,62.39
12422,1689576,54,0,33192,49,5,50.0,0.0
12423,16668,52,0,2181,43,9,100.0,0.0
12424,30792,20,30792,2156,19,1,7.6923076923076925,64.11
12425,29472,53,0,1603,38,15,100.0,0.0
12426,21504,7,0,4486,6,1,100.0,0.0
12427,1127172,135,405300,99549,120,15,1.0526315789473684,8.08
12428,10464,39,0,4301,33,6,100.0,0.0
12429,1155792,32,22992,130710,27,5,6.666666666666667,71.51
12430,3378336,22,33684,237095,20,2,7.6923076923076925,67.3
12431,5142960,632,0,68589,313,319,1.1494252873563218,0.0
12432,14436,95,0,2123,57,38,2.7777777777777777,0.0
12433,6924,11,6924,811,11,0,10.0,76.21
12434,6552,138,0,917,94,44,1.4492753623188406,0.0
12435,36252,21,36252,2301,19,2,7.6923076923076925,62.93
12436,708,60,552,249,39,21,3.4482758620689653,47.06
12437,4608,295,0,2059,169,126,1.2987012987012987,0.0
12438,4656,30,4560,1074,25,5,8.333333333333334,56.35
12439,4243632,798,0,136763,403,395,1.5873015873015872,0.0
12440,0,0,0,0,0,0,100.0,0.0
12441,81096,109,0,1991,75,34,1.851851851851852,0.0
12442,10092,58,0,1990,47,11,100.0,0.0
12443,7128,23,7128,840,20,3,8.333333333333334,69.67
12444,1743660,256,0,31471,127,129,2.631578947368421,0.0
12445,4250724,81,0,107349,70,11,50.0,0.0
12446,636,20,636,117,12,8,6.25,49.46
12447,27984,25,27984,1140,22,3,6.666666666666667,48.94
12448,36000,67,0,7275,57,10,100.0,0.0
12449,38988,102,38988,1046,86,16,1.25,18.66
12450,8340,27,8340,1088,24,3,5.555555555555555,55.12
12451,5208120,3552,0,154008,1969,1583,1.0,1.5
12452,3084,246,0,834,186,60,100.0,0.0
12453,2765676,183,40752,17338,136,47,1.0,10.58
12454,4536,26,4536,612,23,3,8.333333333333334,47.24
12455,50136,14,50136,5694,8,6,33.333333333333336,99.76
12456,132,5,60,50,4,1,25.0,75.29
12457,13764,41,0,2378,33,8,100.0,0.0
12458,8520,25,2856,1775,18,7,7.6923076923076925,83.01
12459,63312,101,63312,2379,83,18,1.2987012987012987,26.5
12460,95184,2,95184,156,2,0,25.0,75.8
12461,5028,22,5028,811,18,4,8.333333333333334,71.23
12462,64440,1,64440,0,1,0,33.333333333333336,0.0
12463,8820,20,8820,816,18,2,9.090909090909092,89.02
12464,4416,13,4416,809,13,0,8.333333333333334,80.9
12465,13860,32,13860,1203,24,8,8.333333333333334,85.78
12466,3108,20,3108,532,17,3,8.333333333333334,75.78
12467,1187904,575,0,7876,381,194,1.0,0.0
12468,77904,25,77904,22264,16,9,12.5,53.18
12469,30528,32,30528,1283,29,3,7.6923076923076925,68.75
12470,4273512,2952,412896,244845,1530,1422,1.0,0.0
12471,684,35,684,418,21,14,11.11111111111111,84.37
12472,360,40,360,0,40,0,2.380952380952381,48.56
12473,4023408,43,0,474450,26,17,10.0,0.95
12474,4728,40,4728,1286,35,5,5.882352941176471,75.31
12475,216,49,216,5,49,0,1.96078431372549,40.73
12476,31608,46,0,2365,28,18,100.0,0.0
12477,396,1,396,192,1,0,25.0,70.55
12478,39156,53,39156,1906,47,6,2.1739130434782608,42.12
12479,33084,8,33084,901,7,1,16.666666666666668,6.19
12480,19404,143,0,3064,97,46,1.9230769230769231,0.0
12481,3036,55,3036,1777,54,1,1.851851851851852,9.03
12482,2508,43,2508,2074,21,22,9.090909090909092,98.09
12483,204,10,204,12,10,0,8.333333333333334,17.13
12484,95376,633,0,7457,373,260,50.0,0.0
12485,17580,195,0,3204,131,64,1.36986301369863,0.0
12486,492,69,492,45,63,6,1.6129032258064515,44.09
12487,6864,6,6864,1766,6,0,14.285714285714286,23.61
12488,24168,388,0,4773,224,164,1.0,0.0
12489,156,2,156,0,2,0,25.0,64.5
12490,4992,31,4992,1089,25,6,8.333333333333334,66.12
12491,34752,15,34752,911,14,1,10.0,64.18
12492,19584,28,9792,2554,25,3,5.555555555555555,67.22
12493,12624,23,12624,1478,18,5,9.090909090909092,95.35
12494,348,38,0,121,25,13,50.0,0.0
12495,32268,47,0,1608,32,15,100.0,0.0
12496,169308,44,169308,14626,38,6,2.702702702702702,13.33
12497,158868,23,0,24829,21,2,100.0,0.0
12498,1524,45,1524,26,45,0,2.127659574468085,53.22
12499,2864508,481,0,18092,240,241,1.5384615384615383,0.0
12500,672,8,0,318,6,2,50.0,0.0
12501,876,7,876,330,6,1,16.666666666666668,98.24
12502,7248,27,7248,1053,22,5,7.142857142857143,68.76
12503,32796,27,4008,2049,22,5,8.333333333333334,93.71
12504,6708,12,6708,919,12,0,8.333333333333334,59.95
12505,5334348,14384,1381992,775494,8129,6255,1.0,1.79
12506,270384,92,270384,25724,66,26,1.818181818181818,9.13
12507,106752,43,106752,21788,39,4,3.703703703703704,2.5
12508,672,8,528,405,6,2,14.285714285714286,52.96
12509,3090444,56,0,112430,46,10,33.333333333333336,0.0
12510,14304,36,14304,1987,32,4,4.545454545454546,75.58
12511,612,0,612,0,0,0,50.0,37.21
12512,7968,349,0,2679,219,130,1.0,0.0
12513,76140,53,76140,7157,45,8,2.272727272727273,28.84
12514,29796,66,0,3176,56,10,100.0,0.0
12515,4303296,147,0,62476,78,69,5.0,0.0
12516,87288,50,87288,11730,36,14,3.225806451612903,15.04
12517,12936,179,0,2225,110,69,1.5384615384615383,0.0
12518,5964,27,5964,1332,24,3,6.666666666666667,63.65
12519,492,12,0,181,9,3,50.0,0.0
12520,564,39,564,269,15,24,33.333333333333336,63.93
12521,17400,46,0,1550,30,16,100.0,0.0
12522,1612992,18,1612992,98682,18,0,50.0,99.77
12523,148560,1,148560,145488,1,0,50.0,97.18
12524,25200,32,0,3297,28,4,100.0,0.0
12525,97872,68,0,5735,58,10,100.0,0.0
12526,1560,6,1560,1342,2,4,50.0,18.03
12527,73800,93,0,9564,65,28,100.0,0.0
12528,18804,288,0,3464,174,114,1.0,0.0
12529,4988556,291,0,27133,152,139,2.5,0.0
12530,9420,13,9420,1017,11,2,10.0,0.0
12531,24612,24,24612,370,21,3,5.882352941176471,77.9
12532,144,12,132,44,7,5,20.0,67.84
12533,10692,19,10692,726,16,3,9.090909090909092,43.29
12534,1740,23,1740,835,20,3,5.555555555555555,46.43
12535,972,31,972,605,27,4,5.2631578947368425,88.17
12536,61836,346,0,4270,212,134,100.0,0.0
12537,61320,94,0,4298,80,14,100.0,0.0
12538,4315764,29,12300,763541,19,10,9.090909090909092,94.15
12539,16776,18,16776,471,15,3,8.333333333333334,49.63
12540,134760,440,134760,3936,282,158,1.0,0.0
12541,5136,29,0,1823,24,5,100.0,0.0
12542,468,3,0,216,2,1,100.0,0.0
12543,2688,12,2688,591,11,1,11.11111111111111,82.84
12544,5240748,2469,23940,94069,1411,1058,1.0,3.83
12545,23928,57,23928,1993,51,6,2.083333333333333,29.76
12546,28392,26,28392,587,23,3,5.2631578947368425,79.46
12547,108,0,108,0,0,0,50.0,75.0
12548,126636,287,0,25689,211,76,50.0,0.0
12549,222912,52,222912,28465,48,4,2.380952380952381,23.54
12550,14820,16,14820,1018,14,2,11.11111111111111,73.22
12551,9516,28,9516,931,24,4,6.666666666666667,65.16
12552,12840,44,12840,1614,38,6,4.761904761904762,65.77
12553,58920,19,58920,2189,18,1,8.333333333333334,63.82
12554,91032,303,91032,90792,159,144,1.0,47.16
12555,5268084,79,0,708702,67,12,33.333333333333336,0.0
12556,898884,185,0,51187,135,50,20.0,0.0
12557,5856,25,5856,1435,21,4,6.25,94.12
12558,16080,52,0,7403,43,9,100.0,0.0
12559,227352,62,193464,10930,51,11,2.631578947368421,21.69
12560,327900,20,4812,33136,16,4,7.6923076923076925,84.56
12561,17160,59,0,1238,42,17,100.0,0.0
12562,1692,23,1692,619,21,2,11.11111111111111,31.28
12563,805212,23,6972,35359,21,2,5.882352941176471,82.96
12564,696,1,696,84,1,0,25.0,20.05
12565,7200,17,7200,633,13,4,11.11111111111111,89.28
12566,3585552,872,1540008,42309,459,413,2.0408163265306123,0.0
12567,1305696,49,300,157276,46,3,2.127659574468085,59.3
12568,3642708,66,0,168425,57,9,25.0,0.0
12569,1655976,19,0,105590,16,3,6.25,0.0
12570,3424992,159,0,82262,80,79,4.761904761904762,0.0
12571,1464,10,1464,561,8,2,14.285714285714286,9.26
12572,10296,55,0,2800,45,10,100.0,0.0
12573,2281752,24,12264,96043,20,4,9.090909090909092,74.64
12574,69540,102,69540,27978,88,14,1.3888888888888888,47.24
12575,780,15,780,150,12,3,7.6923076923076925,47.82
12576,379476,25,13248,16559,22,3,5.0,77.79
12577,600792,185,253780,54761,148,37,1.3157894736842106,20.65
12578,14076,80,0,2496,68,12,100.0,0.0
12579,5242932,3406,0,872498,1547,1859,1.3157894736842106,0.0
12580,12960,38,12960,1361,31,7,6.25,59.89
12581,19980,51,0,2178,42,9,100.0,0.0
12582,2880,20,2880,276,18,2,6.25,82.35
12583,3863220,1151,1183752,549213,297,854,1.0,51.19
12584,936096,23,8424,41228,22,1,5.555555555555555,79.83
12585,2868,183,2868,1607,126,57,1.639344262295082,17.11
12586,10308,25,10308,381,22,3,5.2631578947368425,83.05
12587,18924,17,18924,741,15,2,8.333333333333334,70.19
12588,408,41,408,0,41,0,2.3255813953488373,47.76
12589,3156,22,3156,327,20,2,5.555555555555555,82.46
12590,216,46,216,5,46,0,2.083333333333333,47.93
12591,13452,73,0,2739,60,13,100.0,0.0
12592,19692,64,19692,2070,58,6,1.818181818181818,30.47
12593,5832,25,5832,620,22,3,5.2631578947368425,82.94
12594,546828,747,386940,159385,747,0,1.0,73.07
12595,2708484,61,0,46911,52,9,50.0,0.0
12596,64356,28,6096,2838,24,4,5.0,79.3
12597,5844,23,5844,402,21,2,5.555555555555555,82.32
12598,5113440,1018,0,323267,596,422,1.0,0.0
12599,1676472,104,0,102643,44,60,7.142857142857143,0.0
12600,8928,15,8928,501,13,2,9.090909090909092,39.9
12601,4236,21,4236,322,19,2,5.882352941176471,82.68
12602,5133672,41,0,814878,37,4,50.0,0.0
12603,948,11,948,462,8,3,20.0,0.0
12604,5365812,3468,0,494212,1947,1521,1.0,0.0
12605,38088,49,0,2278,32,17,100.0,0.0
12606,15624,51,0,2126,41,10,100.0,0.0
12607,11040,75,0,2693,61,14,100.0,0.0
12608,30804,23,30804,617,19,4,7.142857142857143,27.1
12609,324,8,276,112,4,4,33.333333333333336,56.7
12610,26028,24,26028,2482,22,2,8.333333333333334,56.49
12611,1555752,67,0,79877,58,9,50.0,0.0
12612,468,0,468,0,0,0,50.0,37.21
12613,2506428,78,1572,32736,45,33,3.703703703703704,82.1
12614,30504,65,0,1511,48,17,100.0,0.0
12615,5382324,9260,168916,727150,5345,3915,1.0,0.0
12616,1032,27,1032,900,25,2,3.8461538461538463,55.16
12617,23052,34,23052,1333,28,6,7.142857142857143,99.65
12618,10212,31,0,2448,27,4,100.0,0.0
12619,1980,17,1980,372,13,4,7.6923076923076925,89.81
12620,392124,14,196482,51234,14,0,8.333333333333334,45.72
12621,413892,3,168,413892,2,1,100.0,100.0
12622,720,4,720,354,1,3,50.0,50.0
12623,5040,23,5040,1157,20,3,6.666666666666667,73.11
12624,3408684,1305,0,36632,767,538,1.0,0.0
12625,5365044,265,0,1701062,229,36,1.0,2.87
12626,32712,27,32712,1325,24,3,6.25,65.53
12627,732,65,732,199,39,26,4.3478260869565215,6.86
12628,4983516,62,0,243045,53,9,33.333333333333336,0.0
12629,84276,34,37332,12187,28,6,5.882352941176471,94.37
12630,12360,15,12360,956,13,2,9.090909090909092,53.54
12631,2100,10,2100,1867,8,2,11.11111111111111,93.6
12632,130008,19,114222,4743,15,4,8.333333333333334,53.83
12633,816,11,816,349,9,2,11.11111111111111,71.8
12634,1385136,4,852,346293,4,0,25.0,99.97
12635,4049664,40,2352,219658,31,9,7.6923076923076925,95.09
12636,71244,0,71244,0,0,0,100.0,100.0
12637,20256,110,20256,1299,71,39,1.7241379310344829,64.08
12638,3012,27,3012,527,22,5,7.142857142857143,49.32
12639,72936,195,72936,11816,153,42,1.0526315789473684,6.04
12640,104604,114,104604,1746,84,30,1.5384615384615383,55.92
12641,4791924,24,2328,201814,18,6,10.0,95.05
12642,905004,48,5820,99136,38,10,6.25,45.93
12643,5056704,569,0,75535,240,329,2.1739130434782608,0.0
12644,62748,40,62748,11860,34,6,4.0,2.84
12645,4106580,76,0,126696,45,31,9.090909090909092,10.0
12646,37500,251,0,7503,137,114,1.2820512820512822,0.0
12647,152448,45,152448,6211,37,8,3.8461538461538463,9.34
12648,5110500,603,0,174390,264,339,2.0,0.0
12649,4308,23,4308,937,18,5,9.090909090909092,73.42
12650,1332,18,1332,645,13,5,10.0,72.26
12651,5225052,1725,0,321449,960,765,1.0,0.0
12652,3468,28,3468,606,24,4,7.142857142857143,77.9
12653,216,0,216,0,0,0,2.857142857142857,69.32
12654,480,0,480,0,0,0,50.0,56.25
12655,174564,57,288,6146,51,6,2.0,59.39
12656,3852,2,0,3348,1,1,33.333333333333336,0.0
12657,5371176,2162,1738368,1871021,1227,935,1.0,0.0
12658,5396640,4969,0,576234,2723,2246,1.0,0.0
12659,420,37,420,66,31,6,3.333333333333333,45.2
12660,6768,27,6768,850,20,7,12.5,64.84
12661,56160,18,56160,3110,18,0,5.882352941176471,4.71
12662,5406120,2334,0,3095977,1359,975,1.0,3.0
12663,468,53,468,175,24,29,9.090909090909092,68.65
12664,667512,1,667512,172920,1,0,33.333333333333336,48.03
12665,420,44,0,129,29,15,100.0,0.0
12666,5406696,3998,0,2898255,2338,1660,1.0,0.0
12667,3239112,88,0,174743,36,52,5.882352941176471,5.0
12668,1476,61,1368,1200,54,7,2.9411764705882355,35.97
12669,77952,0,77952,0,0,0,50.0,82.0
12670,972,6,972,40,6,0,14.285714285714286,94.2
12671,660,53,660,15,51,2,1.9230769230769231,52.08
12672,792,7,792,111,6,1,14.285714285714286,56.56
12673,14880,36,7416,1935,29,7,5.882352941176471,73.46
12674,336,27,336,3,27,0,3.4482758620689653,52.85
12675,3684,48,3684,3512,48,0,2.0,33.12
12676,3194652,1073,0,46539,608,465,1.0,3.98
12677,420,56,420,24,50,6,2.0408163265306123,41.68
12678,19644,37,0,3985,33,4,100.0,0.0
12679,9300,13,9300,1116,13,0,10.0,90.69
12680,1243692,153,798390,153413,133,20,1.0416666666666667,0.33
12681,7788,19,7788,761,16,3,7.142857142857143,84.75
12682,432,71,360,34,69,2,1.7543859649122806,57.15
12683,550272,5,550272,461359,5,0,20.0,98.84
12684,5413488,9495,1452243,824207,5423,4072,1.0,0.0
12685,2348928,51,696,51173,34,17,4.545454545454546,45.0
12686,57216,4,57216,477,4,0,20.0,98.21
12687,2472,200,0,596,161,39,100.0,0.0
12688,54396,26,54396,840,20,6,8.333333333333334,68.25
12689,10944,23,10944,1041,21,2,6.666666666666667,73.33
12690,4309416,151,0,282658,89,62,3.225806451612903,0.0
12691,851988,8,851988,108,7,1,14.285714285714286,83.92
12692,5373708,2719,839064,186311,1366,1353,1.0,0.0
12693,45576,56,45576,2797,51,5,2.0,20.6
12694,316308,0,316308,0,0,0,100.0,100.0
12695,5712,17,5712,902,13,4,11.11111111111111,17.05
12696,5353548,3695,0,140508,1979,1716,1.0,0.0
12697,5145864,1330,0,786699,819,511,1.4285714285714286,0.0
12698,4449180,45,0,369906,18,27,16.666666666666668,0.0
12699,22116,168,0,3608,118,50,1.3157894736842106,0.0
12700,2842416,17,16020,168825,14,3,9.090909090909092,8.55
12701,5087712,1639,0,70896,874,765,1.0,0.0
12702,503316,25,285366,14062,24,1,4.761904761904762,23.86
12703,4242816,279,0,177859,134,145,1.7857142857142858,0.0
12704,24888,215,0,2715,141,74,1.0638297872340423,0.0
12705,2532,13,252,300,9,4,16.666666666666668,51.36
12706,5150580,481,0,164317,235,246,2.2222222222222223,0.0
12707,69504,43,0,9254,25,18,100.0,0.0
12708,5115396,17,63756,313358,11,6,11.11111111111111,0.74
12709,24996,20,19608,7738,20,0,4.761904761904762,29.71
12710,12408,23,12408,963,19,4,7.6923076923076925,79.08
12711,45660,12,45660,655,11,1,11.11111111111111,54.44
12712,1968180,72,0,57350,60,12,50.0,0.0
12713,332148,11,0,63888,9,2,100.0,0.0
12714,6108,38,6108,997,30,8,4.545454545454546,55.26
12715,69696,3,65400,37356,1,2,50.0,0.0
12716,0,0,0,0,0,0,100.0,0.0
12717,5928,218,5928,158,208,10,1.0,3.09
12718,5065104,4371,1125630,396958,2317,2054,1.0,0.0
12719,1908,331,1620,1124,206,125,1.0,8.61
12720,7884,23,7884,1189,23,0,4.761904761904762,56.84
12721,21096,3,5364,7828,3,0,33.333333333333336,99.28
12722,8652,342,0,3462,214,128,1.0,0.0
12723,5028120,3957,944148,205314,2233,1724,1.0,0.0
12724,81492,194,0,3884,123,71,100.0,0.0
12725,4958112,201,0,57948,102,99,5.0,0.0
12726,10752,93,10752,3082,88,5,1.408450704225352,59.46
12727,1296,4,1296,420,4,0,16.666666666666668,19.6
12728,4337292,4032,0,106451,1947,2085,1.0,0.0
12729,7368,14,7368,568,13,1,11.11111111111111,71.24
12730,4863948,124,3830508,1360530,62,62,100.0,0.0
12731,732,9,684,624,7,2,14.285714285714286,92.72
12732,928932,7,928932,7011,7,0,12.5,97.24
12733,40632,23,40632,1048,19,4,7.142857142857143,72.83
12734,235104,4,235104,41652,2,2,100.0,0.0
12735,252984,82,252984,1953,66,16,1.639344262295082,10.11
12736,16800,28,16800,1292,23,5,6.666666666666667,70.68
12737,181980,0,181980,0,0,0,50.0,61.73
12738,780,77,720,256,47,30,2.857142857142857,4.58
12739,417900,702,122166,49010,527,175,1.0,31.89
12740,24696,30,24696,1186,24,6,6.25,77.53
12741,149616,99,0,16716,52,47,100.0,0.0
12742,13704,23,13704,1486,20,3,7.6923076923076925,80.47
12743,8988,31,7992,3240,31,0,5.555555555555555,1.24
12744,13632,44,0,2440,42,2,100.0,0.0
12745,4687968,99,19188,711219,66,33,3.703703703703704,57.95
12746,175452,33,175452,136668,30,3,3.703703703703704,81.25
12747,9240,387,0,3704,245,142,1.0,0.0
12748,672,7,0,341,4,3,100.0,0.0
12749,14700,46,14700,3684,36,10,4.3478260869565215,34.88
12750,1248,8,180,277,5,3,25.0,56.61
12751,564,5,0,165,4,1,50.0,0.0
12752,1420404,38,0,40215,32,6,33.333333333333336,0.0
12753,1696884,766,0,25636,416,350,1.7857142857142858,0.0
12754,39348,130,0,2709,80,50,1.8867924528301887,0.0
12755,3796020,13,0,406462,6,7,20.0,0.0
12756,101856,45,101856,1988,38,7,2.857142857142857,29.47
12757,8904,23,8904,1049,19,4,6.666666666666667,92.41
12758,48,1,48,0,1,0,50.0,59.04
12759,300,6,300,144,6,0,14.285714285714286,53.87
12760,3672,92,1092,747,83,9,1.2987012987012987,33.74
12761,32172,360,0,3039,214,146,1.0,0.0
12762,231384,43,231384,21525,39,4,2.857142857142857,23.65
12763,5264100,338,0,1573346,189,149,1.0,0.0
12764,98160,299,0,2975,187,112,100.0,0.0
12765,7740,24,7740,1296,22,2,5.882352941176471,94.35
12766,3043860,77,0,83941,66,11,20.0,0.0
12767,90564,1,90564,912,1,0,50.0,99.51
12768,5244,370,0,2307,226,144,1.0,0.0
12769,265068,839,264312,96680,802,37,100.0,99.99
12770,1229424,124,0,105738,99,25,50.0,0.0
12771,7320,20,7320,1267,14,6,7.142857142857143,35.89
12772,12984,23,12984,1253,19,4,9.090909090909092,87.01
12773,612,17,612,201,13,4,7.6923076923076925,67.94
12774,0,0,0,0,0,0,50.0,99.84
12775,220032,16,220032,173243,16,0,25.0,99.95
12776,5378592,143,0,4180332,143,0,1.0416666666666667,1.3
12777,7020,21,7020,466,21,0,4.761904761904762,79.84
12778,1734480,49,1096374,48454,31,18,14.285714285714286,97.68
12779,362916,21,510,53435,15,6,11.11111111111111,0.0
12780,6720,43,0,1612,35,8,100.0,0.0
12781,427080,50,0,26988,41,9,50.0,0.0
12782,4764,23,4764,330,20,3,6.25,74.37
12783,2676,16,2676,599,14,2,6.666666666666667,61.34
12784,4426512,27,9780,164576,24,3,4.761904761904762,76.87
12785,5446404,15632,1842888,1260372,7988,7644,1.0,0.0
12786,345840,81,0,6079,71,10,50.0,0.0
12787,23868,194,0,3946,124,70,1.5384615384615383,0.0
12788,4152,5,4152,292,5,0,12.5,2.91
12789,1093560,2,1089708,1093560,1,1,50.0,90.0
12790,4776,22,4776,397,21,1,5.2631578947368425,70.57
12791,23676,0,23676,0,0,0,100.0,100.0
12792,29076,60,29076,3789,51,9,2.0,17.9
12793,3468,24,3468,357,21,3,5.882352941176471,78.52
12794,780,4,780,189,4,0,20.0,0.0
12795,9708,28,6456,809,23,5,5.555555555555555,74.17
12796,1752,4,1752,285,4,0,14.285714285714286,0.0
12797,2365080,66,0,66300,55,11,33.333333333333336,0.0
12798,27684,26,27684,2484,22,4,6.666666666666667,69.26
12799,5220528,35,35064,151340,22,13,10.0,0.0
12800,2700,5,2598,201,4,1,25.0,99.26
12801,5096580,24,3648,214882,21,3,5.555555555555555,78.89
12802,26280,44,0,2147,38,6,50.0,0.0
12803,66624,51,0,4532,43,8,50.0,0.0
12804,8172,31,0,1291,16,15,7.6923076923076925,1.5
12805,1527024,7,1527024,1308653,4,3,100.0,100.0
12806,0,0,0,0,0,0,100.0,100.0
12807,16236,25,0,2749,17,8,100.0,0.0
12808,201684,22,117984,5675,17,5,7.6923076923076925,59.63
12809,1530960,3,1530960,1530900,2,1,100.0,100.0
12810,0,0,0,0,0,0,100.0,100.0
12811,0,0,0,0,0,0,100.0,100.0
12812,9492,29,9492,874,26,3,9.090909090909092,71.52
12813,204036,23,181878,10826,18,5,6.666666666666667,48.07
12814,21420,25,21420,790,19,6,9.090909090909092,83.77
12815,1025940,50,267028,112689,43,7,3.125,27.36
12816,708768,157,0,19851,65,92,5.882352941176471,0.0
12817,33204,30,33204,1731,27,3,6.666666666666667,74.36
12818,5186700,1476,0,278752,829,647,1.36986301369863,0.0
12819,93924,20,93924,5700,19,1,7.6923076923076925,52.9
12820,85548,84,71556,47235,74,10,100.0,0.0
12821,24216,10,24216,2706,7,3,3.333333333333333,0.0
12822,7872,22,3660,1864,18,4,7.6923076923076925,79.86
12823,74772,180,74772,2333,129,51,1.0,41.74
12824,636,17,0,114,10,7,50.0,0.0
12825,38892,24,38892,2920,20,4,6.25,91.85
12826,10056,33,10056,791,26,7,7.142857142857143,80.04
12827,5676,21,312,408,12,9,16.666666666666668,62.27
12828,33708,6,33708,1388,4,2,20.0,78.16
12829,3748176,599,0,1115662,408,191,1.3888888888888888,0.0
12830,55224,3,41112,26708,3,0,25.0,48.57
12831,2172,11,2172,1905,11,0,8.333333333333334,69.96
12832,23628,21,3816,2165,18,3,7.6923076923076925,94.11
12833,17004,29,17004,3166,25,4,5.882352941176471,65.14
12834,29184,19,29184,653,14,5,9.090909090909092,0.0
12835,7368,25,7368,582,20,5,8.333333333333334,78.48
12836,2436,67,2436,1296,24,43,12.5,97.54
12837,42588,38,42588,2592,33,5,5.2631578947368425,91.13
12838,6588,37,6588,1212,30,7,6.666666666666667,81.59
12839,15876,16,15876,459,14,2,5.882352941176471,0.78
12840,576,56,576,170,52,4,3.225806451612903,66.59
12841,948,126,948,414,70,56,2.380952380952381,59.92
12842,1128,2,1128,420,2,0,25.0,97.7
12843,1164,62,0,285,55,7,100.0,0.0
12844,216,0,216,0,0,0,100.0,100.0
12845,6480,90,1752,318,82,8,1.7241379310344829,55.85
12846,4583940,826,857640,296543,417,409,1.0,0.29
12847,5491044,3154,914520,566910,1636,1518,1.0,4.9
12848,2959176,509,916368,83446,294,215,2.1739130434782608,0.0
12849,768,0,768,0,0,0,100.0,100.0
12850,2124,14,2124,276,13,1,7.6923076923076925,77.91
12851,59952,1,59952,6600,1,0,50.0,99.39
12852,372,0,372,0,0,0,100.0,100.0
12853,59976,7,59976,200,7,0,12.5,52.59
12854,5207940,4313,919992,175502,2415,1898,1.0,0.15
12855,2424,30,2424,900,18,12,7.6923076923076925,94.75
12856,1296,163,0,229,126,37,100.0,0.0
12857,77004,27,68946,2361,26,1,4.3478260869565215,33.01
12858,5453352,8812,2057898,807859,5214,3598,1.0,0.0
12859,4200,51,4200,4075,51,0,2.0,36.12
12860,5240460,207,5240460,716,116,91,1.098901098901099,43.1
12861,68628,26,68628,5292,26,0,4.0,64.68
12862,3444372,162,0,235362,57,105,3.4482758620689653,0.72
12863,4481640,1891,0,86727,1024,867,1.0,0.0
12864,2724876,1724,0,150997,852,872,1.0,0.0
12865,3264,0,3264,0,0,0,100.0,100.0
12866,12660,11,12660,7437,11,0,8.333333333333334,72.27
12867,87972,11,87972,20710,11,0,8.333333333333334,73.74
12868,81792,2,81792,40464,2,0,14.285714285714286,53.0
12869,270444,126,270444,80066,108,18,1.0,51.85
12870,106044,35,106044,37790,33,2,2.9411764705882355,27.69
12871,4213236,177,0,391527,43,134,1.0,0.0
12872,5510184,6039,0,670827,3459,2580,1.0,0.0
12873,73272,0,73272,0,0,0,100.0,98.01
12874,73728,83,0,7198,60,23,100.0,0.0
12875,188448,21,124992,19428,21,0,5.0,92.9
12876,2335668,8,2335668,349843,8,0,5.882352941176471,9.11
12877,876,76,876,296,72,4,2.1739130434782608,23.49
12878,62748,378,0,7048,238,140,100.0,0.0
12879,348,19,348,135,15,4,6.666666666666667,41.87
12880,5480220,9014,96084,325779,5040,3974,1.0,0.0
12881,18792,18,18792,1946,13,5,12.5,83.82
12882,852,20,228,255,13,7,11.11111111111111,98.06
12883,2208,1,0,2208,0,1,100.0,0.0
12884,1236,33,1236,1165,29,4,3.571428571428572,78.07
12885,1524,2,1524,126,1,1,50.0,66.73
12886,74628,55,74628,3288,43,12,2.5641025641025643,32.43
12887,10284,26,10284,695,24,2,5.0,74.64
12888,32748,20,32748,1233,17,3,7.6923076923076925,80.55
12889,87984,16,87984,4929,14,2,9.090909090909092,74.81
12890,32616,25,32616,1050,21,4,7.142857142857143,75.49
12891,5326368,27,0,425700,24,3,5.555555555555555,0.0
12892,860496,14,860496,16934,14,0,7.142857142857143,96.55
12893,102540,4,102540,6747,4,0,20.0,95.13
12894,462192,7,85500,103280,6,1,16.666666666666668,82.7
12895,8112,21,8112,421,20,1,5.0,74.5
12896,237768,64,237768,63844,57,7,2.0408163265306123,19.46
12897,2736,17,2736,664,16,1,7.6923076923076925,52.75
12898,4836,84,4836,1316,42,42,4.166666666666667,68.49
12899,5507628,1476,0,3791490,779,697,2.631578947368421,54.27
12900,3744,3,3744,376,3,0,25.0,98.69
12901,47820,317,0,2980,184,133,100.0,0.0
12902,11616,24,0,4437,22,2,100.0,0.0
12903,105000,55,0,9336,50,5,33.333333333333336,0.0
12904,4356,398,0,1522,258,140,1.0,0.0
12905,654480,28,7272,26748,24,4,5.2631578947368425,74.31
12906,39708,36,39708,2947,33,3,7.6923076923076925,59.98
12907,6828,27,6828,1460,24,3,6.666666666666667,75.92
12908,4332,25,4332,1248,20,5,7.142857142857143,57.99
12909,36096,240,0,3487,154,86,1.0,0.0
12910,500976,799,172851,48414,590,209,1.0,33.24
12911,4198668,20,3516,210390,19,1,5.555555555555555,73.81
12912,39324,31,39324,18359,31,0,4.0,28.24
12913,41904,26,41904,3582,21,5,7.142857142857143,94.63
12914,82392,5,82392,3038,5,0,20.0,98.36
12915,11088,25,11088,441,23,2,5.0,76.53
12916,2034948,31,0,128524,28,3,50.0,0.0
12917,5892,115,5892,607,106,9,1.2048192771084338,15.87
12918,40224,36,40224,2072,29,7,7.142857142857143,77.0
12919,11856,413,0,4332,251,162,1.0,0.0
12920,3072,21,3072,406,19,2,5.882352941176471,80.38
12921,1092372,42,232482,79316,31,11,4.166666666666667,29.33
12922,38208,29,38208,25327,26,3,4.545454545454546,69.25
12923,22824,3,0,7828,1,2,33.333333333333336,0.0
12924,3636,83,0,1108,49,34,2.9411764705882355,0.0
12925,12996,24,12996,485,22,2,5.2631578947368425,71.39
12926,348504,47,0,30907,37,10,100.0,0.0
12927,4632,22,4632,401,20,2,5.555555555555555,76.25
12928,3926748,74,0,152240,58,16,33.333333333333336,0.0
12929,5370600,99,0,385166,87,12,25.0,0.0
12930,4188,24,4188,414,22,2,5.2631578947368425,77.33
12931,15120,16,15120,1309,14,2,11.11111111111111,56.07
12932,11016,108,11016,3387,58,50,100.0,100.0
12933,0,0,0,0,0,0,50.0,99.75
12934,2136,23,2136,367,20,3,6.25,76.76
12935,626460,82,626460,84363,78,4,1.7543859649122806,14.84
12936,13812,21,13812,1049,17,4,9.090909090909092,74.28
12937,96240,50,96240,13761,42,8,2.857142857142857,2.28
12938,5454720,1015,0,68666,518,497,1.162790697674419,0.0
12939,24504,6,24504,13586,2,4,25.0,87.75
12940,299316,9,0,39553,6,3,25.0,5.0
12941,5505624,54620,1046952,783655,39205,15415,1.0,3.42
12942,3792,12,3792,646,11,1,12.5,59.36
12943,84840,63,84840,3732,56,7,1.8867924528301887,19.8
12944,3974616,56,7356,497638,45,11,5.2631578947368425,76.31
12945,5189424,134,0,85091,99,35,33.333333333333336,0.0
12946,2740008,75,0,224942,60,15,33.333333333333336,0.0
12947,2059596,79,0,27908,68,11,100.0,0.0
12948,4884,23,4884,362,20,3,5.882352941176471,79.67
12949,7416,20,7416,412,19,1,5.555555555555555,75.29
12950,26184,43,26184,4311,23,20,50.0,96.58
12951,69300,18,69300,896,16,2,9.090909090909092,52.57
12952,408,2,408,138,2,0,25.0,58.1
12953,24960,32,0,6429,30,2,100.0,0.0
12954,282168,41,0,8716,35,6,50.0,0.0
12955,5207532,314,0,336485,110,204,2.380952380952381,0.0
12956,3576,13,3576,626,12,1,12.5,73.68
12957,20508,235,0,2717,141,94,1.1494252873563218,0.0
12958,14616,81,0,3332,66,15,100.0,0.0
12959,6876,74,0,1959,66,8,100.0,0.0
12960,696,6,0,292,5,1,100.0,0.0
12961,258732,65,258732,21988,60,5,1.8867924528301887,14.32
12962,4159308,697,0,55893,385,312,1.5873015873015872,0.0
12963,2219976,34,0,755385,28,6,50.0,0.0
12964,29304,19,29304,863,16,3,9.090909090909092,77.02
12965,41976,351,0,3772,203,148,100.0,0.0
12966,26568,24,26568,2143,20,4,6.25,74.54
12967,12552,258,0,1792,166,92,1.25,0.0
12968,46980,36,26184,2611,28,8,6.25,79.55
12969,10668,131,0,1219,87,44,1.6129032258064515,0.0
12970,269424,50,0,20302,21,29,12.5,0.0
12971,29544,26,29544,1857,22,4,7.6923076923076925,82.28
12972,1908,243,1908,1360,109,134,2.7777777777777777,74.62
12973,3516,31,3516,1095,27,4,7.142857142857143,74.34
12974,276,9,276,109,9,0,9.090909090909092,64.13
12975,3252,29,3252,702,24,5,7.142857142857143,86.42
12976,240312,425,240312,5477,208,217,1.1235955056179776,36.3
12977,2028,66,2028,1600,54,12,2.0,43.02
12978,7572,46,7572,1960,40,6,4.3478260869565215,71.97
12979,217236,62,217236,9844,57,5,2.0,13.58
12980,720,119,720,167,79,40,2.0,4.46
12981,1490880,196,0,456680,173,23,100.0,0.0
12982,34212,22,34212,10020,20,2,5.2631578947368425,92.55
12983,6336,30,6336,1105,27,3,5.882352941176471,68.03
12984,840,76,540,240,64,12,1.851851851851852,49.25
12985,3277020,1113,0,48135,672,441,1.0,0.0
12986,42732,64,0,2619,52,12,100.0,0.0
12987,1656,228,1656,1168,146,82,1.1494252873563218,44.49
12988,5572140,17698,1339608,1347717,10089,7609,1.0,0.0
12989,3794388,912,0,23119,488,424,1.0526315789473684,0.0
12990,85860,134,85860,3467,96,38,1.3333333333333333,53.44
12991,88296,39,4788,6460,32,7,5.0,86.3
12992,2470836,329,0,17051,197,132,1.0,0.0
12993,46620,67,46620,1619,60,7,1.818181818181818,27.04
12994,38820,2,38820,35802,2,0,25.0,78.41
12995,23400,59,0,2666,51,8,100.0,0.0
12996,31644,47,31644,2721,38,9,5.2631578947368425,62.16
12997,600,57,600,285,37,20,4.0,56.71
12998,57708,177,57708,7355,141,36,1.1111111111111112,11.0
12999,216,41,216,107,31,10,3.225806451612903,3.56
13000,184692,3,184692,372,3,0,25.0,68.87
13001,5439468,7505,1734204,280998,3120,4385,1.0,0.0
13002,132,1,132,108,1,0,50.0,99.67
13003,22140,37,0,5417,32,5,50.0,0.0
13004,60,0,60,0,0,0,100.0,100.0
13005,5576856,18469,1518576,1397449,8839,9630,1.0,1.25
13006,3360,212,0,989,161,51,100.0,0.0
13007,96,32,96,21,30,2,3.125,27.03
13008,4038396,456,0,25766,245,211,2.0,0.0
13009,5469300,809,1263012,52159,457,352,1.0,0.0
13010,2677428,137,2677428,40358,71,66,3.0303030303030303,76.3
13011,3090816,4,3090816,57,2,2,25.0,0.0
13012,142236,107,0,9432,80,27,100.0,0.0
13013,5295612,1367,0,151680,674,693,1.0,0.0
13014,1704,193,1704,196,183,10,1.0,24.65
13015,5331756,4360,431892,133778,2344,2016,1.0,0.0
13016,264936,25,3444,11552,25,0,4.0,20.63
13017,468,55,468,22,53,2,1.9230769230769231,52.02
13018,5578272,4780,396384,535399,2695,2085,1.0,1.33
13019,516,7,360,308,5,2,25.0,0.0
13020,5161752,1495,1268688,31190,808,687,1.0,0.0
13021,5589828,1734,2478828,68175,861,873,1.0,0.0
13022,918132,53,918132,11130,28,25,25.0,0.0
13023,136632,3,49356,53788,3,0,50.0,95.85
13024,40176,19,40176,1040,17,2,10.0,69.34
13025,321924,26,321924,30981,12,14,14.285714285714286,80.03
13026,5384976,5599,405528,97507,3042,2557,1.0,2.0
13027,150264,182,0,6818,115,67,100.0,0.0
13028,61500,9,0,7752,6,3,100.0,0.0
13029,4957668,2160,407604,132697,1060,1100,1.0,0.0
13030,26712,100,3864,1971,83,17,1.0,35.46
13031,5515296,1562,0,168197,839,723,1.0,0.0
13032,787356,14,787356,493517,14,0,7.142857142857143,13.47
13033,5601264,31861,1515930,2204487,18196,13665,1.0,0.0
13034,5436648,2452,0,96905,1273,1179,1.0,0.0
13035,5413224,2603,409920,134449,1339,1264,1.0,0.0
13036,5535072,1490,0,454187,848,642,1.162790697674419,0.0
13037,180,32,180,51,24,8,4.761904761904762,35.35
13038,5593272,3034,0,1535236,1661,1373,1.7241379310344829,0.0
13039,677076,735,219744,51552,535,200,1.0,38.29
13040,55944,290,0,6446,176,114,100.0,0.0
13041,86220,43,0,35016,32,11,100.0,0.0
13042,43260,24,43260,843,21,3,6.25,77.19
13043,83688,1,83688,936,1,0,50.0,99.77
13044,34452,88,0,2971,73,15,100.0,0.0
13045,36504,23,36504,2028,21,2,7.142857142857143,97.41
13046,34452,31,34452,2079,27,4,6.25,68.2
13047,780864,11,780864,63633,11,0,8.333333333333334,98.2
13048,29076,75,29076,1986,60,15,1.851851851851852,12.39
13049,268500,46,120516,75110,45,1,2.5641025641025643,0.0
13050,2624340,37,50112,292306,30,7,5.882352941176471,71.41
13051,6840,58,0,1637,49,9,100.0,0.0
13052,1864092,97,4260,139025,55,42,3.703703703703704,0.0
13053,3372,65,324,117,65,0,2.1739130434782608,70.59
13054,142776,27,19992,6097,26,1,4.545454545454546,72.51
13055,10536,20,10536,1078,16,4,8.333333333333334,81.43
13056,312,48,312,21,48,0,2.0,46.13
13057,11088,31,11088,3944,27,4,4.761904761904762,92.27
13058,1591068,63,0,28591,52,11,33.333333333333336,0.0
13059,63240,7,63240,2982,5,2,33.333333333333336,99.68
13060,573744,42,0,27713,36,6,50.0,0.0
13061,2198352,51,929472,820724,45,6,2.857142857142857,44.38
13062,23280,63,0,2945,54,9,50.0,0.0
13063,1560,60,528,56,58,2,1.7241379310344829,51.49
13064,185292,14,185292,76076,13,1,10.0,96.93
13065,924,2,924,450,2,0,25.0,94.36
13066,31416,341,0,3722,201,140,100.0,0.0
13067,396,3,0,196,2,1,100.0,0.0
13068,1972308,31,0,191744,17,14,16.666666666666668,7.0
13069,300,53,300,13,49,4,2.0408163265306123,49.19
13070,81612,68,81612,6159,63,5,1.639344262295082,18.95
13071,312888,28,7560,22721,25,3,6.25,62.41
13072,5476188,2174,1020540,1119038,1196,978,1.0,0.0
13073,252,42,252,6,42,0,2.272727272727273,45.02
13074,5562000,708,1050264,613116,441,267,1.0,0.0
13075,2673792,338,0,73516,184,154,4.166666666666667,0.0
13076,516,57,516,30,56,1,1.7543859649122806,76.35
13077,970680,9,0,176525,6,3,16.666666666666668,44.94
13078,18120,302,0,3652,174,128,1.1904761904761905,0.0
13079,13332,24,13332,509,22,2,5.2631578947368425,65.93
13080,80268,253,0,5998,170,83,100.0,0.0
13081,2913588,35,2913588,182619,31,4,3.333333333333333,57.4
13082,0,0,0,0,0,0,1.162790697674419,0.0
13083,6252,22,6252,418,20,2,5.882352941176471,77.58
13084,1689192,94,336180,122360,81,13,1.4705882352941178,37.32
13085,22944,27,22944,1971,24,3,10.0,69.14
13086,15756,22,15756,420,21,1,5.0,74.23
13087,639240,8,936,80262,8,0,25.0,99.72
13088,109188,96,109188,14920,89,7,1.3888888888888888,8.16
13089,4608,15,4608,829,14,1,8.333333333333334,51.46
13090,3896172,43,0,92544,36,7,33.333333333333336,0.0
13091,49092,237,0,5090,129,108,1.639344262295082,0.0
13092,2484,11,2484,1341,9,2,12.5,98.14
13093,156,23,156,68,11,12,14.285714285714286,55.37
13094,16356,25,16356,1428,22,3,6.666666666666667,88.42
13095,258048,41,0,7389,27,14,100.0,0.0
13096,91656,60,0,11298,50,10,14.285714285714286,0.0
13097,35568,289,0,2446,159,130,1.2195121951219512,0.0
13098,5418024,3998,1025568,289000,1588,2410,1.0,1.85
13099,28860,22,28860,638,17,5,9.090909090909092,87.0
13100,503592,100,360808,61378,83,17,1.9230769230769231,10.76
13101,11244,22,11244,1378,19,3,7.6923076923076925,70.91
13102,6552,37,6552,2245,31,6,4.545454545454546,66.48
13103,692520,3,692520,1952,3,0,8.333333333333334,22.0
13104,7584,226,0,2946,126,100,1.4705882352941178,0.0
13105,18516,27,18516,1103,22,5,7.6923076923076925,62.63
13106,4284,31,4284,963,25,6,7.142857142857143,82.29
13107,251232,35,251232,229156,33,2,3.225806451612903,45.16
13108,27768,4,0,7242,3,1,50.0,50.0
13109,249732,47,249732,15082,39,8,2.7777777777777777,67.09
13110,11580,7,11580,264,5,2,16.666666666666668,0.0
13111,3924,5,3924,751,4,1,25.0,99.19
13112,5621376,649,1972836,1347219,413,236,1.25,0.0
13113,996,12,996,293,9,3,12.5,45.33
13114,1378584,130,0,72558,112,18,20.0,0.0
13115,788724,283,262440,12781,148,135,1.075268817204301,50.19
13116,4572,17,4572,588,15,2,10.0,85.53
13117,5439108,5130,5325924,1783838,2690,2440,1.6129032258064515,0.0
13118,4608,23,4608,1180,20,3,6.25,96.32
13119,9696,55,9696,2634,45,10,4.761904761904762,36.02
13120,108,0,108,0,0,0,50.0,75.0
13121,5457420,3917,1666812,884469,2561,1356,1.0,2.0
13122,288,511,264,99,320,191,1.0,34.9
13123,331524,32,331524,2161,27,5,4.166666666666667,49.0
13124,2244,10,2244,308,6,4,100.0,0.0
13125,1248684,1,573512,471852,0,1,100.0,0.0
13126,4682460,70,0,576403,60,10,100.0,0.0
13127,36432,113,0,11240,95,18,50.0,0.0
13128,3264,15,3264,614,14,1,7.6923076923076925,96.56
13129,864,6,864,154,5,1,16.666666666666668,51.15
13130,5633148,722,0,96265,388,334,1.4705882352941178,5.0
13131,5367600,1240,0,92602,727,513,1.0,0.0
13132,5643132,3232,0,802801,1958,1274,1.0,0.0
13133,45552,23,12744,3018,19,4,8.333333333333334,81.71
13134,2340,45,2340,2034,31,14,5.2631578947368425,46.17
13135,288,97,288,12,97,0,1.694915254237288,44.01
13136,6192,26,6192,5783,26,0,3.333333333333333,59.72
13137,1350564,81,546900,68076,54,27,2.0408163265306123,0.0
13138,7260,266,0,2985,173,93,1.1764705882352942,0.0
13139,1701408,25,1701408,225,23,2,4.3478260869565215,79.83
13140,3624,195,0,1008,158,37,100.0,0.0
13141,720,86,720,41,86,0,2.0,45.62
13142,190032,94,166152,40605,87,7,1.3888888888888888,5.15
13143,888,47,888,427,38,9,2.857142857142857,36.36
13144,5436,37,5436,1526,32,5,5.555555555555555,93.72
13145,756,96,756,153,94,2,1.7543859649122806,63.16
13146,733176,662,286120,49814,481,181,1.0,45.12
13147,2796,19,2796,2555,14,5,10.0,0.0
13148,528,69,384,149,39,30,3.571428571428572,6.13
13149,405672,41,0,96637,19,22,25.0,0.0
13150,135060,64,0,10421,46,18,100.0,0.0
13151,61260,5,61260,4994,5,0,14.285714285714286,68.56
13152,3276,307,2772,1301,199,108,1.0,28.86
13153,5657076,1280,3733356,1833476,582,698,1.0,0.0
13154,142572,72,0,8908,49,23,100.0,0.0
13155,519828,3,519828,372,2,1,33.333333333333336,58.37
13156,4903068,5890,1095384,224567,3212,2678,1.0,3.0
13157,11868,92,11868,3088,72,20,1.639344262295082,53.07
13158,817416,126,185328,55392,126,0,1.2987012987012987,3.3
13159,80868,62,80868,21515,46,16,2.4390243902439024,30.09
13160,3096,0,3096,0,0,0,100.0,100.0
13161,38148,0,38148,0,0,0,100.0,100.0
13162,69156,69,69156,915,65,4,1.694915254237288,2.8
13163,5679648,59074,354420,1355890,41946,17128,1.0,0.0
13164,5477232,516,0,124448,225,291,1.6129032258064515,0.0
13165,38388,0,38388,0,0,0,100.0,100.0
13166,1008,173,0,185,91,82,50.0,0.0
13167,5231472,4833,491784,170401,2580,2253,1.0,0.0
13168,56736,174,0,4031,113,61,100.0,0.0
13169,5880,4,5880,984,3,1,33.333333333333336,96.17
13170,1092,9,156,138,7,2,16.666666666666668,79.91
13171,600,38,600,51,35,3,3.333333333333333,47.62
13172,1104624,298,1104624,2912,188,110,1.0,5.0
13173,1315224,207,0,27428,99,108,5.0,6.64
13174,1800,10,0,1014,7,3,100.0,100.0
13175,4790292,3062,496356,126403,1560,1502,1.0,0.0
13176,9192,3,9192,1468,3,0,25.0,90.54
13177,5336520,2830,0,127020,1467,1363,1.0,0.0
13178,552,5,552,187,4,1,25.0,99.51
13179,5641920,4600,1205076,765299,2641,1959,1.0,0.0
13180,38532,5,38532,1406,5,0,20.0,64.58
13181,5676504,25465,1652196,792501,14415,11050,1.0,0.0
13182,1997796,506,0,45466,236,270,1.098901098901099,0.0
13183,83292,58,83292,1629,49,9,2.1739130434782608,28.87
13184,1080,12,324,245,11,1,8.333333333333334,46.26
13185,43392,30,23916,1416,26,4,6.666666666666667,46.46
13186,34488,23,34488,1135,20,3,5.882352941176471,97.21
13187,40500,35,40500,1638,29,6,7.142857142857143,77.8
13188,18000,7,18000,17298,7,0,11.11111111111111,62.43
13189,156792,5,156792,46380,5,0,16.666666666666668,99.37
13190,3804324,55,0,144660,46,9,100.0,0.0
13191,47760,57,0,4796,49,8,50.0,0.0
13192,45204,96,45204,26772,80,16,1.492537313432836,41.13
13193,9192,14,9192,694,13,1,10.0,49.22
13194,228,48,228,118,22,26,11.11111111111111,55.44
13195,2583684,171,0,16695,122,49,100.0,100.0
13196,228,1,228,0,1,0,33.333333333333336,76.98
13197,4860,55,0,1693,48,7,100.0,0.0
13198,228,0,228,0,0,0,100.0,100.0
13199,2532,17,2532,510,10,7,11.11111111111111,58.15
13200,9996,18,9996,1116,17,1,8.333333333333334,75.0
13201,127584,27,7212,5360,25,2,4.545454545454546,70.27
13202,300,16,300,156,8,8,50.0,54.27
13203,88800,14,0,8080,11,3,100.0,0.0
13204,2988,21,2988,391,19,2,5.882352941176471,76.71
13205,4075728,150,0,112309,107,43,1.7857142857142858,0.0
13206,2484,8,0,468,6,2,11.11111111111111,0.0
13207,2122536,82,0,29933,70,12,50.0,0.0
13208,5690604,298,0,1438211,196,102,14.285714285714286,0.0
13209,4620,14,4620,940,13,1,8.333333333333334,0.66
13210,384,47,384,125,21,26,10.0,61.23
13211,2414724,41,0,61281,35,6,50.0,0.0
13212,6276,23,6276,486,22,1,5.2631578947368425,78.4
13213,98760,298,204,721,122,176,3.125,29.3
13214,6876,24,6876,460,22,2,5.2631578947368425,76.24
13215,455760,49,353034,89103,40,9,3.571428571428572,30.53
13216,22968,19,22968,1275,15,4,8.333333333333334,84.2
13217,240,20,240,76,12,8,16.666666666666668,54.93
13218,4399464,23,26436,383301,19,4,7.6923076923076925,52.24
13219,7284,25,7284,976,22,3,7.6923076923076925,59.72
13220,3852,6,3852,496,6,0,16.666666666666668,71.12
13221,5701488,929,0,171793,520,409,1.36986301369863,0.0
13222,111600,4,111600,234,3,1,33.333333333333336,89.13
13223,5385312,14,0,385041,7,7,12.5,0.22
13224,47328,73,47328,7506,49,24,2.5641025641025643,56.44
13225,417096,25,0,33432,11,14,14.285714285714286,50.0
13226,101436,38,9360,4319,31,7,5.882352941176471,46.67
13227,591408,82,345216,78405,70,12,1.851851851851852,47.5
13228,40212,309,0,3847,163,146,1.098901098901099,0.0
13229,932232,219,932232,8948,118,101,7.142857142857143,38.92
13230,2532432,62,0,85056,51,11,33.333333333333336,0.0
13231,5738904,5412,0,1613355,2666,2746,1.0,0.0
13232,532584,37,532584,196308,37,0,3.0303030303030303,93.9
13233,504,6,0,220,3,3,50.0,0.0
13234,312,31,312,56,24,7,4.761904761904762,56.83
13235,816,16,816,311,9,7,33.333333333333336,96.24
13236,46668,52,0,7428,42,10,50.0,0.0
13237,7668,30,7668,2028,27,3,6.25,44.29
13238,4896,299,0,2025,172,127,1.4285714285714286,0.0
13239,17820,16,17820,677,13,3,11.11111111111111,88.01
13240,34680,68,0,7299,60,8,100.0,0.0
13241,5102436,940,0,91413,555,385,1.0416666666666667,0.0
13242,10752,247,2904,2554,145,102,1.0,0.0
13243,44568,61,44568,2317,56,5,1.818181818181818,21.13
13244,109020,161,70344,8104,132,29,1.0869565217391304,15.41
13245,336,21,336,49,17,4,5.555555555555555,16.39
13246,456,46,456,184,27,19,11.11111111111111,0.0
13247,31080,362,624,584,223,139,1.0,26.4
13248,65748,12,65748,3681,11,1,8.333333333333334,81.98
13249,82368,382,14232,7981,220,162,100.0,0.0
13250,249180,13,154578,7339,11,2,10.0,73.52
13251,192,1,192,120,1,0,33.333333333333336,78.9
13252,3600,246,0,956,185,61,100.0,0.0
13253,52776,21,52776,2488,18,3,6.666666666666667,92.77
13254,366672,46,0,15381,31,15,100.0,0.0
13255,96,3,96,12,3,0,20.0,58.97
13256,742068,1,742068,59724,1,0,50.0,99.68
13257,492,56,492,145,36,20,3.4482758620689653,18.8
13258,2352,23,2352,1007,20,3,7.6923076923076925,98.44
13259,5692164,3395,1176168,155933,1883,1512,1.0,0.0
13260,11592,25,11592,853,21,4,7.6923076923076925,82.28
13261,24948,26,24948,2293,23,3,5.882352941176471,60.35
13262,1179900,6,1179900,765484,6,0,16.666666666666668,98.94
13263,80688,6,80688,4062,6,0,14.285714285714286,97.03
13264,2607384,134,2607384,13725,64,70,4.166666666666667,76.36
13265,432,17,432,115,17,0,5.882352941176471,77.27
13266,5554176,21,0,1658938,3,18,2.7777777777777777,0.0
13267,6684,146,0,1506,105,41,1.4285714285714286,0.0
13268,540,61,540,453,39,22,3.0303030303030303,53.32
13269,5309508,6087,0,146183,3271,2816,1.0,0.0
13270,5588340,6692,851124,428671,3692,3000,1.0,0.0
13271,4872,4,4872,1092,4,0,25.0,98.73
13272,683028,33,683028,507598,33,0,4.166666666666667,2.08
13273,165372,5,165372,643,5,0,14.285714285714286,45.52
13274,12432,2,12432,300,2,0,33.333333333333336,93.91
13275,336,2,336,240,2,0,20.0,29.91
13276,10800,24,10800,1694,22,2,6.666666666666667,98.54
13277,7044,6,7044,150,6,0,14.285714285714286,97.49
13278,41556,21,22872,4460,16,5,8.333333333333334,53.09
13279,254160,25,0,14141,15,10,9.090909090909092,10.0
13280,2412,110,2412,2057,80,30,1.4492753623188406,46.05
13281,5761632,2296,0,1438477,1373,923,1.0,2.53
13282,5475096,438,0,347184,189,249,1.96078431372549,0.0
13283,4584,9,4584,412,8,1,14.285714285714286,84.06
13284,4576164,387,0,36477,211,176,2.380952380952381,0.0
13285,888,19,888,188,15,4,9.090909090909092,39.42
13286,2208696,681,235432,129972,680,1,1.0,0.0
13287,5478900,443,0,323795,211,232,3.0303030303030303,14.67
13288,5489232,1063,0,903644,593,470,1.1235955056179776,0.0
13289,937224,11,660,85621,9,2,14.285714285714286,52.58
13290,684,44,0,387,31,13,50.0,0.0
13291,5514036,5414,1191660,297880,2823,2591,1.0,0.53
13292,5641356,2313,0,95595,1292,1021,1.0,0.0
13293,17652,2,17652,276,2,0,33.333333333333336,93.5
13294,5741748,7041,0,936676,4371,2670,1.0,0.0
13295,9756,3,9756,4392,2,1,50.0,77.04
13296,576,5,576,307,5,0,14.285714285714286,93.33
13297,1800,19,0,816,11,8,25.0,0.0
13298,5151744,1548,0,35316,874,674,1.0,0.0
13299,3932808,420,0,32701,255,165,1.2345679012345678,0.0
13300,360,152,240,84,93,59,1.7543859649122806,25.44
13301,910764,679,349500,52453,496,183,1.0,41.36
13302,4402224,95,0,212227,81,14,16.666666666666668,0.0
13303,5004,18,5004,930,17,1,9.090909090909092,69.45
13304,39624,28,0,3111,24,4,100.0,0.0
13305,5405808,5633,1168428,234743,2297,3336,1.0,0.0
13306,92640,15,92640,6906,15,0,6.666666666666667,92.55
13307,1011492,9,1011492,14237,9,0,12.5,99.26
13308,5652852,1302,0,898041,719,583,1.0526315789473684,0.0
13309,19668,29,19668,1630,25,4,6.666666666666667,48.96
13310,126504,21,126504,2771,17,4,7.142857142857143,57.17
13311,176472,104,0,13394,86,18,20.0,0.0
13312,858180,5,858180,142586,4,1,33.333333333333336,97.67
13313,1490532,5,0,569577,5,0,100.0,100.0
13314,12468,23,12468,770,19,4,8.333333333333334,84.67
13315,9876,32,9876,591,30,2,3.8461538461538463,74.64
13316,3060,43,3060,2713,31,12,4.761904761904762,98.33
13317,5780916,2896,0,552353,1736,1160,1.0,0.0
13318,5744760,1052,2031492,1469679,448,604,1.0,0.0
13319,23136,512,0,5160,274,238,1.0,0.0
13320,4997664,27,0,389460,21,6,100.0,0.0
13321,770280,1,770280,95916,1,0,50.0,99.68
13322,3170856,30,0,319249,25,5,33.333333333333336,0.0
13323,4999404,40,4999404,236194,34,6,3.4482758620689653,65.88
13324,152208,52,0,3997,36,16,100.0,0.0
13325,118932,2,0,108222,2,0,25.0,90.0
13326,76572,47,0,6418,40,7,50.0,0.0
13327,354252,1146,272412,106249,1126,20,20.0,99.88
13328,3060504,126,0,62531,54,72,3.571428571428572,0.0
13329,18072,117,18072,1098,53,64,7.142857142857143,88.14
13330,466080,1,310792,5988,1,0,100.0,100.0
13331,5723784,2010,1356,1055588,1151,859,1.0,0.0
13332,1896,49,1344,539,33,16,5.882352941176471,89.06
13333,234888,64,234888,56195,60,4,1.7543859649122806,19.65
13334,37668,23,37668,23406,23,0,4.545454545454546,93.21
13335,6624,24,6624,467,22,2,5.2631578947368425,76.58
13336,5320380,24,136908,666514,19,5,5.2631578947368425,57.97
13337,2594604,83,0,66465,69,14,20.0,0.0
13338,11664,22,11664,1976,20,2,6.666666666666667,45.69
13339,13188,22,13188,472,21,1,5.2631578947368425,70.8
13340,6312,80,5820,1997,48,32,8.333333333333334,87.07
13341,4740,21,4740,388,20,1,5.555555555555555,74.52
13342,102732,602,0,6693,329,273,100.0,0.0
13343,565656,55,0,28213,45,10,4.3478260869565215,0.0
13344,6576,23,6576,592,22,1,4.761904761904762,75.38
13345,5281536,718,0,101510,397,321,1.0526315789473684,0.0
13346,610212,99,0,59267,85,14,50.0,0.0
13347,4644,6,4644,1548,6,0,20.0,94.04
13348,4620,22,4620,414,20,2,5.882352941176471,76.51
13349,5597436,853,0,303739,504,349,1.0,0.0
13350,5172,3,5172,2964,3,0,50.0,99.49
13351,2370060,31,19812,481322,23,8,8.333333333333334,86.13
13352,148584,23,148584,3165,19,4,5.0,49.01
13353,29052,25,29052,1935,22,3,6.25,55.31
13354,19464,39,0,4233,34,5,100.0,0.0
13355,15576,12,15576,5223,9,3,100.0,100.0
13356,1567332,59,0,59952,50,9,50.0,0.0
13357,5533200,323,0,77660,167,156,3.8461538461538463,0.0
13358,4818276,61,0,279029,55,6,33.333333333333336,0.0
13359,6408,22,6408,554,19,3,10.0,82.8
13360,2012100,84,28112,29790,45,39,3.0303030303030303,0.0
13361,2076,65,2076,265,41,24,3.571428571428572,27.93
13362,18384,33,18384,1575,28,5,6.25,47.2
13363,5732580,3283,0,1481711,1961,1322,1.0,0.0
13364,5695536,326,0,1543213,176,150,1.0869565217391304,0.0
13365,1164,28,1164,300,22,6,5.0,80.77
13366,1716,9,1716,308,7,2,14.285714285714286,53.25
13367,5036292,59,0,172730,50,9,33.333333333333336,0.0
13368,5814720,2124,726348,140238,1259,865,1.0,0.0
13369,35988,3,35988,12436,2,1,33.333333333333336,79.96
13370,6936,34,6936,1452,29,5,6.666666666666667,75.67
13371,2004,11,2004,382,9,2,14.285714285714286,89.71
13372,1944,10,1944,240,9,1,10.0,43.29
13373,912,3,72,304,3,0,25.0,81.0
13374,33744,296,0,3942,154,142,1.2658227848101269,0.0
13375,13848,294,0,2558,186,108,100.0,0.0
13376,50784,410,0,5219,229,181,100.0,0.0
13377,14472,43,0,4332,35,8,100.0,0.0
13378,193296,46,193296,22249,41,5,2.7777777777777777,54.64
13379,3480,17,3480,356,14,3,11.11111111111111,89.46
13380,218256,51,0,9802,43,8,50.0,0.0
13381,55692,8,35304,26611,8,0,33.333333333333336,99.87
13382,171852,21,171852,456,17,4,9.090909090909092,43.6
13383,576,18,576,228,14,4,8.333333333333334,42.26
13384,2964,30,2964,761,26,4,6.666666666666667,77.76
13385,1557684,181,0,147498,146,35,16.666666666666668,0.0
13386,86508,2,86508,6660,2,0,33.333333333333336,0.0
13387,53976,176,53976,887,166,10,1.0,0.0
13388,1164,124,1164,632,105,19,1.2820512820512822,81.14
13389,42648,39,0,2096,25,14,100.0,0.0
13390,17592,25,17592,2240,23,2,5.555555555555555,16.15
13391,2112,39,2112,1515,23,16,5.0,66.52
13392,2633400,48,2633400,788,23,25,10.0,86.89
13393,5782056,1402,610104,1705629,559,843,1.0,0.0
13394,9960,373,0,2186,191,182,1.2195121951219512,0.0
13395,696,62,0,380,46,16,50.0,0.0
13396,67944,253,67944,12723,218,35,1.0,10.22
13397,408,72,408,141,42,30,2.9411764705882355,22.09
13398,72660,36,72660,2309,33,3,5.2631578947368425,97.7
13399,63984,288,0,3569,159,129,100.0,0.0
13400,36480,114,25932,25669,91,23,1.2658227848101269,43.78
13401,23748,415,0,3423,245,170,100.0,0.0
13402,2634936,35,2634936,117987,20,15,6.666666666666667,78.5
13403,10020,22,10020,1635,21,1,7.142857142857143,78.0
13404,25188,21,25188,2059,19,2,7.6923076923076925,20.16
13405,3428232,109,0,727866,77,32,3.125,0.0
13406,5148,27,5148,1320,24,3,5.882352941176471,95.24
13407,5166324,1421,2361480,117374,744,677,1.0,57.6
13408,70332,52,0,2714,37,15,100.0,0.0
13409,2196,10,2196,1111,8,2,14.285714285714286,99.88
13410,53388,101,53388,3895,86,15,1.351351351351351,16.23
13411,84540,417,0,2781,222,195,100.0,0.0
13412,12084,1,12084,7512,1,0,100.0,0.0
13413,11364,20,11364,1005,17,3,10.0,19.51
13414,36936,16,36936,750,15,1,7.142857142857143,56.8
13415,1884,8,1884,1765,7,1,12.5,55.97
13416,2728284,234,0,13469,166,68,100.0,100.0
13417,3228,33,3228,919,28,5,6.666666666666667,41.76
13418,6420,26,6420,1008,22,4,7.142857142857143,96.49
13419,22008,21,22008,1032,17,4,5.882352941176471,64.18
13420,4884,23,4884,1142,21,2,6.666666666666667,67.6
13421,3783852,47,0,262769,24,23,10.0,2.91
13422,311976,90,311976,90528,78,12,1.7543859649122806,2.62
13423,312612,5,312612,235173,5,0,16.666666666666668,98.92
13424,5820,31,5820,2005,28,3,5.882352941176471,22.08
13425,12936,3,12936,424,2,1,50.0,0.0
13426,26844,61,0,1681,45,16,100.0,0.0
13427,18732,49,18732,5118,43,6,4.761904761904762,67.84
13428,34296,45,0,4767,39,6,100.0,0.0
13429,3960,14,3960,795,13,1,7.6923076923076925,65.52
13430,12048,24,12048,944,22,2,5.0,72.06
13431,2508,86,2508,970,55,31,2.9411764705882355,36.61
13432,1394868,93,0,48954,82,11,33.333333333333336,0.0
13433,13116,33,13116,2024,28,5,6.666666666666667,39.4
13434,4848,6,4848,300,4,2,33.333333333333336,0.0
13435,807732,781,243273,44811,576,205,1.0,32.01
13436,3552,29,3552,1336,26,3,7.6923076923076925,72.17
13437,24612,263,0,4202,147,116,1.1494252873563218,0.0
13438,37956,80,0,6606,67,13,100.0,0.0
13439,5712,20,5712,913,17,3,8.333333333333334,38.48
13440,874428,80,0,20149,28,52,1.0,0.0
13441,2976,19,2976,960,16,3,7.142857142857143,84.61
13442,9960,24,9960,380,23,1,5.0,76.09
13443,6204,45,6204,1268,36,9,5.555555555555555,29.96
13444,300,4,300,132,2,2,50.0,97.51
13445,2903688,31,0,128848,27,4,33.333333333333336,0.0
13446,1822032,7,1822032,331560,4,3,33.333333333333336,0.0
13447,24600,18,21456,11874,16,2,9.090909090909092,35.04
13448,1545588,72,450930,203812,71,1,100.0,100.0
13449,13800,26,13800,745,25,1,4.3478260869565215,81.21
13450,4464,23,4464,963,19,4,7.142857142857143,61.74
13451,85092,43,85092,18750,36,7,2.857142857142857,30.51
13452,7224,42,7224,1850,34,8,5.0,80.84
13453,460080,25,122916,23812,25,0,3.8461538461538463,59.93
13454,63060,47,0,5012,40,7,100.0,0.0
13455,1440,0,1440,0,0,0,100.0,100.0
13456,5988,15,5988,642,14,1,8.333333333333334,0.0
13457,27684,50,0,3069,34,16,100.0,0.0
13458,1812,19,1812,636,16,3,7.142857142857143,0.0
13459,18300,86,0,2532,74,12,100.0,0.0
13460,924372,20,9876,92802,18,2,6.666666666666667,79.04
13461,13428,38,0,5129,32,6,100.0,0.0
13462,4996668,21,36948,714752,17,4,7.6923076923076925,97.82
13463,294804,54,162396,57629,46,8,2.5,23.61
13464,79944,58,0,4290,47,11,50.0,0.0
13465,4877772,74,0,649656,64,10,3.0303030303030303,0.0
13466,19308,23,19308,881,21,2,5.2631578947368425,75.88
13467,13404,19,13404,2474,16,3,8.333333333333334,83.39
13468,20868,21,20868,542,20,1,5.2631578947368425,73.1
13469,7920,5,7920,1893,5,0,16.666666666666668,91.58
13470,5892504,3241,0,444620,1907,1334,1.0,0.0
13471,5632296,909,701328,530015,385,524,1.408450704225352,0.05
13472,10584,55,0,1227,41,14,100.0,0.0
13473,18396,56,16326,3857,32,24,6.25,0.0
13474,49656,18,49656,832,15,3,9.090909090909092,16.99
13475,4824,31,4824,1327,27,4,5.2631578947368425,68.98
13476,2407092,47,0,53297,42,5,50.0,0.0
13477,56280,22,56280,1557,20,2,9.090909090909092,18.89
13478,3468,24,0,461,21,3,14.285714285714286,0.0
13479,21432,57,21432,5517,49,8,2.631578947368421,35.63
13480,7968,26,7968,1166,22,4,8.333333333333334,17.93
13481,2280,4,2280,783,3,1,25.0,79.8
13482,5304312,65,0,428500,52,13,25.0,0.0
13483,288,14,288,143,12,2,11.11111111111111,82.43
13484,45816,55,0,1735,38,17,100.0,0.0
13485,44580,4,44580,44448,4,0,16.666666666666668,48.46
13486,72624,29,9852,3310,24,5,7.6923076923076925,79.16
13487,3145332,227,150282,161554,133,94,1.0,0.0
13488,936,6,936,326,6,0,14.285714285714286,58.67
13489,0,0,0,0,0,0,100.0,100.0
13490,5888436,33,14856,666362,26,7,7.142857142857143,91.74
13491,585804,31,5832,57409,26,5,7.142857142857143,81.32
13492,420,22,420,128,21,1,4.761904761904762,39.68
13493,82428,65,0,4869,58,7,100.0,0.0
13494,25404,74,0,6685,63,11,100.0,0.0
13495,71412,396,0,4179,213,183,100.0,0.0
13496,12372,25,7812,998,22,3,7.142857142857143,52.28
13497,564,2,564,156,2,0,33.333333333333336,68.61
13498,24492,51,0,1828,35,16,100.0,0.0
13499,30372,21,30372,932,19,2,9.090909090909092,97.98
13500,1404,16,1404,1142,12,4,8.333333333333334,82.3
13501,0,0,0,0,0,0,10.0,0.0
13502,4728,26,4728,1115,21,5,9.090909090909092,79.73
13503,5512428,1401,729276,255123,753,648,1.0,0.0
13504,5242800,82,204,63999,44,38,4.3478260869565215,60.48
13505,61416,203,0,2748,127,76,100.0,0.0
13506,50568,21,50568,1732,18,3,10.0,53.3
13507,4716,27,4716,1359,22,5,9.090909090909092,96.79
13508,20268,10,7836,2584,9,1,12.5,89.88
13509,4992,37,4992,888,32,5,6.25,76.4
13510,5445960,17,58044,1211817,13,4,10.0,78.97
13511,8100,41,8100,1784,35,6,6.25,44.37
13512,4354116,20,1064076,1398604,20,0,7.142857142857143,97.02
13513,66516,271,0,6308,168,103,100.0,0.0
13514,412728,246,77004,18340,204,42,1.0,9.08
13515,12996,128,0,5991,66,62,2.0,0.0
13516,36156,25,36156,2529,22,3,6.25,11.94
13517,168,1,168,36,1,0,33.333333333333336,49.96
13518,168,18,168,50,18,0,5.0,37.32
13519,2280,2,2280,1098,2,0,100.0,100.0
13520,163728,135,0,8526,59,76,100.0,0.0
13521,72852,74,72852,3081,65,9,1.7857142857142858,23.25
13522,7080,22,7080,1654,20,2,6.666666666666667,84.17
13523,3780,17,0,1651,10,7,12.5,4.76
13524,10308,31,10308,1184,24,7,8.333333333333334,96.23
13525,5136,20,5136,946,17,3,7.6923076923076925,0.0
13526,468,10,468,228,10,0,7.6923076923076925,55.44
13527,18900,4,18900,3438,3,1,25.0,60.57
13528,28692,55,0,1596,38,17,100.0,0.0
13529,264,34,264,99,24,10,4.761904761904762,49.59
13530,3096,20,3096,797,18,2,9.090909090909092,59.08
13531,576,17,348,143,14,3,8.333333333333334,64.39
13532,103380,30,11820,4586,24,6,6.666666666666667,75.67
13533,2840964,50,0,66947,45,5,50.0,0.0
13534,4996308,366,0,143052,224,142,1.36986301369863,0.1
13535,33564,320,0,4555,191,129,100.0,0.0
13536,5942796,2671,3190020,88702,1462,1209,1.0,0.15
13537,275340,108,275340,45653,90,18,1.5384615384615383,5.4
13538,12444,354,0,4890,184,170,1.0869565217391304,0.0
13539,19344,320,0,3923,196,124,100.0,0.0
13540,792,89,792,327,51,38,2.9411764705882355,65.48
13541,13872,290,0,2100,172,118,100.0,0.0
13542,2941524,159,9462,22493,158,1,1.2658227848101269,90.73
13543,147216,14,15192,11870,14,0,9.090909090909092,72.55
13544,3893544,715,0,60026,278,437,3.125,4.99
13545,828,1,828,600,1,0,25.0,89.42
13546,12468,25,12468,1521,23,2,6.666666666666667,60.34
13547,4152300,917,0,94348,523,394,1.0,0.0
13548,5845908,61,0,382139,51,10,33.333333333333336,0.0
13549,2702196,36,1272,76225,36,0,4.545454545454546,83.42
13550,34020,62,0,2244,47,15,100.0,0.0
13551,3067848,77,0,368800,77,0,3.125,98.58
13552,1761744,67,0,28628,57,10,33.333333333333336,0.0
13553,4284,18,4284,1174,17,1,6.666666666666667,72.28
13554,113844,222,0,18071,165,57,50.0,0.0
13555,1823664,167,0,122925,66,101,5.0,0.0
13556,5601792,1020,0,166299,562,458,1.3333333333333333,0.0
13557,5052,4,5052,4344,2,2,33.333333333333336,96.5
13558,25188,25,25188,2034,21,4,7.142857142857143,97.09
13559,20700,43,20700,1843,36,7,4.761904761904762,65.32
13560,2864664,93,0,686572,68,25,50.0,0.0
13561,9492,15,9492,681,15,0,7.6923076923076925,57.16
13562,9456,20,9456,1737,18,2,7.6923076923076925,1.94
13563,13500,42,0,1968,34,8,100.0,0.0
13564,11412,27,11412,1114,21,6,7.142857142857143,68.71
13565,23856,22,23856,931,22,0,4.761904761904762,77.76
13566,434364,46,434364,225137,19,27,10.0,35.79
13567,4204068,47,4204068,1950336,35,12,4.545454545454546,22.54
13568,3839352,60,0,65712,50,10,33.333333333333336,0.0
13569,681264,60,0,14835,51,9,50.0,0.0
13570,3684,14,3684,876,13,1,9.090909090909092,67.01
13571,11052,19,11052,408,18,1,5.555555555555555,68.67
13572,94608,33,94608,11676,26,7,5.555555555555555,63.88
13573,10740,23,10740,606,19,4,7.6923076923076925,76.75
13574,5306568,98,0,487576,86,12,2.1739130434782608,0.0
13575,2244,17,2244,559,15,2,9.090909090909092,89.72
13576,3960,24,3960,541,22,2,5.555555555555555,75.16
13577,37440,206,0,4143,128,78,1.5151515151515151,0.0
13578,1923336,14,9588,271974,13,1,8.333333333333334,60.38
13579,903468,28,0,97940,25,3,100.0,100.0
13580,2028,22,2028,396,20,2,5.555555555555555,72.44
13581,6048,21,3180,1325,19,2,7.142857142857143,35.85
13582,7188,61,0,1836,50,11,50.0,0.0
13583,1368936,37,0,75447,31,6,100.0,0.0
13584,5772,24,5772,457,22,2,5.2631578947368425,73.72
13585,2067588,121,179568,146338,107,14,1.075268817204301,12.08
13586,36900,47,0,1677,31,16,100.0,0.0
13587,5977788,41870,309492,897338,24843,17027,1.0,0.0
13588,32568,28,18420,4189,25,3,5.0,73.7
13589,6816,40,6816,1320,34,6,4.761904761904762,69.5
13590,5230224,68,0,167398,52,16,20.0,0.0
13591,5896584,620,0,474410,289,331,1.5625,0.0
13592,2039220,6,1020216,680010,4,2,100.0,100.0
13593,2892,7,0,1467,4,3,14.285714285714286,85.0
13594,7656,23,7656,1123,20,3,8.333333333333334,63.93
13595,57504,32,57504,2460,27,5,5.882352941176471,45.66
13596,2188608,5,1655832,410644,5,0,25.0,99.85
13597,10656,44,0,2372,34,10,100.0,0.0
13598,575292,1,575292,293820,1,0,50.0,99.98
13599,3319824,47,29568,635075,36,11,5.882352941176471,97.9
13600,289104,5,480,115812,4,1,50.0,0.0
13601,5969460,1852,315294,1368704,1143,709,1.0,0.0
13602,250848,97,250848,92985,85,12,1.7543859649122806,11.01
13603,5921664,500,730560,1416608,294,206,1.0,0.0
13604,336,9,336,152,9,0,10.0,79.96
13605,4560,7,4560,685,7,0,12.5,89.25
13606,3564,24,3564,1125,21,3,5.882352941176471,93.11
13607,132312,37,132312,48039,30,7,4.761904761904762,28.77
13608,3127464,137,1850274,36373,83,54,2.5,0.54
13609,1128,5,1128,405,3,2,100.0,100.0
13610,16032,29,16032,1083,25,4,5.2631578947368425,69.37
13611,1128,102,1128,75,74,28,1.818181818181818,52.34
13612,43944,43,0,3016,28,15,100.0,0.0
13613,53628,192,0,1357,115,77,100.0,0.0
13614,180,10,180,36,10,0,8.333333333333334,42.5
13615,50724,23,14772,7802,20,3,8.333333333333334,18.98
13616,948,7,948,420,5,2,16.666666666666668,77.29
13617,5981496,2704,131268,290894,1587,1117,1.0,0.0
13618,1764,14,1248,644,14,0,6.666666666666667,75.25
13619,65304,186,58140,13883,145,41,1.1904761904761905,8.86
13620,108,8,108,39,5,3,33.333333333333336,87.87
13621,186096,46,0,16352,37,9,5.2631578947368425,0.0
13622,19740,23,19740,1395,21,2,8.333333333333334,20.99
13623,1188,67,1188,256,65,2,1.492537313432836,26.54
13624,7944,66,0,1895,52,14,100.0,0.0
13625,48096,15,0,22608,7,8,25.0,0.0
13626,5981040,647,4681576,3923561,288,359,12.5,0.0
13627,2899140,33,2899140,7227,18,15,9.090909090909092,0.0
13628,31464,116,0,6884,75,41,2.272727272727273,0.0
13629,9000,24,9000,1306,20,4,7.142857142857143,32.51
13630,6768,6,0,2244,5,1,16.666666666666668,0.0
13631,67560,269,0,2625,150,119,100.0,0.0
13632,29856,26,14964,3218,21,5,9.090909090909092,82.9
13633,497460,22,497460,457436,22,0,7.142857142857143,99.23
13634,5999304,1729,771226,1065182,789,940,1.3157894736842106,0.0
13635,66120,36,66120,6076,32,4,3.703703703703704,4.85
13636,762192,16,181824,108600,16,0,100.0,100.0
13637,19188,216,0,2443,140,76,100.0,0.0
13638,1188,22,192,181,16,6,6.666666666666667,44.21
13639,6540,21,6540,321,20,1,5.2631578947368425,70.83
13640,20808,2,20808,13992,2,0,3.225806451612903,76.71
13641,1080,76,1080,673,62,14,1.5625,49.59
13642,312,74,312,98,52,22,2.4390243902439024,0.0
13643,5024340,31,4697232,2016757,26,5,6.666666666666667,29.67
13644,3414192,179,0,25242,111,68,1.7857142857142858,0.03
13645,6019692,2673,733242,1038330,1437,1236,1.0,0.0
13646,72672,122,0,5331,74,48,100.0,0.0
13647,13248,21,13248,1036,18,3,8.333333333333334,22.23
13648,2570304,19,0,286594,10,9,16.666666666666668,0.0
13649,8796,4,0,3339,3,1,100.0,0.0
13650,41436,48,0,2554,33,15,100.0,0.0
13651,888,4,888,0,4,0,16.666666666666668,76.27
13652,954168,2,954168,234,2,0,25.0,62.03
13653,150852,5,150852,360,4,1,25.0,0.0
13654,564,21,564,265,16,5,12.5,65.88
13655,5030988,129,0,107159,61,68,4.3478260869565215,0.0
13656,129024,22,38472,8940,19,3,7.6923076923076925,69.12
13657,220872,25,29304,10786,22,3,6.666666666666667,96.23
13658,5602548,1618,0,62395,857,761,1.0,0.0
13659,11436,18,11436,1810,17,1,7.142857142857143,78.57
13660,2355792,115,0,78521,50,65,3.125,0.0
13661,5829648,605,0,48540,304,301,1.25,1.0
13662,4695180,316,0,25512,183,133,2.0408163265306123,0.0
13663,6022740,4883,2307156,458393,2703,2180,1.0,0.0
13664,156156,25,156156,21021,15,10,20.0,3.0
13665,192432,90,192432,68738,64,26,1.8867924528301887,16.72
13666,5388,27,5388,1282,25,2,5.0,37.28
13667,6029220,3662,0,1275289,2164,1498,1.0,0.0
13668,324,99,324,17,99,0,1.408450704225352,0.0
13669,5786748,2246,583140,269441,1185,1061,1.0,3.01
13670,396,20,396,165,13,7,12.5,43.91
13671,637776,18,0,57422,11,7,12.5,0.0
13672,40584,42,4224,7272,26,16,4.0,57.97
13673,600,7,600,348,4,3,33.333333333333336,95.28
13674,15948,12,15948,812,11,1,16.666666666666668,89.94
13675,5216988,956,0,115595,518,438,1.0,0.0
13676,4645884,906,0,46018,510,396,1.0,0.0
13677,6000,15,6000,884,14,1,7.6923076923076925,3.03
13678,11496,13,11496,5,13,0,6.666666666666667,68.99
13679,5340900,492,5340900,67859,230,262,1.9230769230769231,65.76
13680,804,3,804,484,1,2,50.0,99.44
13681,4824,23,4068,695,21,2,5.0,75.26
13682,5827956,46,0,241493,39,7,50.0,0.0
13683,31308,21,4956,2485,19,2,6.666666666666667,41.22
13684,264,11,264,66,11,0,7.6923076923076925,80.59
13685,6036,25,6036,392,22,3,5.555555555555555,73.21
13686,14352,8,14352,8496,8,0,11.11111111111111,97.67
13687,7020,25,7020,1250,22,3,6.25,65.87
13688,660,10,0,325,8,2,50.0,0.0
13689,3504,45,3504,1181,35,10,5.2631578947368425,27.86
13690,6041556,5178,1894832,1230798,2843,2335,1.0,0.0
13691,3168,20,3168,987,17,3,7.142857142857143,64.31
13692,954576,47,504156,76985,42,5,2.4390243902439024,13.8
13693,70428,39,24768,3831,32,7,6.25,70.01
13694,2316,119,2130,748,81,38,1.0,0.0
13695,360,18,360,76,14,4,8.333333333333334,54.82
13696,828,1,0,828,0,1,100.0,0.0
13697,11916,22,11916,523,21,1,5.2631578947368425,72.29
13698,828,99,828,279,47,52,3.333333333333333,55.66
13699,96,3,96,36,2,1,33.333333333333336,83.99
13700,7224,23,7224,1212,21,2,7.142857142857143,57.96
13701,300,27,300,40,23,4,4.761904761904762,41.97
13702,213756,52,213756,191231,51,1,2.272727272727273,77.25
13703,1248,25,1248,552,25,0,3.703703703703704,54.65
13704,2774988,101,2774988,382147,56,45,4.761904761904762,23.9
13705,360,1,0,360,0,1,100.0,0.0
13706,9444,19,9444,870,15,4,11.11111111111111,81.52
13707,535272,22,3936,49141,20,2,5.555555555555555,75.76
13708,660,43,660,309,19,24,11.11111111111111,75.56
13709,264,76,264,102,34,42,7.142857142857143,79.68
13710,1984224,16,396,124306,14,2,7.142857142857143,58.79
13711,180,19,180,43,15,4,7.6923076923076925,68.42
13712,5937216,154,0,126379,78,76,3.225806451612903,3.0
13713,5937108,544,0,70582,296,248,1.3888888888888888,0.0
13714,180,32,84,16,28,4,3.703703703703704,36.55
13715,73632,39,0,3543,30,9,100.0,0.0
13716,5306796,383,0,434808,222,161,1.408450704225352,3.19
13717,5113152,50,0,253766,40,10,50.0,0.0
13718,3751584,26,0,303776,21,5,20.0,0.0
13719,2839980,60,0,135407,53,7,33.333333333333336,0.0
13720,204,0,204,0,0,0,50.0,61.33
13721,144,0,144,0,0,0,50.0,67.24
13722,5261496,33,5261496,251219,15,18,12.5,91.19
13723,16824,51,0,2772,43,8,33.333333333333336,0.0
13724,3888,22,3888,390,20,2,5.882352941176471,73.12
13725,5652,21,5652,1007,19,2,6.666666666666667,73.54
13726,36480,8,264,8988,7,1,14.285714285714286,90.16
13727,730344,68,730344,234927,68,0,2.272727272727273,91.56
13728,10380,22,10380,505,21,1,5.2631578947368425,75.2
13729,53412,326,0,6157,192,134,100.0,0.0
13730,45156,297,0,4929,190,107,100.0,0.0
13731,3318540,50,263808,103552,43,7,2.631578947368421,30.01
13732,1836,20,372,219,17,3,5.882352941176471,59.9
13733,10164,24,10164,402,22,2,5.882352941176471,72.45
13734,5945592,1070,0,82617,598,472,1.0,2.06
13735,1260,99,1260,474,27,72,2.083333333333333,0.0
13736,2726424,19,4908,144289,17,2,8.333333333333334,0.0
13737,473904,246,0,8729,123,123,3.703703703703704,0.0
13738,41328,24,41328,1356,21,3,6.666666666666667,96.39
13739,14688,13,14688,6999,8,5,20.0,89.29
13740,170988,63,170988,49949,54,9,2.631578947368421,22.19
13741,42264,118,0,6224,78,40,1.96078431372549,0.0
13742,358116,30,187812,180217,30,0,50.0,99.99
13743,531444,482,326083,208495,482,0,1.0,42.98
13744,8328,77,0,2103,69,8,100.0,0.0
13745,46932,44,0,2958,30,14,100.0,0.0
13746,372,33,192,54,29,4,3.571428571428572,52.64
13747,42420,13,42420,5735,11,2,10.0,85.64
13748,5784,19,5784,1133,18,1,7.142857142857143,69.74
13749,1371276,80,0,310845,65,15,100.0,0.0
13750,105804,0,105804,0,0,0,100.0,100.0
13751,63252,27,63252,5712,23,4,11.11111111111111,20.09
13752,68112,11,456,14516,9,2,10.0,39.57
13753,18912,33,18912,1024,28,5,5.882352941176471,74.69
13754,9216,1,0,9216,1,0,100.0,100.0
13755,6073584,1018,1992630,1444754,516,502,1.0101010101010102,0.0
13756,576,18,576,144,18,0,5.2631578947368425,78.83
13757,2003400,30,25848,133441,25,5,7.6923076923076925,34.64
13758,245172,61,245172,89761,53,8,2.5641025641025643,17.37
13759,5736,21,5736,928,19,2,6.25,60.65
13760,57648,27,57648,1032,23,4,9.090909090909092,36.5
13761,40896,37,5256,2052,32,5,6.666666666666667,76.64
13762,53232,4,53232,1848,3,1,20.0,46.72
13763,5124,22,5124,1009,19,3,9.090909090909092,54.55
13764,5675652,305,2736384,59714,162,143,4.545454545454546,88.26
13765,3828,102,3828,135,50,52,4.166666666666667,70.19
13766,9588,20,9588,911,18,2,7.142857142857143,22.34
13767,2580,7,2580,387,7,0,12.5,58.23
13768,3792984,243,0,671078,118,125,4.545454545454546,3.57
13769,7368,25,5040,1579,22,3,8.333333333333334,70.02
13770,21120,29,0,2737,24,5,100.0,0.0
13771,12360,50,0,2655,41,9,100.0,0.0
13772,576,0,576,0,0,0,50.0,57.18
13773,6002040,4295,0,594364,2604,1691,1.0,0.0
13774,18732,301,0,6304,146,155,1.9230769230769231,0.0
13775,10428,24,10428,1235,21,3,9.090909090909092,16.17
13776,3312,38,3312,2755,29,9,3.8461538461538463,72.78
13777,12768,204,0,3484,135,69,100.0,0.0
13778,3499332,128,0,366668,68,60,3.8461538461538463,0.0
13779,600,2,600,456,1,1,33.333333333333336,78.51
13780,1140,25,1140,701,25,0,3.333333333333333,60.55
13781,1464,102,0,302,86,16,50.0,0.0
13782,5664,13,5664,472,11,2,11.11111111111111,75.44
13783,720,59,720,347,54,5,1.96078431372549,48.0
13784,172932,115,0,37200,95,20,50.0,0.0
13785,408,0,408,0,0,0,100.0,92.0
13786,10788,24,10788,748,21,3,7.6923076923076925,66.48
13787,1248,30,1248,1056,20,10,5.882352941176471,87.7
13788,3119196,29,3119196,59168,20,9,14.285714285714286,62.72
13789,1879944,47,0,56934,36,11,50.0,0.0
13790,143736,112,0,9411,72,40,100.0,0.0
13791,5998992,2144,68718,332878,1185,959,1.0,3.0
13792,5885604,1394,77052,274755,658,736,1.0,0.0
13793,11172,18,11172,1176,16,2,10.0,27.44
13794,50064,230,0,4192,139,91,100.0,0.0
13795,984,144,936,195,80,64,2.5,13.69
13796,988512,4,48588,281304,4,0,33.333333333333336,99.83
13797,2407056,55,0,132819,47,8,33.333333333333336,0.0
13798,21012,195,0,2854,125,70,100.0,0.0
13799,4238448,20,4238448,177,17,3,5.2631578947368425,81.65
13800,21888,19,21888,918,17,2,7.6923076923076925,0.0
13801,330540,149,48744,13505,124,25,1.1764705882352942,5.53
13802,52116,44,52116,877,26,18,5.2631578947368425,43.21
13803,6044556,3469,2041752,768109,1828,1641,1.0,5.27
13804,5967876,1851,0,59505,1032,819,1.0,1.38
13805,5869632,11028,948120,619982,4886,6142,1.0,0.0
13806,3240,14,3240,806,13,1,9.090909090909092,59.99
13807,432,9,432,232,7,2,16.666666666666668,92.14
13808,16692,29,16692,1555,26,3,7.6923076923076925,15.46
13809,1428,161,1428,534,96,65,2.127659574468085,0.0
13810,117948,153,117948,1527,103,50,1.2048192771084338,38.63
13811,3857856,216,0,21470,127,89,100.0,0.0
13812,2677800,506,2677800,24572,268,238,1.2820512820512822,37.69
13813,43320,177,43320,2363,103,74,2.857142857142857,74.53
13814,6109728,3024,0,1324903,1736,1288,1.0,4.24
13815,984,64,984,291,40,24,4.166666666666667,55.66
13816,5852928,1830,0,97962,1087,743,1.0,0.0
13817,6336,17,6336,845,16,1,7.6923076923076925,68.73
13818,20004,139,20004,1414,85,54,1.8867924528301887,59.07
13819,5925168,1147,3359904,71668,588,559,1.0,0.0
13820,107088,30,107088,2960,27,3,3.703703703703704,69.77
13821,4157184,76,2877396,136439,41,35,8.333333333333334,82.63
13822,90192,35,90192,6672,30,5,3.703703703703704,5.25
13823,67104,54,67104,1128,36,18,3.333333333333333,33.96
13824,2327712,278,0,24533,157,121,2.2222222222222223,0.0
13825,4455168,364,924456,95902,208,156,1.0,5.0
13826,60648,71,60648,917,71,0,1.408450704225352,66.09
13827,6768,16,6768,952,15,1,8.333333333333334,58.37
13828,3960,131,3960,1315,99,32,1.2820512820512822,40.55
13829,6101736,2994,1622784,1290443,1446,1548,1.0,0.0
13830,252,48,108,32,35,13,3.4482758620689653,0.0
13831,28104,915,28104,12863,322,593,1.5384615384615383,80.68
13832,2340,40,2340,1833,38,2,2.5641025641025643,54.77
13833,4713288,405,0,92685,205,200,2.3255813953488373,0.0
13834,1596,14,1596,1464,9,5,16.666666666666668,72.87
13835,6084804,13035,1324287,781502,7477,5558,1.0,0.0
13836,60,17,60,4,17,0,5.2631578947368425,36.87
13837,3012948,7,3012948,524,5,2,10.0,0.0
13838,156,11,156,56,8,3,14.285714285714286,18.74
13839,5681568,251,0,37066,116,135,2.702702702702702,3.85
13840,1077588,125,0,13285,58,67,4.3478260869565215,0.0
13841,4176,57,4176,3871,43,14,2.631578947368421,43.68
13842,39708,9,0,9922,7,2,100.0,0.0
13843,5478588,274,1543428,193062,145,129,2.4390243902439024,0.0
13844,988716,724,292239,47076,523,201,1.0,35.21
13845,1416,1,1416,288,1,0,25.0,65.16
13846,173220,604,0,7617,344,260,1.36986301369863,0.0
13847,1124100,15,0,87815,10,5,11.11111111111111,2.0
13848,4805304,203,0,84043,106,97,2.7777777777777777,0.0
13849,411600,6,411600,884,6,0,100.0,100.0
13850,80496,26,15204,3726,23,3,4.761904761904762,67.58
13851,32124,22,26160,1806,20,2,5.555555555555555,80.0
13852,440472,38,163344,46335,30,8,4.3478260869565215,3.89
13853,120312,7,120312,55073,7,0,2.857142857142857,7.74
13854,861852,51,0,37173,44,7,50.0,0.0
13855,9504,38,0,1829,31,7,100.0,0.0
13856,24960,265,0,2766,160,105,100.0,0.0
13857,1272456,53,0,318871,40,13,25.0,0.0
13858,18624,18,18624,940,15,3,8.333333333333334,29.94
13859,984,7,984,363,4,3,50.0,99.34
13860,1740,22,240,132,21,1,4.3478260869565215,29.58
13861,29664,352,0,3357,165,187,1.351351351351351,0.0
13862,1980,0,1980,0,0,0,50.0,95.75
13863,70884,77,0,3811,66,11,100.0,0.0
13864,852,3,852,320,2,1,50.0,98.27
13865,39384,211,0,3466,137,74,100.0,0.0
13866,133584,47,0,6120,33,14,100.0,0.0
13867,48348,38,48348,3321,31,7,5.0,60.79
13868,33228,305,0,4720,198,107,100.0,0.0
13869,6576,48,0,1680,41,7,50.0,0.0
13870,76008,24,76008,2722,21,3,6.666666666666667,97.21
13871,11844,23,11844,469,21,2,5.2631578947368425,72.46
13872,75132,5,75132,17311,3,2,33.333333333333336,62.08
13873,6036,47,0,1847,40,7,100.0,0.0
13874,14100,22,14100,546,21,1,5.0,78.53
13875,15036,0,15036,0,0,0,100.0,100.0
13876,3528,23,3528,409,21,2,5.2631578947368425,72.84
13877,5978628,887,694848,444296,515,372,1.0,1.86
13878,36636,313,0,3558,194,119,100.0,0.0
13879,13860,27,13860,603,25,2,4.761904761904762,75.55
13880,240,1,240,144,1,0,50.0,56.24
13881,168780,32,168780,22397,30,2,4.0,43.62
13882,89364,87,3852,1411,76,11,1.6129032258064515,26.76
13883,14028,12,14028,616,11,1,10.0,80.18
13884,8616,74,0,2046,64,10,100.0,0.0
13885,5232,6,5232,216,5,1,20.0,66.48
13886,6816,22,318,1089,19,3,7.142857142857143,14.62
13887,1283688,57,0,40472,43,14,20.0,0.0
13888,17460,66,0,3897,54,12,50.0,0.0
13889,1398060,53,1398060,41426,28,25,11.11111111111111,23.72
13890,19176,21,19176,589,17,4,7.142857142857143,75.42
13891,1697484,65,0,29546,54,11,50.0,0.0
13892,48336,11,48336,2377,7,4,14.285714285714286,46.6
13893,732,7,732,540,5,2,16.666666666666668,95.63
13894,92004,50,0,4788,34,16,100.0,0.0
13895,47208,5,47208,523,3,2,33.333333333333336,97.77
13896,648,2,0,492,1,1,100.0,0.0
13897,1728,2,1728,288,2,0,25.0,52.96
13898,14472,21,14472,1436,19,2,5.882352941176471,68.56
13899,27648,486,0,14321,238,248,1.0,0.0
13900,66372,51,66372,1716,42,9,4.761904761904762,22.25
13901,5963712,85,0,504555,70,15,3.0303030303030303,0.0
13902,1008,10,1008,492,10,0,8.333333333333334,85.28
13903,4487868,313,3360444,104566,169,144,2.857142857142857,0.0
13904,506196,61,506196,501365,58,3,16.666666666666668,0.0
13905,47544,74,0,3575,64,10,100.0,0.0
13906,132,28,132,37,20,8,7.142857142857143,64.12
13907,6061452,115,0,94165,58,57,7.142857142857143,0.0
13908,5496,126,5496,4889,84,42,1.6129032258064515,52.91
13909,6064608,2663,0,103946,1503,1160,1.0,0.0
13910,6185424,11706,0,1736447,7651,4055,1.0,0.0
13911,6183276,40011,2537611,1556076,20531,19480,1.0,0.0
13912,156,14,156,90,14,0,6.25,72.3
13913,2685168,102,2685168,59354,45,57,6.666666666666667,0.0
13914,43512,144,0,9865,88,56,1.639344262295082,0.0
13915,28500,279,0,4249,183,96,50.0,0.0
13916,55200,22,432,4781,17,5,7.6923076923076925,18.86
13917,6158796,6339,660756,437715,3523,2816,1.0,0.0
13918,612,88,612,186,88,0,1.1904761904761905,43.61
13919,5631900,332,0,134314,174,158,1.7241379310344829,0.0
13920,11640,0,11640,0,0,0,100.0,100.0
13921,6176076,913,667908,1394421,510,403,1.0,2.41
13922,6196452,18739,744000,1309377,11549,7190,1.0,0.0
13923,4775028,277,0,56802,128,149,3.333333333333333,0.0
13924,21084,138,0,5864,83,55,1.8867924528301887,0.0
13925,2586468,207,2586468,46081,102,105,3.8461538461538463,73.12
13926,2292,0,2292,0,0,0,50.0,90.0
13927,6083880,822,664644,151896,449,373,1.3333333333333333,0.0
13928,61728,38,0,6482,29,9,100.0,0.0
13929,85128,28,85128,3185,26,2,3.4482758620689653,71.11
13930,240,6,240,24,6,0,12.5,40.1
13931,5873784,1743,0,143979,926,817,1.0,0.0
13932,5052576,996,0,128195,474,522,1.162790697674419,5.93
13933,2940684,35,2601840,314675,34,1,3.703703703703704,7.81
13934,5997576,1664,676740,107233,990,674,1.0,5.0
13935,251208,17,69876,32398,17,0,2.7777777777777777,10.91
13936,5112,0,5112,0,0,0,100.0,100.0
13937,84,14,84,7,14,0,6.25,42.07
13938,1006680,6,1006680,103990,6,0,14.285714285714286,98.08
13939,20940,9,20940,3934,5,4,20.0,94.47
13940,996,9,996,60,6,3,20.0,46.29
13941,6128004,166,0,129554,86,80,3.333333333333333,0.0
13942,1067556,44,4032,24807,37,7,2.9411764705882355,45.6
13943,3492,15,3492,1321,13,2,11.11111111111111,62.03
13944,38592,5,38592,2320,4,1,33.333333333333336,96.15
13945,6031308,3369,1169604,559106,1765,1604,1.0,0.0
13946,23652,56,23652,8636,46,10,2.857142857142857,50.72
13947,4008,2,1908,3702,1,1,50.0,65.54
13948,11292,41,0,2234,34,7,100.0,0.0
13949,1115160,46,0,619446,26,20,100.0,0.0
13950,5417052,835,299409,62815,594,241,1.0,55.46
13951,75120,40,75120,1735,37,3,4.0,68.04
13952,1320,45,1320,181,42,3,2.5,32.25
13953,31392,293,0,3550,186,107,100.0,0.0
13954,5681328,537,0,75317,252,285,1.2195121951219512,0.0
13955,1128,45,1128,570,42,3,2.3255813953488373,31.93
13956,1548,6,1548,452,4,2,14.285714285714286,23.29
13957,6192,6,6192,1024,5,1,25.0,0.0
13958,351072,27,960,14533,17,10,11.11111111111111,34.76
13959,46020,34,0,3385,29,5,100.0,0.0
13960,21912,203,0,4023,111,92,1.5873015873015872,0.0
13961,1965372,58,0,36289,51,7,33.333333333333336,0.0
13962,3228,9,3228,3076,9,0,10.0,91.22
13963,2576592,5,2576592,66432,3,2,50.0,99.81
13964,300,11,300,55,6,5,25.0,29.36
13965,6195564,13560,772524,254891,6343,7217,1.0,0.0
13966,984,0,984,0,0,0,100.0,100.0
13967,878448,6,878448,5734,5,1,25.0,92.03
13968,1452,16,1452,294,16,0,5.555555555555555,55.91
13969,1644,19,1644,138,13,6,9.090909090909092,50.78
13970,1560,13,1560,562,10,3,14.285714285714286,89.03
13971,3919344,14,13140,1763002,10,4,25.0,99.67
13972,35796,6,1392,6376,6,0,16.666666666666668,90.92
13973,2105196,25,6984,252960,23,2,5.2631578947368425,75.43
13974,528,21,528,131,17,4,6.666666666666667,45.11
13975,61392,19,61392,1294,18,1,7.142857142857143,67.41
13976,1216308,9,2616,137244,7,2,16.666666666666668,90.31
13977,2592,14,2592,1360,13,1,8.333333333333334,69.02
13978,5310120,47,0,119236,38,9,33.333333333333336,0.0
13979,2952,3,2952,2888,3,0,20.0,94.37
13980,142464,62,0,10893,53,9,50.0,0.0
13981,47328,268,0,2228,169,99,50.0,0.0
13982,609516,124,609516,182630,116,8,1.0,11.71
13983,75612,16,0,5527,13,3,100.0,0.0
13984,2484,12,2484,981,12,0,7.6923076923076925,58.31
13985,139608,23,10644,6526,21,2,5.2631578947368425,72.5
13986,77148,23,12408,3758,21,2,5.2631578947368425,75.81
13987,416712,83,416712,59574,50,33,4.0,0.0
13988,98220,33,98220,4274,27,6,6.25,92.68
13989,4081404,1,0,4081404,1,0,12.5,37.0
13990,5428776,2654,1266720,271217,1434,1220,1.0,0.0
13991,268680,48,268680,101867,42,6,3.125,43.87
13992,6197940,6942,627672,1831306,4180,2762,1.0,0.0
13993,553620,33,553620,34156,23,10,6.25,52.27
13994,3332244,16,3331932,496650,9,7,9.090909090909092,60.8
13995,112644,25,94356,7360,22,3,8.333333333333334,72.07
13996,6233952,4950,319060,508595,2730,2220,1.0,0.0
13997,5412,35,5412,1495,26,9,9.090909090909092,97.18
13998,86256,17,86256,1069,16,1,7.6923076923076925,25.91
13999,88932,27,36168,10740,23,4,8.333333333333334,80.35
14000,4465608,233,1014744,748917,119,114,5.882352941176471,0.14
14001,31020,303,0,4991,201,102,1.0,0.0
14002,23784,19,23784,1453,18,1,8.333333333333334,34.27
14003,6036732,178,4072056,1056765,102,76,1.7857142857142858,7.01
14004,6216504,4807,0,3670516,2832,1975,1.0,0.0
14005,216780,20,0,24775,18,2,50.0,0.0
14006,744,105,744,480,91,14,1.1904761904761905,37.29
14007,29436,9,29436,2272,9,0,11.11111111111111,96.43
14008,38076,15,38076,1254,12,3,7.142857142857143,81.08
14009,672,38,672,100,38,0,2.5641025641025643,44.76
14010,972,58,972,602,38,20,3.333333333333333,73.33
14011,5933460,609,1677852,124113,342,267,1.0,0.0
14012,89292,21,47682,1004,19,2,7.6923076923076925,15.1
14013,4503168,59,0,79317,52,7,50.0,0.0
14014,2751264,30,2751264,53766,14,16,8.333333333333334,80.03
14015,75624,1,75624,156,1,0,50.0,98.0
14016,119676,50,0,12085,37,13,100.0,0.0
14017,6260832,10545,425790,806318,5509,5036,1.0,1.39
14018,2955276,319,0,89850,128,191,5.0,0.0
14019,912,10,0,507,9,1,8.333333333333334,0.0
14020,6183396,121,42984,55475,96,25,1.6666666666666667,8.27
14021,288,1,288,0,1,0,33.333333333333336,63.71
14022,108,8,108,24,5,3,25.0,57.99
14023,1020,22,1020,744,20,2,4.761904761904762,81.3
14024,63252,0,63252,0,0,0,100.0,100.0
14025,8124,93,1740,700,57,36,2.7777777777777777,67.46
14026,9540,134,0,2234,86,48,100.0,0.0
14027,948,141,948,529,107,34,1.0869565217391304,19.72
14028,22476,144,0,3453,79,65,100.0,0.0
14029,85836,295,0,2750,178,117,50.0,0.0
14030,6267456,2199,1694856,94078,1205,994,1.0,0.18
14031,432,7,432,128,7,0,12.5,82.44
14032,1896,87,1896,502,75,12,1.4285714285714286,41.58
14033,134880,148,0,9085,85,63,100.0,0.0
14034,312,51,312,62,41,10,2.631578947368421,32.99
14035,487728,39,372,12817,31,8,3.4482758620689653,68.73
14036,6282948,856,2220888,706906,468,388,1.351351351351351,0.0
14037,155424,56,155424,7033,36,20,3.571428571428572,58.45
14038,5900040,424,0,719710,215,209,1.0,0.0
14039,5990256,456,0,313562,184,272,2.083333333333333,15.0
14040,3444,135,3444,1424,101,34,1.162790697674419,37.07
14041,312,4,312,132,2,2,50.0,33.56
14042,3555372,435,0,38766,224,211,1.8867924528301887,10.72
14043,7860,3,7860,532,3,0,50.0,79.92
14044,5851812,74,5851812,1473,40,34,4.166666666666667,66.68
14045,1440,22,0,993,17,5,5.882352941176471,0.0
14046,5911512,664,1104348,1291375,393,271,1.0,0.0
14047,6186120,3440,0,205432,1655,1785,1.0,0.0
14048,9336,106,708,445,44,62,6.25,95.84
14049,6180120,178,0,132878,92,86,3.0303030303030303,0.0
14050,191028,21,14700,9905,20,1,5.882352941176471,75.85
14051,1513320,49,1266148,80657,36,13,4.545454545454546,0.0
14052,3048,65,3048,3015,42,23,4.761904761904762,84.84
14053,24060,70,0,2937,42,28,100.0,0.0
14054,151776,1,151776,7140,1,0,25.0,91.32
14055,3839928,133,558732,257847,116,17,100.0,100.0
14056,48432,16,48432,2960,15,1,8.333333333333334,71.58
14057,54000,33,54000,1485,28,5,5.0,43.93
14058,1947792,42,0,327305,32,10,33.333333333333336,0.0
14059,1190916,65,0,58209,52,13,100.0,0.0
14060,11628,39,11628,1689,35,4,3.571428571428572,57.57
14061,45768,44,0,2542,37,7,100.0,0.0
14062,5830968,492,0,311439,261,231,1.7241379310344829,0.0
14063,96,0,96,0,0,0,50.0,75.0
14064,6310272,11491,3196299,1796368,7376,4115,1.0,0.0
14065,23304,15,23304,951,13,2,8.333333333333334,52.22
14066,75684,52,0,4923,46,6,100.0,0.0
14067,82728,1,82728,132,1,0,50.0,99.5
14068,2772228,12,61080,907218,8,4,50.0,99.6
14069,50424,67,4284,5031,53,14,2.0,33.51
14070,88716,4,88716,30723,4,0,20.0,93.2
14071,1000992,51,0,29175,45,6,100.0,0.0
14072,39756,243,0,3618,146,97,1.1363636363636365,0.0
14073,77232,81,77232,2150,58,23,2.2222222222222223,18.4
14074,861384,14,861384,32903,14,0,25.0,99.96
14075,9720,23,9720,394,21,2,5.2631578947368425,70.91
14076,2796,18,2796,378,15,3,7.6923076923076925,66.95
14077,27144,131,0,1931,91,40,100.0,0.0
14078,4200,25,4200,451,22,3,5.555555555555555,69.58
14079,213396,57,0,8186,48,9,100.0,0.0
14080,20184,183,0,1433,101,82,50.0,0.0
14081,253056,44,0,7312,36,8,100.0,0.0
14082,320400,72,320400,126513,63,9,2.4390243902439024,14.87
14083,7872,58,0,1678,50,8,50.0,0.0
14084,65112,20,65112,687,16,4,10.0,86.82
14085,5664,21,5664,441,19,2,5.882352941176471,72.87
14086,181188,43,0,6444,28,15,100.0,0.0
14087,6324864,15598,714540,2242981,9640,5958,1.0,0.5
14088,497412,57,249084,114429,50,7,2.9411764705882355,18.7
14089,2873016,26,5484,331825,22,4,5.555555555555555,70.75
14090,63828,22,63828,4008,19,3,10.0,19.55
14091,5510856,881,0,136164,517,364,1.075268817204301,0.0
14092,5227860,14,5227860,299207,9,5,50.0,0.0
14093,4548,20,4548,728,18,2,6.25,72.37
14094,17304,25,17304,582,23,2,4.761904761904762,76.46
14095,88872,27,88872,3299,23,4,7.6923076923076925,95.08
14096,42924,7,42924,747,4,3,12.5,21.86
14097,10692,37,0,1952,30,7,100.0,0.0
14098,120,8,120,9,6,2,16.666666666666668,53.08
14099,276720,67,183768,23491,58,9,1.7857142857142858,26.04
14100,190860,43,190860,67788,37,6,3.703703703703704,22.91
14101,1368,106,1368,273,86,20,1.4705882352941178,29.35
14102,2232888,14,0,536101,9,5,14.285714285714286,0.0
14103,3024,9,3024,580,6,3,20.0,95.49
14104,1475676,68,0,67505,59,9,50.0,0.0
14105,1128,168,0,257,141,27,50.0,0.0
14106,15180,47,0,1209,30,17,100.0,0.0
14107,4479372,40,4326144,115340,17,23,14.285714285714286,83.02
14108,787632,18,787632,1001,18,0,9.090909090909092,56.38
14109,36204,20,36204,630,18,2,10.0,69.51
14110,192,15,192,71,10,5,14.285714285714286,49.02
14111,20196,9,0,3914,6,3,50.0,0.0
14112,107004,48,0,3479,33,15,100.0,0.0
14113,4635036,670,0,46903,359,311,1.5873015873015872,0.0
14114,18432,40,18432,1724,34,6,7.142857142857143,13.47
14115,660,2,660,408,2,0,33.333333333333336,98.71
14116,4179192,273,4179060,56507,179,94,1.0,0.0
14117,3610524,41,0,614087,33,8,20.0,0.0
14118,8448,11,8448,1202,6,5,33.333333333333336,93.82
14119,4164,47,0,743,37,10,100.0,0.0
14120,118056,6,118056,1300,5,1,16.666666666666668,77.78
14121,2749872,160,2749872,33567,75,85,3.0303030303030303,0.0
14122,3924,11,3924,1411,7,4,20.0,84.29
14123,192,1,192,0,1,0,33.333333333333336,73.0
14124,400188,79,0,46063,65,14,33.333333333333336,0.0
14125,3312,27,0,1100,21,6,100.0,0.0
14126,1440,2,1440,1098,2,0,33.333333333333336,94.0
14127,6078060,242,0,667938,114,128,1.851851851851852,12.74
14128,516,29,516,93,28,1,5.0,78.41
14129,5334168,5925,1136388,646355,3149,2776,1.0,0.0
14130,6828,17,6828,208,13,4,9.090909090909092,61.37
14131,540,15,540,155,8,7,20.0,75.4
14132,5992620,209,5992620,344804,113,96,2.5,0.0
14133,312204,21,0,15330,19,2,50.0,0.0
14134,3084,47,0,610,31,16,100.0,0.0
14135,74460,240,0,3669,151,89,50.0,0.0
14136,390672,135,35472,14491,104,31,1.5384615384615383,11.03
14137,1404,29,1404,280,28,1,7.6923076923076925,77.31
14138,6328416,2527,4189332,302882,1334,1193,1.0,0.0
14139,270408,113,270408,5618,87,26,1.2820512820512822,48.29
14140,6333444,7935,830388,1169327,4380,3555,1.0,0.63
14141,1908,8,0,735,7,1,11.11111111111111,0.0
14142,204,13,204,36,9,4,12.5,73.17
14143,532200,29,528713,167390,9,20,14.285714285714286,0.0
14144,9756,28,9756,381,27,1,3.4482758620689653,69.18
14145,0,0,0,0,0,0,2.127659574468085,30.0
14146,4194852,253,4194684,84898,113,140,6.25,10.23
14147,103128,329,0,5574,200,129,1.2345679012345678,0.0
14148,3348,116,3348,1586,76,40,2.631578947368421,8.8
14149,13428,193,0,2843,107,86,100.0,0.0
14150,6367320,47231,993557,1208124,28735,18496,1.0,0.8
14151,5988000,2721,0,466905,1541,1180,1.0,0.0
14152,1740,77,0,725,53,24,100.0,0.0
14153,2904,1,2904,240,1,0,33.333333333333336,73.0
14154,4763304,689,4206948,65691,357,332,1.408450704225352,6.5
14155,6086796,335,0,162621,147,188,3.0303030303030303,0.0
14156,19380,2,19380,258,2,0,33.333333333333336,99.01
14157,1788108,227,1788108,8456,163,64,1.0,0.0
14158,3084,7,3084,1018,7,0,11.11111111111111,3.96
14159,300,11,300,19,11,0,7.6923076923076925,46.4
14160,6329796,495,0,1748522,257,238,1.0,0.0
14161,1272,3,1272,920,3,0,16.666666666666668,22.87
14162,6212448,150,0,452935,78,72,4.3478260869565215,50.0
14163,5340,26,5340,671,25,1,4.3478260869565215,67.75
14164,347544,32,0,16676,25,7,50.0,0.0
14165,6080448,485,0,274395,227,258,2.0,0.0
14166,3002316,342,921840,312373,153,189,1.0526315789473684,0.0
14167,444,65,0,165,33,32,50.0,0.0
14168,22440,30,0,3357,25,5,100.0,0.0
14169,28116,15,28116,2232,15,0,5.882352941176471,72.08
14170,6237720,5137,0,618529,2986,2151,1.0,2.95
14171,6912,394,5832,745,156,238,1.1494252873563218,90.0
14172,1188,3,1188,724,3,0,20.0,97.0
14173,816,99,816,69,75,24,1.4492753623188406,26.45
14174,54264,2,54264,186,1,1,33.333333333333336,28.08
14175,3360,4,3360,177,2,2,33.333333333333336,63.7
14176,228,6,228,86,4,2,33.333333333333336,99.49
14177,1524,0,1524,0,0,0,50.0,99.6
14178,115608,10,115608,15391,10,0,9.090909090909092,66.46
14179,3491568,347,3262092,42227,229,118,1.0,0.0
14180,14580,75,14580,1108,73,2,1.694915254237288,29.48
14181,1547004,11,1547004,264457,11,0,10.0,97.34
14182,4488,13,4488,1663,13,0,7.142857142857143,4.52
14183,1128,6,0,912,5,1,100.0,0.0
14184,3552,242,2436,421,193,49,1.0,30.57
14185,1837092,62,176520,96856,60,2,8.333333333333334,98.67
14186,2244,27,2244,504,21,6,6.25,51.04
14187,158880,4,158880,906,4,0,25.0,89.35
14188,61596,52,0,2634,43,9,100.0,0.0
14189,5270124,900,0,206563,442,458,1.0526315789473684,4.31
14190,20136,275,0,3126,158,117,100.0,0.0
14191,10860,46,0,2263,36,10,100.0,0.0
14192,132096,266,0,6573,155,111,33.333333333333336,0.0
14193,1092,0,1092,0,0,0,100.0,100.0
14194,258708,37,258708,13824,37,0,2.7777777777777777,83.74
14195,1296,186,0,572,174,12,100.0,0.0
14196,12828,40,0,1769,29,11,100.0,0.0
14197,1644,12,1644,667,11,1,9.090909090909092,60.91
14198,1256916,833,236574,53769,583,250,1.0,54.12
14199,19860,386,0,4354,190,196,100.0,0.0
14200,3430392,27,2904,130799,22,5,5.882352941176471,81.46
14201,174444,36,174444,4757,32,4,3.225806451612903,14.01
14202,5655420,2455,1810068,238236,1005,1450,1.0,0.0
14203,1267320,983,766446,351833,983,0,1.0,32.42
14204,2090988,29,69804,350859,21,8,7.142857142857143,85.9
14205,76464,5,76464,5932,5,0,16.666666666666668,97.93
14206,4870152,58,0,719096,46,12,25.0,0.0
14207,69696,43,0,3454,29,14,100.0,0.0
14208,148824,7,148824,5667,6,1,20.0,4.08
14209,3456,20,3456,365,19,1,5.555555555555555,75.85
14210,331272,37,250032,199130,32,5,3.8461538461538463,75.4
14211,75120,32,75120,1609,26,6,7.142857142857143,78.45
14212,2208,16,2208,624,16,0,6.666666666666667,83.05
14213,170172,59,170172,27349,53,6,2.1739130434782608,59.21
14214,1536,11,1536,535,11,0,8.333333333333334,87.65
14215,13740,45,0,2779,36,9,100.0,0.0
14216,4884,51,4884,1102,50,1,4.545454545454546,48.41
14217,2692080,21,10944,128572,19,2,5.555555555555555,78.48
14218,3649140,347,3648948,21999,209,138,1.0,0.0
14219,274932,3,0,92992,2,1,100.0,0.0
14220,9924,23,9924,447,21,2,5.555555555555555,76.76
14221,18492,65,0,2400,53,12,2.5,0.0
14222,11976,22,3252,854,19,3,5.882352941176471,78.27
14223,8592,42,8592,2196,34,8,4.545454545454546,66.86
14224,768,13,768,274,9,4,16.666666666666668,39.29
14225,77952,23,77952,1305,19,4,5.882352941176471,80.57
14226,1971684,25,63036,81949,21,4,7.6923076923076925,16.45
14227,4493844,51,0,108816,43,8,25.0,0.0
14228,8904,35,0,1614,29,6,100.0,0.0
14229,162420,28,4092,40704,23,5,6.666666666666667,74.78
14230,20772,5,20772,422,5,0,16.666666666666668,72.53
14231,20712,28,20712,1787,26,2,4.545454545454546,71.39
14232,49128,396,0,4779,229,167,100.0,0.0
14233,156,3,156,76,3,0,20.0,66.57
14234,5436,12,5436,1032,10,2,11.11111111111111,98.02
14235,4704,38,0,1266,34,4,100.0,0.0
14236,7968,21,7968,402,20,1,5.555555555555555,77.14
14237,2172,14,2172,452,13,1,7.6923076923076925,49.49
14238,71424,45,0,2534,29,16,100.0,0.0
14239,1560,29,1212,687,23,6,14.285714285714286,51.0
14240,158268,1,158268,1200,1,0,33.333333333333336,99.0
14241,3030324,828,1682460,159250,458,370,1.492537313432836,0.0
14242,6084,41,0,1674,34,7,100.0,0.0
14243,4783728,115,3037152,1479903,49,66,1.0,0.0
14244,76512,20,76512,871,17,3,7.6923076923076925,51.47
14245,819672,39,504,21200,21,18,20.0,94.42
14246,6402828,1781,0,2310294,1090,691,1.0,1.98
14247,15036,31,15036,1412,26,5,5.882352941176471,75.54
14248,552,6,552,214,6,0,12.5,88.64
14249,188004,50,188004,29668,47,3,2.2222222222222223,30.3
14250,624,0,624,0,0,0,50.0,80.2
14251,86040,11,86040,4243,11,0,11.11111111111111,67.28
14252,30420,356,0,5107,172,184,100.0,0.0
14253,792,15,312,174,10,5,12.5,92.51
14254,36252,49,0,1635,33,16,100.0,0.0
14255,20472,28,20472,1495,24,4,7.142857142857143,13.74
14256,2310132,3,2310132,328,1,2,5.882352941176471,32.03
14257,4267896,573,4267416,20098,350,223,1.0,5.0
14258,6063264,50,0,1171079,42,8,5.882352941176471,0.0
14259,816,5,816,105,5,0,14.285714285714286,95.54
14260,1081836,37,0,31761,31,6,50.0,0.0
14261,19536,69,0,2538,60,9,100.0,0.0
14262,5180592,107,5180592,56731,45,62,7.6923076923076925,74.98
14263,1020,144,0,200,124,20,50.0,0.0
14264,7116,22,7116,1198,19,3,8.333333333333334,61.95
14265,86184,15,86184,8543,13,2,7.142857142857143,87.13
14266,324,12,324,19,12,0,7.142857142857143,98.8
14267,1368,11,1368,1131,5,6,25.0,98.14
14268,3655236,71,0,860971,34,37,2.7777777777777777,0.0
14269,20988,292,0,3229,173,119,100.0,0.0
14270,48492,33,48492,1764,18,15,20.0,62.16
14271,2679300,110,2679300,61720,48,62,7.142857142857143,0.0
14272,168,1,168,24,1,0,33.333333333333336,74.81
14273,2148,12,2148,1195,6,6,20.0,97.83
14274,828,2,828,420,1,1,50.0,55.59
14275,6237336,579,838788,760716,345,234,1.0,9.24
14276,636,195,0,126,112,83,50.0,0.0
14277,324,6,324,36,4,2,33.333333333333336,92.47
14278,1596,188,1572,1290,135,53,1.0416666666666667,39.69
14279,9324,83,9324,324,61,22,2.857142857142857,50.91
14280,1164,35,1164,1033,21,14,5.555555555555555,63.01
14281,6132,18,6132,719,15,3,12.5,56.57
14282,4200,16,0,1551,13,3,50.0,97.99
14283,20640,16,20640,303,13,3,11.11111111111111,86.64
14284,21960,6,21960,4226,3,3,50.0,76.74
14285,1008,16,1008,518,15,1,6.25,30.27
14286,445068,239,0,4055,119,120,3.125,7.0
14287,36240,186,36240,6240,150,36,1.0869565217391304,10.14
14288,4392,45,0,888,41,4,100.0,100.0
14289,0,0,0,0,0,0,100.0,0.0
14290,3756,159,0,971,118,41,100.0,0.0
14291,6448200,60,0,223857,50,10,50.0,1.0
14292,184008,352,0,7337,205,147,100.0,0.0
14293,96,1,0,96,0,1,100.0,0.0
14294,5028420,82,0,103961,52,30,1.5873015873015872,0.0
14295,15216,143,15216,131,109,34,1.020408163265306,19.33
14296,2301972,25,7248,186021,19,6,9.090909090909092,75.69
14297,3384,34,372,157,28,6,3.8461538461538463,46.28
14298,12792,89,0,879,65,24,100.0,0.0
14299,1188,70,1188,188,64,6,2.4390243902439024,58.87
14300,5241960,510,1257780,449437,213,297,2.127659574468085,0.0
14301,5429628,1018,3334896,129273,505,513,1.2195121951219512,0.0
14302,6416568,1480,923544,660066,830,650,1.0,0.0
14303,780,150,780,111,112,38,1.1494252873563218,31.24
14304,648,69,648,164,52,17,2.631578947368421,23.3
14305,3457584,318,1966332,25454,170,148,1.3888888888888888,0.0
14306,2941128,50,2941128,16185,20,30,10.0,68.06
14307,77232,472,0,7649,260,212,1.0,0.0
14308,3262740,11,0,297848,7,4,16.666666666666668,0.0
14309,312,69,0,140,35,34,100.0,0.0
14310,6029496,1696,4293144,80863,923,773,1.0,0.0
14311,4002720,347,516,20940,222,125,1.0,12.01
14312,5815440,2994,129576,159212,1553,1441,1.0,0.0
14313,6343632,4189,930120,406386,2528,1661,1.0,0.0
14314,2460,84,2460,1335,66,18,1.7241379310344829,38.43
14315,18324,25,18324,1705,21,4,11.11111111111111,54.82
14316,488460,187,330792,87331,162,25,1.0,4.01
14317,5755692,58,0,1582339,38,20,20.0,75.0
14318,12612,25,12612,1910,24,1,6.25,72.9
14319,3384096,61,0,258919,51,10,25.0,0.0
14320,5271972,1189,3347652,36494,769,420,1.0,0.0
14321,5916924,60,0,1592710,37,23,25.0,75.0
14322,60,7,36,36,4,3,50.0,96.0
14323,48012,23,48012,1625,22,1,9.090909090909092,32.62
14324,4976712,60,0,108060,49,11,50.0,0.0
14325,48732,0,48732,0,0,0,100.0,100.0
14326,1704,11,0,556,9,2,100.0,0.0
14327,1437456,695,761652,58963,507,188,1.0,56.5
14328,1031280,51,0,39136,45,6,50.0,0.0
14329,3839088,645,0,199204,335,310,1.2345679012345678,0.0
14330,3480,21,3480,1332,19,2,8.333333333333334,85.92
14331,6059604,686,172980,247547,370,316,1.3333333333333333,0.0
14332,2472,25,2472,1073,18,7,9.090909090909092,73.39
14333,19752,29,7608,3221,24,5,5.2631578947368425,69.96
14334,6373092,26,10980,736580,21,5,8.333333333333334,97.37
14335,783840,17,783840,261805,17,0,6.666666666666667,55.24
14336,9624,24,9624,1440,21,3,7.6923076923076925,17.12
14337,780,6,180,178,5,1,16.666666666666668,92.77
14338,4320,26,4320,1328,23,3,8.333333333333334,85.93
14339,276,3,0,176,3,0,16.666666666666668,34.92
14340,45108,42,0,3797,36,6,100.0,0.0
14341,38364,35,0,5690,32,3,100.0,100.0
14342,9960,22,9960,394,20,2,5.555555555555555,78.22
14343,5196,20,5196,1069,18,2,8.333333333333334,67.65
14344,6173016,52,0,372300,46,6,50.0,0.0
14345,953244,216,0,13029,140,76,50.0,0.0
14346,3391884,38,71988,184642,31,7,5.2631578947368425,86.64
14347,12360,29,12360,1236,24,5,6.25,76.62
14348,10092,23,10092,2917,21,2,4.761904761904762,44.87
14349,4224,18,4074,859,16,2,8.333333333333334,38.32
14350,5124,35,0,763,34,1,100.0,100.0
14351,6648,22,6648,394,21,1,5.555555555555555,74.91
14352,1668,4,1668,474,3,1,25.0,97.63
14353,60852,17,60852,5404,17,0,11.11111111111111,59.0
14354,708,5,708,244,4,1,25.0,93.77
14355,1168848,82,0,43915,68,14,100.0,0.0
14356,6228,54,0,1689,45,9,100.0,0.0
14357,58272,27,0,2962,22,5,100.0,0.0
14358,1284,15,1284,646,9,6,20.0,90.41
14359,17160,29,17136,1637,26,3,4.3478260869565215,72.83
14360,6000,287,0,2824,139,148,1.6129032258064515,0.0
14361,41280,300,0,3764,174,126,100.0,0.0
14362,6300,48,0,1205,45,3,100.0,100.0
14363,2122860,24,281124,111978,10,14,7.142857142857143,0.0
14364,7572,44,7572,1510,35,9,4.166666666666667,53.01
14365,8376,16,8376,1302,15,1,7.6923076923076925,0.78
14366,7404,11,7404,6974,11,0,8.333333333333334,58.57
14367,21576,22,7092,1446,20,2,5.555555555555555,78.88
14368,348,35,264,55,35,0,2.7777777777777777,45.04
14369,1668,2,0,1164,1,1,100.0,0.0
14370,1858452,49,0,116197,40,9,33.333333333333336,0.0
14371,247812,71,247812,78188,60,11,2.9411764705882355,22.09
14372,60708,421,0,3757,244,177,100.0,0.0
14373,8736,75,0,2256,64,11,100.0,0.0
14374,9360,23,9360,409,22,1,5.0,74.77
14375,936,11,0,392,8,3,100.0,0.0
14376,170124,42,0,8668,38,4,100.0,100.0
14377,16560,37,16560,3213,30,7,5.0,92.71
14378,153012,25,7404,6746,23,2,5.2631578947368425,79.24
14379,11472,62,0,1988,55,7,100.0,0.0
14380,6506760,2463,896052,1043478,1516,947,1.0,0.0
14381,5316,27,5316,899,22,5,7.142857142857143,91.14
14382,5256,39,5256,511,37,2,7.6923076923076925,71.15
14383,2776236,36,0,111391,31,5,50.0,0.0
14384,1644924,233,0,24079,157,76,50.0,0.0
14385,1195668,112,372,32177,83,29,1.694915254237288,38.19
14386,185832,64,185832,63236,55,9,2.631578947368421,45.68
14387,23172,15,23172,692,14,1,11.11111111111111,71.24
14388,19356,347,0,4811,189,158,100.0,0.0
14389,51420,71,51420,676,39,32,4.3478260869565215,70.83
14390,133308,26,133308,60652,26,0,7.142857142857143,99.38
14391,16584,30,16584,906,25,5,5.882352941176471,76.47
14392,6540,78,6540,190,68,10,1.7857142857142858,0.0
14393,4426440,205,4426440,6673,139,66,1.1494252873563218,16.63
14394,4728,41,4332,1720,34,7,5.0,52.97
14395,27228,2,0,24498,2,0,12.5,5.0
14396,236784,491,0,12725,286,205,100.0,0.0
14397,45036,37,45036,1682,32,5,7.142857142857143,12.32
14398,672,26,672,294,24,2,4.3478260869565215,62.48
14399,2268,43,2268,667,41,2,2.5641025641025643,49.34
14400,31920,11,804,14321,6,5,33.333333333333336,98.11
14401,1376604,184,1464,8426,143,41,1.0,31.0
14402,6437532,549,0,226090,274,275,1.2048192771084338,0.0
14403,4668,15,4668,1434,15,0,7.142857142857143,26.86
14404,16560,467,0,6307,225,242,1.0,0.0
14405,2796,47,2568,767,45,2,2.631578947368421,55.98
14406,14832,42,14832,2520,37,5,2.7777777777777777,66.58
14407,68772,444,0,4353,262,182,100.0,0.0
14408,348564,81,348564,85075,75,6,1.5384615384615383,37.84
14409,768,1,768,420,1,0,25.0,49.66
14410,62748,11,55410,54802,10,1,14.285714285714286,97.24
14411,1122948,71,0,246188,71,0,1.408450704225352,0.0
14412,5382360,425,0,949948,249,176,1.0638297872340423,0.0
14413,84624,36,84624,19441,22,14,7.6923076923076925,58.13
14414,5356056,1263,4565700,124040,526,737,1.3888888888888888,65.48
14415,468,1,468,324,1,0,50.0,0.0
14416,276,49,276,108,29,20,4.545454545454546,58.04
14417,6539148,10438,929016,1335167,6000,4438,1.0,0.0
14418,312,5,0,230,3,2,100.0,99.99
14419,16860,26,16860,2625,23,3,9.090909090909092,20.61
14420,6095988,115,6095988,153778,51,64,5.0,79.66
14421,169212,610,0,9743,351,259,20.0,0.0
14422,1152,30,1152,403,22,8,5.0,65.91
14423,2820,43,2820,1661,39,4,2.5641025641025643,34.74
14424,44016,17,44016,945,16,1,8.333333333333334,59.24
14425,19884,10,19884,8805,6,4,16.666666666666668,93.66
14426,1032,4,0,576,2,2,50.0,99.99
14427,22368,33,22368,1404,27,6,5.555555555555555,74.54
14428,108,3,108,52,3,0,20.0,54.87
14429,144,19,96,19,18,1,5.0,38.09
14430,19596,307,0,3791,190,117,100.0,0.0
14431,3636,8,0,1071,6,2,100.0,0.0
14432,1512,1,1512,1224,1,0,50.0,97.03
14433,120,2,120,30,1,1,100.0,100.0
14434,312,1,312,36,1,0,50.0,54.87
14435,6547752,3017,0,1499731,1439,1578,1.0,0.0
14436,2592732,142,2592732,80045,89,53,7.142857142857143,0.0
14437,65340,2,65340,174,2,0,25.0,63.22
14438,4413516,112,1019652,1680969,54,58,1.0,0.0
14439,7680,23,7680,1113,22,1,8.333333333333334,69.14
14440,4080,2,4080,324,2,0,50.0,90.5
14441,3690168,119,0,69375,52,67,6.25,3.0
14442,2607624,434,2607624,54211,240,194,1.0,50.98
14443,163536,36,163536,882,28,8,100.0,0.0
14444,52656,91,0,6838,79,12,50.0,0.0
14445,30180,14,30180,970,13,1,11.11111111111111,29.4
14446,1181676,17,0,375813,13,4,25.0,0.0
14447,622956,17,5232,73960,15,2,14.285714285714286,75.74
14448,6517140,5901,1417500,915989,3742,2159,1.0,0.31
14449,255900,181,250656,81976,137,44,1.25,2.32
14450,9048,347,0,3111,212,135,100.0,0.0
14451,8772,15,8772,1251,9,6,50.0,85.62
14452,54768,90,54768,2759,75,15,1.3888888888888888,15.13
14453,2040,18,2040,765,16,2,8.333333333333334,64.02
14454,4783404,36,52056,183250,29,7,7.142857142857143,98.93
14455,78540,251,0,17975,179,72,100.0,0.0
14456,30288,351,0,5232,209,142,100.0,0.0
14457,18204,38,18204,1795,31,7,5.2631578947368425,76.77
14458,26148,47,18294,2169,39,8,6.25,13.8
14459,347076,500,0,10961,307,193,25.0,0.0
14460,31608,33,492,1113,27,6,3.703703703703704,40.37
14461,1527240,49,1527240,1776,30,19,20.0,0.0
14462,3540,1,3540,48,1,0,33.333333333333336,93.61
14463,963396,0,963396,0,0,0,100.0,100.0
14464,174816,34,174816,13549,29,5,7.6923076923076925,75.64
14465,9492,8,9492,1968,8,0,11.11111111111111,0.0
14466,10620,27,10620,1217,22,5,6.25,72.25
14467,1709496,31,7248,102197,27,4,5.0,74.78
14468,6251160,67,0,356292,56,11,25.0,0.0
14469,3211104,307,1045032,22862,188,119,1.6129032258064515,0.0
14470,432,8,312,148,7,1,12.5,91.31
14471,17316,21,17316,1027,18,3,7.6923076923076925,36.12
14472,76032,44,0,10452,36,8,50.0,0.0
14473,966168,28,11412,35229,26,2,5.0,72.23
14474,4723368,49,0,612732,41,8,25.0,0.0
14475,2434860,70,0,38931,62,8,50.0,0.0
14476,13524,21,13524,473,21,0,5.2631578947368425,78.84
14477,11424,18,11424,1116,15,3,7.6923076923076925,89.58
14478,8964,23,8964,686,20,3,6.25,78.75
14479,1968,6,0,1024,4,2,100.0,0.0
14480,588,14,588,239,7,7,100.0,100.0
14481,4644,11,4644,844,10,1,10.0,0.31
14482,612,97,312,140,71,26,2.4390243902439024,80.86
14483,506640,30,506640,13538,26,4,4.3478260869565215,36.76
14484,3247488,66,0,187291,55,11,12.5,0.0
14485,20904,502,0,6732,273,229,100.0,0.0
14486,3129612,57,0,73766,47,10,100.0,0.0
14487,60720,62,0,3280,54,8,33.333333333333336,0.0
14488,516,24,516,396,22,2,4.761904761904762,84.93
14489,6216984,6,0,1142078,3,3,20.0,7.5
14490,253236,39,253236,38124,36,3,2.9411764705882355,23.52
14491,1068,31,1068,409,24,7,7.6923076923076925,62.15
14492,4389360,384,4389072,715142,249,135,2.3255813953488373,0.0
14493,25752,40,25752,3407,31,9,6.666666666666667,72.97
14494,80256,18,80256,6252,17,1,11.11111111111111,69.03
14495,6565368,48,0,265212,40,8,100.0,0.0
14496,3255756,214,0,482312,101,113,5.555555555555555,0.0
14497,14592,10,0,1759,8,2,33.333333333333336,0.0
14498,1542096,2115,1404828,13297,1174,941,1.0,0.0
14499,624,19,624,120,19,0,5.0,73.47
14500,5459556,487,5459556,88041,228,259,1.639344262295082,0.0
14501,2465928,323,1320036,108829,194,129,3.225806451612903,69.96
14502,780,19,228,163,14,5,9.090909090909092,51.47
14503,2676048,324,2676048,25099,161,163,1.818181818181818,73.08
14504,3348,12,0,597,10,2,50.0,0.0
14505,38256,27,38256,1423,24,3,8.333333333333334,14.82
14506,8748,26,8748,1020,23,3,9.090909090909092,46.19
14507,822036,117,716814,84013,92,25,1.6666666666666667,12.48
14508,996,32,0,178,28,4,100.0,100.0
14509,16944,42,0,2288,36,6,100.0,0.0
14510,75576,398,0,31585,225,173,1.0,0.0
14511,2995680,108,2858364,1515955,65,43,16.666666666666668,99.74
14512,1260,39,1260,179,37,2,2.9411764705882355,53.05
14513,1140,10,1140,292,4,6,33.333333333333336,98.8
14514,70008,206,0,2120,142,64,100.0,0.0
14515,876,0,876,0,0,0,100.0,100.0
14516,2998128,45,0,1117049,17,28,1.0,0.34
14517,44268,180,36492,3774,134,46,1.2820512820512822,4.94
14518,3851280,46,0,92122,35,11,33.333333333333336,0.0
14519,6282432,1254,2427012,1662288,585,669,1.0,0.0
14520,4755636,517,0,76686,170,347,3.703703703703704,0.0
14521,528,24,528,397,20,4,7.142857142857143,94.06
14522,23772,8,9000,5797,6,2,100.0,0.0
14523,8448,0,8448,0,0,0,100.0,100.0
14524,553572,0,553572,0,0,0,33.333333333333336,85.0
14525,420,7,420,15,7,0,11.11111111111111,65.3
14526,576,12,0,260,10,2,100.0,0.0
14527,132,10,132,19,8,2,11.11111111111111,52.86
14528,552,9,552,172,6,3,25.0,97.51
14529,3124920,270,0,16735,173,97,33.333333333333336,0.0
14530,1788,52,1788,1194,46,6,2.4390243902439024,27.71
14531,3072,30,3072,81,17,13,14.285714285714286,63.0
14532,301524,19,272148,30081,19,0,5.555555555555555,30.83
14533,144072,13,144072,6182,11,2,8.333333333333334,87.46
14534,219672,24,17316,44709,19,5,10.0,15.34
14535,2063544,16,1771974,46585,16,0,6.25,9.67
14536,1692,79,0,556,62,17,100.0,0.0
14537,155868,100,155868,40926,86,14,1.694915254237288,4.18
14538,4909704,67,0,306462,39,28,3.703703703703704,0.0
14539,59988,374,0,5412,212,162,1.0,0.0
14540,11856,249,0,3325,126,123,100.0,0.0
14541,43236,19,43236,1528,18,1,6.666666666666667,95.01
14542,6618720,10424,786168,705716,5945,4479,1.0,0.0
14543,888,39,888,226,27,12,4.3478260869565215,70.34
14544,3107880,298,2044872,150960,154,144,3.333333333333333,0.0
14545,6100236,651,0,82173,361,290,2.631578947368421,0.0
14546,4464252,70,4463556,146179,36,34,4.545454545454546,0.0
14547,8748,130,0,2495,84,46,100.0,0.0
14548,56184,11,56184,139,9,2,14.285714285714286,71.43
14549,22404,326,0,4538,188,138,1.0,0.0
14550,3786564,18,3114456,436438,9,9,11.11111111111111,58.91
14551,5279952,3,0,1760652,2,1,50.0,5.0
14552,6630660,7194,783510,2167639,4281,2913,1.0,0.88
14553,1212,0,1212,0,0,0,100.0,100.0
14554,6091680,2436,2489982,191233,1277,1159,1.0,0.0
14555,7272,7,3192,1889,4,3,20.0,55.11
14556,6339204,638,4469364,526822,272,366,1.851851851851852,0.0
14557,3564,2,3564,1800,1,1,50.0,98.09
14558,5073372,638,0,191209,333,305,1.3333333333333333,0.0
14559,5712,23,5712,864,20,3,5.555555555555555,49.58
14560,264,2,144,180,2,0,33.333333333333336,73.18
14561,2892,12,2892,984,12,0,11.11111111111111,37.55
14562,2687208,54,2687208,35309,30,24,4.545454545454546,39.2
14563,104700,61,0,5222,47,14,50.0,0.0
14564,50928,9,50928,296,7,2,20.0,67.58
14565,702468,260,0,43119,114,146,4.3478260869565215,0.0
14566,41592,21,41592,1202,17,4,7.142857142857143,77.12
14567,67200,46,67200,5734,34,12,3.333333333333333,28.17
14568,1505340,757,345206,41219,548,209,1.0,36.3
14569,9840,26,9840,800,26,0,4.3478260869565215,75.6
14570,2679732,0,2679732,0,0,0,10.0,36.95
14571,1464,13,1464,537,11,2,10.0,68.56
14572,25668,48,0,2422,41,7,100.0,0.0
14573,5880,37,0,1369,31,6,100.0,0.0
14574,1404,12,1404,904,9,3,14.285714285714286,83.23
14575,5230020,976,0,55627,540,436,1.0,0.0
14576,241788,2,0,121146,1,1,100.0,0.0
14577,70236,32,70236,9178,28,4,3.571428571428572,58.85
14578,10032,23,10032,965,18,5,9.090909090909092,69.93
14579,228,32,228,118,16,16,12.5,72.02
14580,197340,46,132276,46881,37,9,5.555555555555555,41.88
14581,19692,14,19692,747,13,1,9.090909090909092,50.0
14582,14004,52,0,3767,42,10,100.0,0.0
14583,471264,232,0,6474,142,90,1.3333333333333333,0.0
14584,25860,25,13404,1873,23,2,5.0,71.95
14585,24924,276,0,3383,183,93,1.1363636363636365,0.0
14586,2388,10,2388,408,10,0,12.5,0.0
14587,5893320,17,2916588,352082,7,10,7.142857142857143,65.39
14588,4382424,140,261828,112110,134,6,1.6666666666666667,84.91
14589,228,2,228,126,1,1,100.0,100.0
14590,111156,45,111156,20510,42,3,2.702702702702702,50.25
14591,2520840,590,0,26006,375,215,25.0,0.0
14592,3107484,67,0,50362,59,8,25.0,0.0
14593,19044,361,0,4008,168,193,100.0,0.0
14594,4044,17,4044,580,17,0,7.142857142857143,48.49
14595,6214812,61,6214812,7366,27,34,8.333333333333334,86.24
14596,43416,46,0,4555,35,11,50.0,99.0
14597,6194292,102,0,1845583,84,18,1.4705882352941178,0.0
14598,324,54,324,114,40,14,2.857142857142857,48.88
14599,1725600,1420,1465956,7507,634,786,8.333333333333334,60.44
14600,6215484,207,2034828,2461233,81,126,1.0,0.0
14601,38436,18,38436,988,16,2,9.090909090909092,15.01
14602,12612,25,12612,533,23,2,4.761904761904762,71.76
14603,2148,19,2148,776,18,1,8.333333333333334,47.57
14604,6792,49,0,1855,42,7,100.0,0.0
14605,47376,6,0,9218,3,3,50.0,99.05
14606,1380,15,1380,478,13,2,9.090909090909092,59.01
14607,1476,16,1476,288,14,2,14.285714285714286,0.0
14608,6641820,123,0,2133967,102,21,20.0,0.0
14609,10968,23,10968,493,21,2,5.2631578947368425,71.41
14610,39732,23,39732,1604,20,3,7.142857142857143,87.87
14611,5004588,753,3913044,19523,410,343,1.0,0.0
14612,13068,30,0,1277,24,6,100.0,0.0
14613,20160,26,20160,1363,21,5,8.333333333333334,77.31
14614,96192,44,0,17815,35,9,25.0,0.0
14615,5484,24,5484,1353,21,3,6.25,0.0
14616,8316,21,8316,381,19,2,5.882352941176471,74.9
14617,18336,22,18336,511,20,2,5.2631578947368425,74.88
14618,5610336,154,0,188242,72,82,5.555555555555555,4.0
14619,3900,40,0,1326,34,6,100.0,0.0
14620,6641664,9091,2690940,282195,5026,4065,1.0638297872340423,0.0
14621,8508,20,8508,502,19,1,5.555555555555555,73.59
14622,5748,24,5748,637,22,2,6.666666666666667,0.0
14623,5724,8,0,879,6,2,33.333333333333336,0.0
14624,1573128,34,0,49055,30,4,50.0,0.0
14625,223008,10,223008,66078,4,6,33.333333333333336,85.82
14626,16296,22,16296,2020,19,3,9.090909090909092,60.61
14627,2160,14,2160,853,13,1,9.090909090909092,60.24
14628,14832,40,14832,2358,34,6,4.3478260869565215,64.08
14629,5604,48,0,1444,41,7,100.0,0.0
14630,8580,13,0,1004,10,3,50.0,0.0
14631,1776,36,0,774,31,5,50.0,0.0
14632,2664,15,2664,652,13,2,10.0,80.69
14633,82320,29,82320,5617,26,3,11.11111111111111,52.95
14634,259872,45,259872,27296,41,4,2.5641025641025643,35.27
14635,1356852,25,1356852,104589,11,14,16.666666666666668,91.68
14636,399192,30,31776,43218,26,4,7.6923076923076925,14.14
14637,247884,9,247884,62458,9,0,100.0,0.0
14638,6162576,78,6162576,232758,36,42,2.380952380952381,44.66
14639,6592848,53,0,126073,45,8,50.0,0.0
14640,2148,11,2148,522,8,3,16.666666666666668,0.0
14641,34224,451,0,5162,210,241,100.0,0.0
14642,1134768,73,0,48777,64,9,3.8461538461538463,0.0
14643,95736,6,312,16636,5,1,16.666666666666668,63.79
14644,360,5,360,180,4,1,33.333333333333336,96.56
14645,648,15,648,154,15,0,5.882352941176471,85.99
14646,124080,7,124080,10681,7,0,12.5,96.57
14647,540,55,540,109,53,2,2.702702702702702,69.88
14648,192,1,192,0,1,0,20.0,75.5
14649,624,111,0,117,106,5,1.0,0.0
14650,343944,6,343944,9218,5,1,25.0,88.86
14651,259152,6,0,130120,3,3,100.0,0.0
14652,2772,11,2772,1122,11,0,11.11111111111111,85.02
14653,5463072,396,0,233199,222,174,1.8867924528301887,0.0
14654,312984,8,312984,3798,4,4,16.666666666666668,0.0
14655,1630584,419,0,55806,249,170,33.333333333333336,0.0
14656,163368,138,0,66105,120,18,2.702702702702702,0.0
14657,12036,22,12036,895,19,3,12.5,19.45
14658,2903976,163,1511160,19476,108,55,2.7777777777777777,0.0
14659,192,11,192,45,5,6,50.0,89.36
14660,6419556,1338,2392818,104252,647,691,1.0,0.0
14661,22572,81,0,4150,58,23,2.5641025641025643,0.0
14662,744,4,744,123,4,0,16.666666666666668,82.01
14663,828,10,108,139,7,3,50.0,99.97
14664,1297260,7230,0,181907,2997,4233,100.0,0.0
14665,5149212,587,0,104683,281,306,1.5625,8.85
14666,2868,281,0,750,234,47,1.0,11.0
14667,5996496,271,0,74112,127,144,1.492537313432836,0.07
14668,960,24,936,652,21,3,4.761904761904762,43.42
14669,348420,10,6468,36022,10,0,14.285714285714286,32.34
14670,1538940,18,25812,298479,14,4,14.285714285714286,90.91
14671,4380,9,4380,4024,9,0,9.090909090909092,43.86
14672,660,11,660,531,10,1,9.090909090909092,81.61
14673,10584,210,0,3449,106,104,100.0,0.0
14674,7596,2,7596,756,2,0,50.0,77.49
14675,89700,12,89700,664,12,0,8.333333333333334,35.06
14676,6637260,1561,4275594,1041780,775,786,1.0,1.62
14677,0,0,0,0,0,0,50.0,60.78
14678,860820,377,0,15587,196,181,1.6129032258064515,0.0
14679,9192,25,9192,2425,21,4,11.11111111111111,16.03
14680,2328,4,2328,348,3,1,100.0,100.0
14681,160692,1,160692,0,1,0,33.333333333333336,55.87
14682,6713928,13829,688877,1791577,6192,7637,1.0,0.0
14683,5509272,279,392652,198661,258,21,1.0416666666666667,93.12
14684,2244,6,2244,434,3,3,50.0,99.11
14685,444,12,444,210,10,2,12.5,80.06
14686,2400,25,2400,650,25,0,5.2631578947368425,15.21
14687,176100,6,176100,192,3,3,50.0,96.71
14688,2940,53,2940,2181,49,4,2.0408163265306123,57.89
14689,6392364,266,0,38139,190,76,1.0,0.0
14690,5602308,1950,4555656,77598,1013,937,1.0,0.0
14691,47940,267,26190,2791,69,198,1.851851851851852,46.48
14692,732,10,732,487,7,3,10.0,59.83
14693,5669748,529,0,135241,243,286,1.851851851851852,0.0
14694,24300,50,0,2368,41,9,100.0,0.0
14695,9876,8,9876,469,6,2,20.0,94.63
14696,6090168,63,0,263608,46,17,20.0,0.0
14697,6218352,428,4557852,114525,177,251,2.7777777777777777,0.0
14698,2925432,25,2925288,240794,13,12,6.666666666666667,0.0
14699,6642132,122,0,1014613,106,16,20.0,0.0
14700,605376,94,134790,87383,90,4,2.5,93.7
14701,26316,8,26316,1491,5,3,33.333333333333336,0.0
14702,5330712,328,0,35310,144,184,3.703703703703704,13.0
14703,3989400,151,0,94270,83,68,2.4390243902439024,9.5
14704,39840,14,39840,1300,13,1,9.090909090909092,0.0
14705,27276,169,0,2979,112,57,1.492537313432836,0.0
14706,4766160,1262,0,33671,688,574,1.0,0.0
14707,3108,23,0,1039,17,6,100.0,0.0
14708,4332,13,4332,1938,9,4,20.0,0.0
14709,3660,7,3660,3121,7,0,11.11111111111111,70.68
14710,425220,662,425220,4310,501,161,1.0,0.0
14711,9816,29,9816,561,17,12,10.0,83.7
14712,14496,12,14496,902,11,1,10.0,19.59
14713,3784956,49,259608,318899,23,26,6.25,61.82
14714,27132,188,0,6093,125,63,100.0,0.0
14715,26892,79,0,5040,52,27,100.0,0.0
14716,888,1,888,684,0,1,100.0,0.0
14717,5076,11,5076,1101,8,3,12.5,70.21
14718,6332112,18749,2539152,490956,12891,5858,1.0,10.0
14719,1812,3,1812,272,3,0,25.0,68.51
14720,2923188,86,2923188,30809,44,42,3.8461538461538463,71.16
14721,3129696,445,0,29379,213,232,2.380952380952381,0.0
14722,1272,13,1272,501,11,2,10.0,0.0
14723,49428,20,6504,3577,18,2,9.090909090909092,40.37
14724,6725208,24594,2092614,3176056,15231,9363,1.0,0.0
14725,3592548,711,703668,62663,525,186,1.0,14.86
14726,6369924,4369,0,1228820,2948,1421,1.0,0.0
14727,6022980,748,403442,59621,533,215,1.0,63.51
14728,20844,6,20844,1120,6,0,14.285714285714286,64.5
14729,528,6,0,256,4,2,50.0,0.0
14730,20196,314,0,4749,164,150,100.0,0.0
14731,25332,58,0,2998,47,11,50.0,0.0
14732,2448,25,2448,1344,20,5,9.090909090909092,69.29
14733,22752,26,22752,1518,25,1,4.545454545454546,75.31
14734,4560,2,4560,2004,1,1,50.0,0.0
14735,11640,20,11640,1760,18,2,7.6923076923076925,84.36
14736,683304,102,683304,348410,84,18,1.6129032258064515,60.21
14737,1812,7,1812,780,6,1,20.0,93.43
14738,75528,58,75528,4732,38,20,3.225806451612903,25.54
14739,6768,21,0,1259,17,4,100.0,100.0
14740,624,0,624,0,0,0,100.0,100.0
14741,936,10,936,270,8,2,14.285714285714286,47.87
14742,6625776,222,3743844,2582928,109,113,4.3478260869565215,0.0
14743,143532,74,0,14648,35,39,6.666666666666667,0.0
14744,8544,52,0,1813,44,8,100.0,0.0
14745,77412,4,0,25887,2,2,50.0,0.0
14746,396,52,396,55,46,6,2.2222222222222223,29.57
14747,24912,30,24912,1547,27,3,5.882352941176471,0.0
14748,94320,0,94320,0,0,0,50.0,95.0
14749,14988,22,14988,567,21,1,5.0,73.09
14750,3062052,13,0,1175856,9,4,16.666666666666668,0.0
14751,22344,241,0,3424,161,80,1.098901098901099,0.0
14752,6717984,1241,0,407109,669,572,1.0,0.0
14753,1054680,83,0,445264,68,15,5.882352941176471,0.0
14754,3893376,54,3893376,1594,54,0,1.7857142857142858,52.43
14755,86916,21,86916,1218,19,2,6.25,88.0
14756,544044,17,358200,45198,17,0,6.666666666666667,93.77
14757,46056,74,46056,34467,69,5,1.694915254237288,57.74
14758,5568,79,5568,710,67,12,1.6666666666666667,28.51
14759,1512,6,1512,460,3,3,33.333333333333336,0.0
14760,6682140,1426,0,209782,787,639,1.0526315789473684,7.0
14761,1304112,9,22800,145401,9,0,11.11111111111111,62.44
14762,4938492,32,22668,650689,28,4,4.761904761904762,71.49
14763,6760656,4068,1229100,1242150,2349,1719,1.0,0.0
14764,18636,26,18636,629,23,3,5.555555555555555,67.41
14765,358620,49,0,40722,39,10,50.0,0.0
14766,10632,24,10632,552,22,2,5.555555555555555,69.3
14767,60504,12,0,5901,10,2,25.0,0.0
14768,4608936,37,169164,244049,32,5,7.6923076923076925,31.09
14769,206328,21,206328,116898,4,17,33.333333333333336,99.34
14770,10560,19,10560,1122,17,2,7.6923076923076925,73.19
14771,1768428,46,0,40992,39,7,100.0,0.0
14772,3432,10,0,650,8,2,33.333333333333336,0.0
14773,2438676,39,0,151181,33,6,33.333333333333336,0.0
14774,4212,12,0,651,9,3,33.333333333333336,0.0
14775,5952204,17000,1616658,1569786,11574,5426,1.0,0.09
14776,354624,44,0,14628,30,14,100.0,0.0
14777,2499372,28,42792,103220,25,3,8.333333333333334,17.84
14778,1200,9,1200,262,8,1,11.11111111111111,0.0
14779,11868,3,11868,652,2,1,33.333333333333336,75.18
14780,2892,15,0,566,13,2,20.0,0.0
14781,3096,3,3096,1300,3,0,20.0,59.45
14782,3192,18,0,608,14,4,33.333333333333336,0.0
14783,6389028,66,0,663278,56,10,20.0,0.0
14784,121020,355,0,16814,215,140,1.0,4.0
14785,4303740,115,0,723218,97,18,25.0,0.0
14786,83424,1,83424,168,1,0,16.666666666666668,42.3
14787,2484,43,0,251,35,8,3.225806451612903,0.0
14788,4179336,66,1260,127496,48,18,2.380952380952381,49.54
14789,1596,2,1596,240,2,0,33.333333333333336,68.64
14790,832872,10,331260,132027,9,1,14.285714285714286,3.18
14791,3679884,113,3660648,140680,87,26,1.2658227848101269,10.0
14792,552,9,552,197,9,0,10.0,78.23
14793,37236,392,0,7777,196,196,100.0,0.0
14794,48312,61,48312,15176,43,18,3.333333333333333,57.14
14795,2759124,6,2759124,1280,4,2,16.666666666666668,27.23
14796,11556,7,0,4208,6,1,14.285714285714286,76.29
14797,6569268,125,0,92201,51,74,8.333333333333334,0.0
14798,192,24,192,69,10,14,20.0,61.57
14799,3675948,51,0,81185,44,7,50.0,0.0
14800,504,2,504,42,2,0,25.0,96.0
14801,120,29,120,39,17,12,7.6923076923076925,46.81
14802,48,12,48,8,10,2,10.0,48.53
14803,4890588,97,0,79266,54,43,3.4482758620689653,0.0
14804,372,7,372,66,6,1,14.285714285714286,67.34
14805,504,27,0,111,20,7,50.0,0.0
14806,456,29,456,201,17,12,7.142857142857143,82.43
14807,3859308,664,0,12904,364,300,1.1494252873563218,0.0
14808,58668,47,0,2846,34,13,100.0,0.0
14809,319980,165,165996,34956,141,24,1.25,3.3
14810,5331324,82,0,81349,34,48,33.333333333333336,0.0
14811,6642000,138,0,85424,75,63,3.225806451612903,2.0
14812,3968664,34,3968664,2280,24,10,4.3478260869565215,13.0
14813,6744,190,0,3520,129,61,1.2987012987012987,0.0
14814,1092,11,1092,440,8,3,16.666666666666668,94.23
14815,1164,3,1164,520,3,0,20.0,56.75
14816,204,20,132,46,16,4,6.666666666666667,43.8
14817,3072,30,2868,2446,28,2,3.571428571428572,71.85
14818,1848,2,1848,0,2,0,25.0,58.25
14819,90504,24,90504,1512,20,4,5.2631578947368425,83.54
14820,12372,182,0,2650,113,69,2.0,4.0
14821,168,1,168,0,1,0,33.333333333333336,78.1
14822,2976480,68,2976480,3253,50,18,2.5,56.08
14823,996,39,0,351,37,2,100.0,0.0
14824,1392,61,1392,963,45,16,2.702702702702702,41.29
14825,18144,277,0,4903,175,102,1.162790697674419,0.0
14826,6728472,1039,1599456,626615,546,493,1.4705882352941178,0.0
14827,828,3,828,172,3,0,25.0,85.27
14828,38352,105,7284,3471,77,28,1.7857142857142858,41.24
14829,6774540,11458,974400,1620804,6678,4780,1.0,2.98
14830,43200,5,43200,18813,3,2,50.0,99.11
14831,888,53,888,101,48,5,2.1739130434782608,30.81
14832,30804,264,0,3361,175,89,1.0,0.0
14833,1092,1,1092,936,1,0,50.0,90.0
14834,25188,16,25188,1291,15,1,11.11111111111111,49.89
14835,6490620,64,2117808,961998,54,10,2.0,5.0
14836,31296,15,31296,830,14,1,7.142857142857143,58.26
14837,6788304,1706,1784784,2662791,839,867,8.333333333333334,0.0
14838,15696,152,15696,6217,96,56,2.857142857142857,55.07
14839,6742992,4356,1082234,2511018,2320,2036,1.7241379310344829,0.0
14840,6924,127,0,2670,85,42,100.0,0.0
14841,1236,66,0,372,58,8,100.0,0.0
14842,437592,21,61644,42365,17,4,7.6923076923076925,74.42
14843,2772,18,2772,791,17,1,7.142857142857143,34.98
14844,2220072,145,2220072,13198,61,84,8.333333333333334,0.0
14845,178188,6,0,31918,5,1,25.0,99.0
14846,552,7,552,449,3,4,33.333333333333336,71.85
14847,3600,22,3600,1497,12,10,12.5,91.07
14848,4788,22,4788,4436,14,8,8.333333333333334,75.79
14849,5246928,414,0,204262,180,234,2.7777777777777777,0.72
14850,3840,19,3840,827,16,3,8.333333333333334,39.37
14851,88140,4,0,1503,3,1,50.0,99.35
14852,1044,15,1044,629,15,0,6.25,85.02
14853,5794692,523,4053324,78067,315,208,1.0,5.0
14854,6775380,1958,2321448,1453659,885,1073,1.0,2.71
14855,2184,4,2184,462,3,1,25.0,99.67
14856,6776508,181,0,1588254,97,84,1.96078431372549,0.0
14857,2160624,603,0,12649,294,309,1.7241379310344829,0.0
14858,6493728,1570,587016,183179,885,685,1.0,4.75
14859,74952,2,74952,186,2,0,25.0,97.81
14860,5884644,472,4649856,122999,262,210,1.639344262295082,0.0
14861,300,14,180,54,12,2,8.333333333333334,48.78
14862,264,4,228,120,3,1,33.333333333333336,57.23
14863,23016,43,0,2510,33,10,100.0,0.0
14864,17532,160,0,3965,100,60,1.694915254237288,0.0
14865,6783948,2882,0,189063,1509,1373,1.0,0.0
14866,5629968,49,0,619034,44,5,33.333333333333336,0.0
14867,319344,3,74760,108032,3,0,33.333333333333336,99.47
14868,6364188,330,0,105621,179,151,3.4482758620689653,0.0
14869,5310276,345,4981146,133727,172,173,1.8867924528301887,15.43
14870,1773768,352,0,29744,213,139,100.0,0.0
14871,20724,26,12456,1333,23,3,4.761904761904762,69.33
14872,132,11,132,3,11,0,7.6923076923076925,47.02
14873,334380,653,196794,46051,477,176,1.0,43.72
14874,6626436,215,0,120029,96,119,3.703703703703704,5.0
14875,13164,26,13164,1997,24,2,5.555555555555555,37.95
14876,523932,711,291474,44228,504,207,1.0,17.52
14877,27192,238,27192,9381,144,94,1.0,42.08
14878,36444,238,0,4616,151,87,1.0638297872340423,0.0
14879,125772,3,125772,16532,2,1,100.0,100.0
14880,15504,189,0,4268,105,84,1.694915254237288,0.0
14881,312,4,312,138,3,1,25.0,75.94
14882,6627084,650,4628052,75671,331,319,1.5151515151515151,0.0
14883,10548,22,9840,1300,19,3,5.882352941176471,77.12
14884,29448,24,29448,937,22,2,8.333333333333334,16.37
14885,71160,46,71160,11844,23,23,7.142857142857143,82.12
14886,105492,61,53106,3987,45,16,2.5,18.93
14887,936,0,936,0,0,0,50.0,64.0
14888,6114960,119,4779096,902774,82,37,1.0,0.0
14889,85764,71,0,6360,59,12,50.0,0.0
14890,28716,22,28716,1342,17,5,12.5,77.14
14891,12252,26,12144,998,24,2,4.761904761904762,73.25
14892,132,2,0,96,2,0,50.0,0.0
14893,6095796,88,0,532344,74,14,3.0303030303030303,0.0
14894,6806496,1051,0,824191,666,385,1.0,0.0
14895,86256,10,0,17420,8,2,50.0,0.0
14896,3912,21,3870,1531,19,2,7.142857142857143,45.78
14897,76896,15,76896,5232,14,1,7.6923076923076925,62.21
14898,19392,21,19392,531,20,1,5.2631578947368425,73.89
14899,5826096,117,0,435378,67,50,3.333333333333333,0.17
14900,5436,22,5436,496,21,1,5.555555555555555,76.26
14901,11112,12,0,1687,10,2,25.0,0.0
14902,5753088,68,0,1486642,53,15,16.666666666666668,0.0
14903,15516,158,0,3292,112,46,1.5625,0.0
14904,13680,22,13680,454,21,1,5.0,78.65
14905,1452,1,1452,828,1,0,50.0,70.17
14906,303936,48,0,8036,37,11,4.545454545454546,0.0
14907,2979120,8,2979120,28036,6,2,14.285714285714286,73.3
14908,6719244,1756,18624,77964,1023,733,1.0,1.8
14909,676752,77,0,89184,65,12,50.0,0.0
14910,96336,29,96336,8344,26,3,4.545454545454546,74.18
14911,4392,15,0,850,12,3,50.0,0.0
14912,264348,25,264348,18227,23,2,4.761904761904762,52.9
14913,19296,54,0,3356,45,9,100.0,0.0
14914,2256,23,0,824,20,3,50.0,0.0
14915,996636,67,203928,99267,59,8,2.631578947368421,44.17
14916,11136,1,11136,1944,1,0,50.0,85.31
14917,2208,20,0,586,18,2,25.0,0.0
14918,431916,50,0,10643,35,15,100.0,0.0
14919,5388,54,0,1102,45,9,50.0,0.0
14920,3708,0,3708,0,0,0,100.0,100.0
14921,2849736,402,2849736,37387,200,202,1.0,85.49
14922,209148,28,0,8869,22,6,4.761904761904762,0.0
14923,972888,79,0,20143,67,12,100.0,0.0
14924,240,138,240,128,94,44,1.3888888888888888,49.4
14925,696,17,0,456,12,5,100.0,0.0
14926,2839032,246,0,23070,122,124,5.2631578947368425,0.0
14927,132,24,132,29,22,2,4.545454545454546,32.97
14928,108,0,108,0,0,0,50.0,80.95
14929,5525616,211,4330224,647249,79,132,1.0,0.0
14930,73812,117,73812,6653,93,24,1.96078431372549,3.32
14931,168,2,168,102,2,0,25.0,75.14
14932,2252076,302,0,32973,162,140,3.4482758620689653,0.0
14933,4287036,14852,0,1465924,10403,4449,1.0,0.0
14934,261504,256,0,6985,153,103,1.25,0.0
14935,6872064,19488,731616,2049190,10435,9053,1.0,0.0
14936,156,6,156,24,3,3,50.0,77.84
14937,45516,15,45516,848,14,1,10.0,16.1
14938,564,149,564,198,87,62,1.851851851851852,50.33
14939,5520,107,0,2143,65,42,3.571428571428572,0.0
14940,4500,14,0,1467,9,5,100.0,0.0
14941,6324852,235,0,51593,143,92,1.5151515151515151,0.14
14942,4956,43,0,1215,38,5,100.0,0.0
14943,241716,68,241716,66422,53,15,2.5641025641025643,3.25
14944,2400,9,2400,1342,9,0,20.0,37.6
14945,96252,332,0,11996,206,126,1.0,4.0
14946,1824,76,0,460,68,8,100.0,0.0
14947,2673312,264,2673312,207052,142,122,3.703703703703704,5.07
14948,23232,351,0,4929,218,133,1.0,0.0
14949,70128,0,70128,0,0,0,50.0,90.0
14950,6876996,2471,0,3066667,1357,1114,1.0,1.13
14951,5368308,219,5368308,132486,128,91,1.098901098901099,10.0
14952,6542640,227,0,217954,142,85,1.7543859649122806,0.16
14953,48684,15,48684,1711,14,1,11.11111111111111,89.86
14954,1668,8,390,586,4,4,50.0,0.03
14955,7080,28,7080,784,26,2,4.3478260869565215,73.06
14956,16860,19,16860,260,18,1,5.2631578947368425,49.28
14957,6810636,4298,759960,729872,2682,1616,1.0,1.45
14958,468,16,468,144,14,2,6.666666666666667,71.73
14959,53124,177,0,4989,123,54,1.4285714285714286,0.0
14960,22920,146,0,999,123,23,100.0,0.0
14961,6168,58,0,1640,48,10,2.7777777777777777,0.0
14962,904440,8,904440,222,7,1,10.0,68.25
14963,6729612,935,4722756,112065,476,459,1.0,0.0
14964,372,18,372,188,12,6,9.090909090909092,60.52
14965,3650004,238,0,20349,127,111,2.857142857142857,0.0
14966,6597744,237,0,65827,106,131,3.333333333333333,0.0
14967,706500,146,0,10078,78,68,2.4390243902439024,0.0
14968,32112,18,32112,1130,17,1,6.666666666666667,89.97
14969,65412,5,65412,2116,4,1,33.333333333333336,74.88
14970,720,0,720,0,0,0,50.0,64.0
14971,25296,13,0,8629,6,7,100.0,0.0
14972,2772,52,2772,2095,42,10,2.5641025641025643,46.94
14973,2880,3,2880,2400,3,0,20.0,98.27
14974,3072924,147,0,119248,79,68,4.545454545454546,0.0
14975,27888,4,27888,7188,3,1,33.333333333333336,40.37
14976,1047204,8,1047204,130119,6,2,20.0,55.21
14977,2633976,13,2633976,257442,8,5,20.0,37.84
14978,259764,68,259764,49482,56,12,2.5,4.55
14979,4733160,100,2392938,1429,47,53,4.545454545454546,86.14
14980,79140,14,23868,8469,13,1,12.5,20.23
14981,5445984,9,0,609153,6,3,50.0,5.0
14982,84744,395,0,5958,251,144,1.0,3.5
14983,6890592,969,2064,1252706,576,393,1.0,0.0
14984,24480,389,0,4669,226,163,1.0,0.0
14985,34428,9,34428,4618,5,4,25.0,0.11
14986,12000,22,12000,884,20,2,5.2631578947368425,76.11
14987,5388,19,0,800,16,3,11.11111111111111,0.0
14988,41748,12,41748,1852,7,5,20.0,32.71
14989,1679340,93,0,26629,43,50,6.666666666666667,0.0
14990,6910152,15482,1979988,1277835,8852,6630,1.0526315789473684,0.0
14991,5484,19,5484,621,18,1,5.882352941176471,72.83
14992,3902532,27,23892,280184,26,1,4.761904761904762,97.13
14993,5932296,749,1773104,262642,446,303,1.4705882352941178,0.0
14994,32364,4,32364,822,4,0,25.0,92.21
14995,911772,718,440820,90986,664,54,1.0,90.92
14996,2626512,35,193872,117336,31,4,4.3478260869565215,37.39
14997,8496,6,0,2864,4,2,50.0,0.0
14998,53064,48,0,3984,42,6,100.0,0.0
14999,1500,12,1500,1154,12,0,7.6923076923076925,82.86
15000,217992,150,0,23887,63,87,4.545454545454546,5.0
15001,104496,18,104496,1450,17,1,7.142857142857143,3.83
15002,190836,99,190836,324,81,18,1.5873015873015872,27.73
15003,19572,24,19572,1058,23,1,4.545454545454546,70.59
15004,2872404,30,0,371004,22,8,33.333333333333336,0.0
15005,128172,250,128172,45697,190,60,1.0,0.0
15006,3984,16,3984,714,15,1,7.6923076923076925,57.0
15007,103668,90,103668,3520,75,15,1.351351351351351,16.22
15008,696,9,696,125,5,4,20.0,83.21
15009,18060,23,18060,433,20,3,5.882352941176471,73.71
15010,28632,31,26748,5240,28,3,4.166666666666667,69.93
15011,6530808,622,998514,64221,458,164,1.0,35.72
15012,2178840,51,0,325788,21,30,12.5,20.0
15013,2507316,30,0,1240773,20,10,20.0,0.0
15014,276,54,276,125,22,32,12.5,79.85
15015,816,0,816,0,0,0,100.0,100.0
15016,36840,51,600,867,34,17,3.8461538461538463,42.19
15017,6097044,37,0,1625753,29,8,9.090909090909092,0.0
15018,50796,18,50796,938,16,2,7.142857142857143,89.01
15019,15888,61,0,2648,53,8,100.0,0.0
15020,1131732,23,49128,50021,19,4,10.0,74.06
15021,6938460,583,4781436,3496409,310,273,1.0,0.0
15022,3463836,50,0,144064,37,13,50.0,0.0
15023,444,37,216,76,29,8,4.3478260869565215,69.41
15024,6747792,500,0,125067,264,236,2.380952380952381,0.0
15025,15000,48,0,2326,40,8,25.0,0.0
15026,3012,14,0,669,12,2,25.0,0.0
15027,2184,8,0,721,5,3,100.0,0.0
15028,4782192,317,4782072,25773,162,155,2.380952380952381,30.0
15029,233988,39,0,7026,29,10,50.0,0.0
15030,2484,54,0,925,48,6,50.0,0.0
15031,6624,29,6624,5327,20,9,2.857142857142857,47.01
15032,165480,1,165480,0,0,1,25.0,95.12
15033,336,77,336,97,69,8,1.492537313432836,43.62
15034,6863928,1627,0,375841,893,734,1.0,0.0
15035,5885028,626,1419072,437229,355,271,1.5625,0.0
15036,5571552,1639,924636,457162,903,736,1.0,0.0
15037,528,8,528,60,8,0,10.0,63.78
15038,2831724,28,13548,203813,24,4,5.2631578947368425,89.07
15039,181620,47,0,5373,32,15,100.0,0.0
15040,432,5,48,163,2,3,100.0,0.0
15041,96,8,96,22,8,0,10.0,59.2
15042,252,100,252,90,50,50,3.8461538461538463,66.23
15043,5196552,347,0,24455,203,144,1.2987012987012987,0.0
15044,6871680,1705,0,402391,948,757,1.0,0.0
15045,6658092,487,87420,277411,262,225,1.7241379310344829,0.0
15046,1650288,114,1650288,62493,57,57,6.25,0.0
15047,6226968,70,0,564796,55,15,50.0,0.0
15048,98748,85,0,22078,70,15,100.0,0.0
15049,170124,0,170124,0,0,0,100.0,100.0
15050,420,14,378,185,14,0,6.25,75.14
15051,9252,70,6552,6459,62,8,1.6666666666666667,43.63
15052,201516,63,73320,15485,55,8,2.7777777777777777,1.76
15053,240,7,240,66,5,2,16.666666666666668,58.68
15054,50724,21,50724,978,19,2,6.666666666666667,41.4
15055,384,20,360,94,20,0,5.0,58.62
15056,3610752,116,0,124219,73,43,3.571428571428572,0.0
15057,288,0,288,0,0,0,50.0,80.0
15058,205968,40,0,21227,34,6,50.0,0.0
15059,19548,188,0,2569,134,54,1.1235955056179776,0.0
15060,2814876,128,2814876,122068,36,92,3.703703703703704,51.0
15061,336,5,0,103,4,1,100.0,0.0
15062,312,14,312,144,13,1,7.142857142857143,43.76
15063,101388,70,1704,3989,52,18,3.4482758620689653,38.44
15064,139968,158,0,5598,99,59,100.0,0.0
15065,312,13,0,80,10,3,100.0,0.0
15066,804,95,0,46,94,1,1.0416666666666667,0.0
15067,6002820,346,2740380,105335,191,155,2.083333333333333,50.35
15068,300,5,72,62,5,0,33.333333333333336,99.95
15069,3794436,93,0,43351,46,47,4.761904761904762,5.0
15070,15408,15,15408,2474,9,6,12.5,53.4
15071,576,97,576,134,43,54,5.555555555555555,76.95
15072,1577412,136,0,18699,70,66,3.125,0.0
15073,40656,2,40656,204,2,0,25.0,61.62
15074,4203108,36,0,254756,23,13,2.857142857142857,0.0
15075,5181384,149,2745000,55165,78,71,5.2631578947368425,82.76
15076,360,2,360,96,1,1,50.0,63.15
15077,23952,152,0,2570,104,48,1.2820512820512822,0.0
15078,2700,18,2700,2318,14,4,7.142857142857143,78.51
15079,2640,33,2640,1977,31,2,3.125,66.75
15080,492,112,492,177,60,52,2.7777777777777777,46.33
15081,2747124,2,2747124,54,2,0,20.0,0.0
15082,684,3,684,200,3,0,20.0,83.07
15083,1404,4,0,486,3,1,100.0,0.0
15084,228,10,228,54,5,5,50.0,64.69
15085,151848,55,151848,4358,49,6,2.0408163265306123,23.75
15086,310764,32,0,18718,21,11,8.333333333333334,0.0
15087,5700036,2745,741660,137740,1524,1221,1.0,0.0
15088,530400,9,530400,1716,8,1,12.5,92.19
15089,6677580,458,0,394585,234,224,1.8867924528301887,0.0
15090,35292,53,35292,18600,21,32,20.0,82.66
15091,96,21,96,15,17,4,5.882352941176471,40.69
15092,312,12,0,86,9,3,100.0,0.0
15093,192,24,192,40,19,5,6.25,45.51
15094,79944,122,120,2675,88,34,1.3333333333333333,17.92
15095,6764556,1421,0,56610,804,617,1.0,0.0
15096,600792,13,300780,85,11,2,7.6923076923076925,71.08
15097,64776,284,0,4141,197,87,100.0,0.0
15098,6511104,413,0,72778,222,191,1.6666666666666667,0.8
15099,1140,42,684,212,42,0,2.3255813953488373,63.83
15100,60804,2,60804,768,1,1,100.0,100.0
15101,6669456,217,1770816,822626,111,106,1.408450704225352,6.17
15102,32040,29,32040,3996,25,4,7.142857142857143,73.52
15103,1416,70,0,325,60,10,100.0,0.0
15104,170928,48,170928,20029,34,14,3.4482758620689653,47.48
15105,2532,0,2532,0,0,0,50.0,90.0
15106,3217308,130,0,50550,56,74,4.545454545454546,6.0
15107,84,32,84,21,22,10,5.2631578947368425,49.4
15108,6974304,10932,1134900,1813750,6695,4237,1.0,0.0
15109,1464,14,1464,872,14,0,6.25,80.93
15110,4320,87,4320,1732,49,38,2.7777777777777777,45.14
15111,7764,5,0,2388,4,1,50.0,99.0
15112,2388,28,2388,2032,26,2,3.703703703703704,77.88
15113,37452,22,0,20269,20,2,14.285714285714286,0.0
15114,960,26,660,545,25,1,3.8461538461538463,61.06
15115,38844,261,0,3839,171,90,100.0,0.0
15116,302568,2,1740,151350,2,0,50.0,99.03
15117,6345804,2895,2488116,362521,1502,1393,1.0,0.0
15118,6857280,1258,4223544,530352,612,646,1.0101010101010102,0.0
15119,44448,353,24846,5063,77,276,2.4390243902439024,42.72
15120,80916,42,80916,11151,33,9,4.166666666666667,4.82
15121,53508,136,53508,237,101,35,1.2048192771084338,27.3
15122,2532,9,2532,388,9,0,16.666666666666668,24.32
15123,65088,2,65088,420,2,0,100.0,99.57
15124,11196,146,0,2171,95,51,100.0,0.0
15125,4699200,178,0,40927,88,90,2.702702702702702,0.0
15126,70284,272,52584,18878,210,62,1.0,0.0
15127,21828,101,0,2110,69,32,1.7857142857142858,0.0
15128,5874636,1420,4818252,69869,793,627,1.0,0.0
15129,2300796,161,0,49686,82,79,1.8867924528301887,0.0
15130,193980,11,0,68656,9,2,100.0,0.0
15131,3240,5,3240,770,4,1,100.0,100.0
15132,13620,90,13620,6486,67,23,2.1739130434782608,28.39
15133,288,1,0,288,0,1,100.0,0.0
15134,5844,7,5844,3425,7,0,20.0,20.24
15135,2856,90,2268,1869,78,12,1.2987012987012987,5.63
15136,13080,292,0,2042,181,111,100.0,0.0
15137,7404,22,7404,592,21,1,5.2631578947368425,70.7
15138,6988176,22316,3073252,1768047,12037,10279,1.0,0.0
15139,6648,4,6648,6312,4,0,20.0,92.92
15140,4823052,255,4822896,45603,120,135,2.7777777777777777,0.0
15141,30936,14,0,5659,11,3,50.0,99.0
15142,4236,7,4236,334,7,0,12.5,35.24
15143,6945600,39,0,4500770,30,9,9.090909090909092,95.27
15144,1104,14,1104,570,14,0,10.0,41.99
15145,4807704,132,4807548,609155,63,69,5.882352941176471,10.0
15146,208236,15,208008,326,15,0,5.882352941176471,59.35
15147,108,0,108,0,0,0,100.0,0.0
15148,690312,403,0,23217,160,243,2.4390243902439024,0.0
15149,4824,7,0,858,3,4,100.0,0.0
15150,2172480,814,2050449,1953331,592,222,1.0,48.76
15151,1104,17,1104,813,16,1,5.882352941176471,50.03
15152,2751228,217,2751228,90183,101,116,2.9411764705882355,70.21
15153,243912,11,243912,37824,9,2,12.5,63.68
15154,2412,32,2340,2282,22,10,5.0,72.71
15155,353124,22,131646,27816,14,8,16.666666666666668,0.0
15156,374712,327,344616,149341,320,7,1.408450704225352,86.08
15157,6960600,87,0,2815750,43,44,1.2658227848101269,0.0
15158,16092,20,16092,736,20,0,5.0,78.18
15159,143700,25,143700,31308,15,10,14.285714285714286,0.0
15160,72840,11,72840,770,10,1,9.090909090909092,0.0
15161,19656,23,19656,971,21,2,5.2631578947368425,69.96
15162,2451348,22,0,118039,18,4,12.5,0.0
15163,30720,25,30720,1615,21,4,6.666666666666667,79.52
15164,18696,21,18696,526,20,1,5.555555555555555,70.69
15165,493836,116,0,7173,84,32,100.0,0.0
15166,2688,17,2688,621,16,1,12.5,52.31
15167,22224,87,0,1439,62,25,50.0,0.0
15168,1549680,77,1549680,1527,64,13,1.7241379310344829,2.91
15169,60444,34,0,2461,25,9,50.0,0.0
15170,473484,259,24024,11852,191,68,1.0,0.0
15171,5951052,1055,4838544,1157814,631,424,1.0,0.0
15172,156,0,156,0,0,0,100.0,100.0
15173,26340,17,26340,2517,10,7,20.0,97.87
15174,3970788,661,2423844,23361,441,220,1.0,0.0
15175,1104,1,1104,204,1,0,33.333333333333336,58.7
15176,3922080,48,0,86681,41,7,50.0,0.0
15177,6980484,283,0,2410755,170,113,1.3157894736842106,0.0
15178,146064,42,0,4497,27,15,100.0,0.0
15179,138408,40,0,13152,30,10,50.0,0.0
15180,1587048,31,0,727045,12,19,12.5,0.0
15181,12180,18,0,2178,16,2,33.333333333333336,0.0
15182,6981096,1753,0,860802,998,755,1.0,0.0
15183,204,20,204,113,14,6,7.6923076923076925,49.01
15184,36168,5,36168,132,5,0,25.0,12.95
15185,28488,68,0,1157,53,15,100.0,0.0
15186,53280,50,27648,4059,44,6,5.2631578947368425,34.47
15187,324,52,288,49,47,5,2.3255813953488373,21.33
15188,6460092,177,1820028,1360452,94,83,2.9411764705882355,0.75
15189,1164,1,1164,252,1,0,50.0,98.89
15190,10728,20,10728,410,19,1,5.555555555555555,77.1
15191,25872,3,0,13060,2,1,50.0,90.0
15192,1213548,54,1213548,83125,46,8,1.96078431372549,41.27
15193,12540,23,12540,581,21,2,5.555555555555555,74.43
15194,63924,42,0,2844,27,15,100.0,0.0
15195,6629736,40,0,2712600,33,7,10.0,0.0
15196,64860,23,64860,1351,19,4,6.666666666666667,89.18
15197,636,36,528,214,22,14,10.0,62.59
15198,1544784,113,0,43518,57,56,7.142857142857143,0.0
15199,14028,24,14028,955,21,3,5.2631578947368425,70.04
15200,704376,59,0,37698,46,13,50.0,0.0
15201,4583928,44,0,405748,21,23,9.090909090909092,0.0
15202,36948,0,36948,0,0,0,100.0,100.0
15203,624,30,624,337,28,2,5.2631578947368425,74.65
15204,3513492,56,0,306517,44,12,33.333333333333336,0.0
15205,425112,1,425112,576,1,0,33.333333333333336,74.25
15206,89832,121,0,8609,53,68,9.090909090909092,0.0
15207,358380,99,0,22339,86,13,100.0,0.0
15208,18240,48,0,1610,32,16,100.0,0.0
15209,2460,48,0,818,41,7,100.0,0.0
15210,140844,40,0,5219,31,9,50.0,0.0
15211,22476,11,22476,1157,10,1,11.11111111111111,1.8
15212,4153032,60,0,213595,48,12,100.0,0.0
15213,13200,301,13200,3058,192,109,1.0,22.27
15214,920832,33,0,93703,18,15,11.11111111111111,0.0
15215,4152,9,4152,1674,6,3,14.285714285714286,68.39
15216,297144,14,25320,29164,10,4,20.0,0.0
15217,20568,34,20568,5935,30,4,7.6923076923076925,35.76
15218,265788,1,265788,0,1,0,33.333333333333336,7.72
15219,1092,9,720,410,8,1,12.5,0.0
15220,17880,46,0,1371,32,14,100.0,0.0
15221,6755076,3072,0,230631,1266,1806,1.0,0.0
15222,7824,43,0,913,34,9,100.0,0.0
15223,5906904,112,0,74294,66,46,5.0,0.0
15224,480,24,336,206,17,7,7.6923076923076925,52.2
15225,622800,166,0,8212,92,74,2.5641025641025643,6.0
15226,2580,39,2580,1033,29,10,3.8461538461538463,62.31
15227,599448,4,0,153954,3,1,100.0,0.0
15228,26568,12,26568,688,10,2,9.090909090909092,11.77
15229,2976504,37,0,127953,31,6,50.0,0.0
15230,197124,39,197124,6324,35,4,2.857142857142857,28.69
15231,6265608,79,0,113413,67,12,33.333333333333336,0.0
15232,648,107,648,106,103,4,1.7241379310344829,56.69
15233,14748,48,0,1322,33,15,100.0,0.0
15234,8988,18,8988,1282,16,2,8.333333333333334,50.64
15235,5271840,40,0,535144,34,6,14.285714285714286,0.0
15236,780,25,780,355,25,0,3.8461538461538463,88.8
15237,5470368,373,743868,104998,173,200,1.6129032258064515,0.0
15238,81360,40,81360,1855,40,0,2.4390243902439024,43.16
15239,64332,274,0,5603,156,118,100.0,0.0
15240,312,36,312,80,34,2,2.857142857142857,70.05
15241,30168,4,30168,2298,3,1,50.0,97.32
15242,56868,59,0,2863,49,10,50.0,0.0
15243,264072,207,33240,9132,154,53,100.0,0.0
15244,6617604,1662,6311100,1136067,807,855,1.0,7.07
15245,4237572,3,0,3132644,1,2,50.0,0.0
15246,2398740,215,0,14724,108,107,4.545454545454546,0.0
15247,6499224,223,65526,64563,95,128,1.4705882352941178,0.0
15248,682260,6,0,314996,5,1,100.0,100.0
15249,5196408,1136,642604,580422,661,475,1.36986301369863,0.0
15250,82320,46,888,1837,46,0,2.127659574468085,72.52
15251,5124,15,5124,1024,12,3,11.11111111111111,88.41
15252,14052,202,0,334,191,11,1.0,0.0
15253,46812,137,0,2594,101,36,100.0,0.0
15254,34452,200,0,6618,143,57,100.0,0.0
15255,6156576,3,1620,2052320,3,0,33.333333333333336,99.01
15256,6767700,5326,824748,150906,2537,2789,1.0,4.44
15257,5294868,31,1620,171739,25,6,4.3478260869565215,63.02
15258,6536340,1242,35352,137766,641,601,1.0869565217391304,0.0
15259,64560,9,64560,525,9,0,9.090909090909092,6.22
15260,93672,434,0,9818,297,137,100.0,0.0
15261,4447524,24,2705808,939890,16,8,7.142857142857143,78.05
15262,324,24,324,125,15,9,11.11111111111111,45.32
15263,196248,9,196248,190928,6,3,20.0,94.6
15264,7033740,8525,915912,1620801,5020,3505,1.0,0.0
15265,914976,25,8406,38588,24,1,6.666666666666667,57.04
15266,44112,19,44112,620,11,8,25.0,95.98
15267,360,2,360,42,1,1,50.0,98.56
15268,432,2,432,0,2,0,12.5,78.77
15269,103908,0,103908,0,0,0,50.0,61.33
15270,180,3,180,64,3,0,20.0,63.13
15271,4824,4,4824,2712,2,2,50.0,99.3
15272,6024144,644,0,66338,348,296,1.408450704225352,0.0
15273,4006248,89,75444,67010,75,14,1.818181818181818,4.72
15274,3935952,106,0,58945,81,25,100.0,100.0
15275,360,21,0,104,19,2,50.0,0.0
15276,228,10,228,63,9,1,10.0,48.0
15277,4035132,108,0,40745,44,64,9.090909090909092,0.0
15278,1284,63,1284,312,59,4,1.7241379310344829,40.99
15279,108,0,108,0,0,0,50.0,80.0
15280,156,18,156,44,14,4,7.142857142857143,46.77
15281,144,2,144,60,2,0,25.0,64.89
15282,156,19,156,35,15,4,6.666666666666667,45.67
15283,6618864,171,6618864,74841,73,98,3.225806451612903,74.97
15284,6810492,135,0,58239,63,72,5.2631578947368425,0.0
15285,45276,32,45276,7585,28,4,6.25,86.74
15286,66000,35,66000,4755,26,9,5.2631578947368425,74.89
15287,151500,56,151500,1747,49,7,4.761904761904762,0.0
15288,4533360,14,6540,677546,13,1,12.5,29.08
15289,33600,84,33558,312,55,29,1.818181818181818,40.84
15290,4956,7,4956,553,6,1,10.0,77.53
15291,54180,180,0,3107,115,65,50.0,0.0
15292,49344,298,0,5176,181,117,100.0,0.0
15293,5261160,114,5261160,3666,63,51,3.703703703703704,75.76
15294,88956,61,0,1967,52,9,100.0,0.0
15295,15840,22,15840,3389,15,7,12.5,88.29
15296,6763032,59,0,220292,32,27,12.5,0.0
15297,5994072,320,0,794471,173,147,6.25,0.0
15298,3959172,901,2581884,42603,522,379,1.0,5.0
15299,5148,26,2249,1024,16,10,11.11111111111111,79.0
15300,2596668,223,2596668,24069,117,106,3.571428571428572,78.14
15301,144168,22,0,10710,20,2,100.0,0.0
15302,5400,0,5400,0,0,0,50.0,56.25
15303,4392,9,4392,1026,7,2,25.0,95.49
15304,192,8,84,73,5,3,20.0,46.76
15305,3559764,44,3559764,102497,20,24,6.666666666666667,62.39
15306,6080592,1215,0,102070,724,491,1.0,0.0
15307,528,43,528,22,41,2,2.380952380952381,48.6
15308,1056,32,1056,413,29,3,4.761904761904762,31.84
15309,6768924,25,11136,271326,23,2,4.545454545454546,73.26
15310,239448,41,220740,61757,38,3,2.7777777777777777,39.3
15311,6083520,186,0,81235,96,90,4.0,0.0
15312,18948,18,18948,1589,14,4,11.11111111111111,76.04
15313,5020932,192,918024,440710,100,92,1.0,0.0
15314,51780,12,51780,1071,11,1,10.0,1.12
15315,6624,52,0,1901,46,6,100.0,0.0
15316,434508,11,434508,157382,11,0,9.090909090909092,95.68
15317,576,22,0,249,20,2,100.0,100.0
15318,1944,29,1944,129,24,5,4.761904761904762,42.39
15319,720,36,720,359,24,12,7.142857142857143,82.1
15320,2113560,547,1082934,40325,414,133,1.0,26.62
15321,2664,14,2664,754,13,1,10.0,67.91
15322,6516,64,6516,5696,58,6,1.7857142857142858,47.73
15323,3448548,15,33072,230633,14,1,7.142857142857143,70.6
15324,6234672,973,747624,2042519,579,394,1.0,3.99
15325,48972,56,0,3006,40,16,100.0,0.0
15326,4164,13,4164,915,11,2,11.11111111111111,84.6
15327,6440484,4767,0,805702,2476,2291,1.0,0.0
15328,8832,21,8832,3598,19,2,6.666666666666667,70.92
15329,119040,72,119040,4517,63,9,1.6666666666666667,12.76
15330,21204,24,13356,1719,23,1,4.545454545454546,74.06
15331,2097168,78,1192740,1408244,74,4,25.0,99.88
15332,5556,8,0,1416,7,1,12.5,2.0
15333,3169956,61,0,54194,52,9,33.333333333333336,0.0
15334,20376,5,20376,84,4,1,25.0,83.46
15335,350136,52,350136,2617,39,13,4.3478260869565215,28.88
15336,5796,15,3564,651,14,1,9.090909090909092,63.18
15337,48252,63,0,7692,50,13,100.0,0.0
15338,703068,59,703068,37808,35,24,10.0,0.0
15339,75792,136,75792,6173,111,25,1.0,18.08
15340,6897732,242,0,792982,126,116,3.125,0.0
15341,2583540,585,0,155930,239,346,1.9230769230769231,0.0
15342,20700,8,20700,5746,5,3,33.333333333333336,97.54
15343,168,10,168,50,8,2,11.11111111111111,78.69
15344,4693872,783,91020,42824,618,165,1.0,0.0
15345,119652,60,119652,29091,55,5,2.1739130434782608,61.9
15346,30588,29,19524,4829,26,3,5.0,72.35
15347,342012,26,230928,233729,22,4,5.2631578947368425,94.69
15348,7440,10,7440,740,9,1,12.5,43.48
15349,6048156,23,0,527072,20,3,12.5,0.0
15350,3228,31,1152,669,31,0,3.333333333333333,66.28
15351,24156,16,24156,6641,14,2,10.0,23.94
15352,8208,49,0,2085,39,10,100.0,0.0
15353,9000,11,1272,2032,9,2,14.285714285714286,0.0
15354,3312,50,3312,778,46,4,25.0,52.39
15355,4584,19,4584,441,18,1,5.882352941176471,77.33
15356,504,8,504,159,5,3,25.0,72.86
15357,16860,23,16860,540,20,3,5.882352941176471,74.57
15358,41352,33,41352,4079,28,5,5.882352941176471,88.51
15359,153276,32,0,19323,19,13,9.090909090909092,0.0
15360,6810204,366,0,296096,168,198,3.0303030303030303,0.0
15361,2664,35,0,1010,29,6,100.0,0.0
15362,159456,11,159456,50000,11,0,9.090909090909092,0.0
15363,852864,78,0,16445,70,8,50.0,0.0
15364,5508,6,5508,4004,4,2,33.333333333333336,72.57
15365,6137064,495,0,63224,259,236,2.127659574468085,5.0
15366,3649164,17,8988,215764,15,2,10.0,0.26
15367,331092,342,1032,2975,198,144,1.0101010101010102,32.99
15368,168,60,144,83,40,20,3.125,41.8
15369,2796180,64,1306776,165738,53,11,1.96078431372549,41.83
15370,355968,233,147813,45609,195,38,1.818181818181818,54.15
15371,4507752,614,0,30452,329,285,1.5625,0.0
15372,2789268,291,0,14386,164,127,1.8867924528301887,0.0
15373,168,8,168,106,8,0,16.666666666666668,63.94
15374,7095432,12453,0,236162,7319,5134,1.0,0.0
15375,6591264,407,0,968422,231,176,1.5384615384615383,0.11
15376,2724,22,2724,1079,21,1,7.6923076923076925,78.72
15377,3084,12,0,475,10,2,50.0,0.0
15378,19488,15,19488,1780,13,2,9.090909090909092,87.23
15379,18312,29,18312,3830,27,2,7.6923076923076925,13.6
15380,648,26,648,84,19,7,7.142857142857143,52.16
15381,75552,45,0,2660,29,16,100.0,0.0
15382,4308,39,4308,1664,30,9,7.6923076923076925,79.34
15383,6879480,11031,745464,1397595,6592,4439,1.0,0.0
15384,720,19,720,303,17,2,5.2631578947368425,86.73
15385,3156,0,3156,0,0,0,50.0,90.0
15386,4044,65,0,1129,54,11,100.0,0.0
15387,7164,4,7164,1377,4,0,16.666666666666668,8.64
15388,96480,79,96480,7594,55,24,2.2222222222222223,21.12
15389,130200,14,0,18035,10,4,12.5,0.0
15390,4332,3,4332,1712,2,1,33.333333333333336,78.38
15391,372,15,372,14,15,0,5.882352941176471,51.14
15392,25440,39,0,6312,32,7,20.0,0.0
15393,6192,31,6192,1636,26,5,5.882352941176471,79.99
15394,7872,17,7872,833,16,1,10.0,17.97
15395,63144,31,63144,10815,29,2,5.0,5.61
15396,39192,43,0,1879,30,13,100.0,0.0
15397,3107904,249,0,111660,137,112,3.125,0.0
15398,463200,54,0,24996,43,11,50.0,0.0
15399,43752,30,23640,4746,26,4,6.666666666666667,90.57
15400,5539248,598,4220700,157113,315,283,1.6666666666666667,2.02
15401,3736536,143,0,346240,118,25,11.11111111111111,0.0
15402,5955240,136,2978796,660891,105,31,25.0,0.38
15403,63576,100,0,1950,67,33,100.0,0.0
15404,1261164,26,5268,49520,23,3,7.6923076923076925,17.42
15405,75948,356,0,6680,245,111,1.0,0.0
15406,77580,5,0,31488,3,2,100.0,0.0
15407,44520,14,44520,14614,11,3,11.11111111111111,73.03
15408,40668,188,0,3222,121,67,100.0,0.0
15409,2916,73,2916,181,32,41,8.333333333333334,85.59
15410,4134972,157,0,102231,97,60,16.666666666666668,0.0
15411,269220,6,134568,44936,3,3,33.333333333333336,4.99
15412,62004,200,43248,12310,180,20,1.0,7.95
15413,76476,119,0,4997,79,40,50.0,0.0
15414,4530768,13,1596,1041339,8,5,20.0,61.78
15415,12948,14,12948,850,12,2,11.11111111111111,90.28
15416,41532,0,41532,0,0,0,100.0,100.0
15417,3000,9,300,461,8,1,14.285714285714286,58.67
15418,948,4,948,261,3,1,50.0,98.75
15419,7069224,843,1611156,374183,477,366,1.5384615384615383,0.0
15420,5532,19,5532,823,16,3,7.6923076923076925,7.96
15421,780,10,780,321,8,2,16.666666666666668,82.76
15422,4428,70,4428,2930,36,34,4.761904761904762,45.04
15423,204,17,0,58,13,4,3.571428571428572,0.0
15424,1592256,61,4344,26563,57,4,1.7857142857142858,11.22
15425,11400,31,11400,1621,28,3,11.11111111111111,17.26
15426,6419412,25,4982004,749531,20,5,5.555555555555555,15.0
15427,817776,971,515199,114622,917,54,1.0,31.53
15428,2704044,193,2704044,456746,86,107,4.3478260869565215,71.64
15429,3384,28,720,971,19,9,10.0,0.0
15430,1524,19,1524,1131,13,6,7.6923076923076925,71.18
15431,4881972,15,0,326664,13,2,6.25,2.0
15432,5356008,547,0,80969,306,241,2.083333333333333,0.0
15433,58056,29,0,2070,29,0,3.225806451612903,0.0
15434,8520,3,8520,24,3,0,25.0,78.81
15435,5868,105,0,1057,73,32,100.0,0.0
15436,28104,144,0,13402,93,51,100.0,0.0
15437,5418084,2262,262632,166128,1188,1074,1.0,0.0
15438,6525684,2148,212604,154248,1158,990,1.0,0.0
15439,4005324,21,43452,382578,19,2,7.6923076923076925,42.81
15440,252,39,180,81,32,7,3.333333333333333,29.28
15441,92100,5,0,20512,5,0,50.0,30.0
15442,6398808,151,3506652,263231,76,75,2.857142857142857,0.0
15443,23916,86,23916,785,71,15,1.639344262295082,15.4
15444,4333836,107,40020,46785,63,44,4.545454545454546,60.76
15445,422676,5,211752,535,4,1,16.666666666666668,96.32
15446,6111468,28,16920,219864,25,3,7.142857142857143,79.94
15447,972,25,972,50,23,2,4.3478260869565215,25.8
15448,206544,58,206544,10944,50,8,2.5,27.62
15449,60084,87,60084,1631,47,40,4.545454545454546,70.85
15450,13848,13,13848,812,12,1,12.5,45.58
15451,1934592,633,679476,39961,466,167,1.0,42.83
15452,300,11,300,61,7,4,14.285714285714286,86.07
15453,92520,18,92520,773,17,1,6.666666666666667,0.0
15454,624528,325,624528,188267,258,67,1.0,0.32
15455,164172,81,0,5776,69,12,50.0,0.0
15456,2796,50,2796,699,41,9,2.4390243902439024,43.39
15457,7144128,13555,38631,1318685,7905,5650,1.0,0.0
15458,708312,6,360954,107126,5,1,33.333333333333336,0.0
15459,1854348,34,0,144153,20,14,100.0,0.0
15460,2198640,719,599709,43964,519,200,1.0,36.75
15461,216,8,216,60,6,2,33.333333333333336,95.28
15462,7120380,1786,0,609936,1063,723,10.0,0.0
15463,8784,9,8784,490,9,0,8.333333333333334,4.43
15464,4320,5,4320,559,5,0,20.0,53.5
15465,924,278,840,603,133,145,100.0,99.96
15466,23064,9,23064,1196,9,0,12.5,51.88
15467,6254004,232,4040880,173174,91,141,5.882352941176471,0.0
15468,5141364,432,0,2435622,291,141,1.0101010101010102,0.0
15469,8940,40,0,1887,27,13,11.11111111111111,0.0
15470,4620,10,4620,2202,10,0,25.0,99.18
15471,7596,25,7596,652,23,2,5.0,0.0
15472,22152,19,22152,3877,19,0,10.0,99.23
15473,38724,17,38724,1016,15,2,7.6923076923076925,92.37
15474,894696,9,0,106201,4,5,33.333333333333336,0.0
15475,95604,278,0,29946,204,74,50.0,0.0
15476,1356,13,1356,448,8,5,33.333333333333336,97.71
15477,1464,48,0,618,38,10,100.0,0.0
15478,5011452,1475,5011452,444612,894,581,1.0,55.91
15479,3393072,5,0,2331777,1,4,100.0,0.0
15480,13236,32,13236,1397,28,4,5.0,80.05
15481,39264,69,0,2652,55,14,50.0,0.0
15482,314328,76,314328,51773,59,17,2.702702702702702,35.1
15483,20688,13,11628,551,12,1,11.11111111111111,54.36
15484,324,9,324,30,9,0,9.090909090909092,59.61
15485,36828,52,0,1803,42,10,100.0,0.0
15486,4435644,22,3468,1195056,18,4,10.0,81.72
15487,67644,99,67644,2739,83,16,1.351351351351351,15.17
15488,785124,2,785124,30828,1,1,100.0,99.88
15489,64284,93,64284,1531,67,26,1.818181818181818,26.49
15490,648,1,648,444,1,0,100.0,100.0
15491,108780,16,55542,1357,14,2,12.5,0.0
15492,168,18,168,13,14,4,10.0,55.04
15493,4176,32,0,279,27,5,33.333333333333336,0.0
15494,2316,42,0,730,33,9,50.0,0.0
15495,159792,768,90564,25410,604,164,1.0,0.0
15496,6522588,122,0,1056095,101,21,100.0,100.0
15497,6060,20,6060,444,20,0,5.0,75.38
15498,251880,13,127380,678,12,1,10.0,0.92
15499,82188,7,82188,653,7,0,11.11111111111111,69.03
15500,3935736,110,3935472,44360,65,45,4.0,9.0
15501,182628,2,182628,20196,2,0,50.0,95.24
15502,3696,23,3696,984,21,2,7.142857142857143,23.15
15503,11472,22,11472,530,21,1,5.0,77.07
15504,276,1,276,120,1,0,25.0,88.48
15505,26436,24,7620,1627,23,1,5.0,76.63
15506,16272,25,16272,1615,24,1,4.545454545454546,78.21
15507,1023588,44,0,32724,38,6,20.0,0.0
15508,2844,17,2844,699,16,1,7.142857142857143,3.7
15509,32940,13,32940,868,11,2,14.285714285714286,25.89
15510,64932,79,0,20736,54,25,100.0,0.0
15511,1980,18,1980,726,17,1,7.142857142857143,0.0
15512,24888,28,24888,1760,24,4,6.666666666666667,89.65
15513,20556,36,20556,1165,30,6,9.090909090909092,79.38
15514,821208,78,298008,101609,72,6,1.5625,25.71
15515,3972,16,3972,696,14,2,12.5,19.46
15516,1062696,40,0,184956,4,36,6.666666666666667,0.0
15517,84588,125,0,2090,91,34,100.0,0.0
15518,18084,59,0,2902,49,10,100.0,0.0
15519,4619820,618,3575340,1082435,374,244,1.0,0.0
15520,50616,11,49116,5196,8,3,50.0,0.0
15521,2916,24,2916,515,23,1,5.555555555555555,37.88
15522,3663600,5,0,726753,3,2,50.0,97.0
15523,5580,30,5580,1476,29,1,5.555555555555555,80.33
15524,6574440,754,0,106989,368,386,1.0526315789473684,0.0
15525,3036,49,0,1009,42,7,50.0,0.0
15526,14736,18,0,8165,10,8,100.0,100.0
15527,3456,17,3456,694,15,2,10.0,91.06
15528,192564,3,192564,40,1,2,50.0,71.02
15529,132,13,132,12,11,2,8.333333333333334,48.06
15530,168,15,144,29,13,2,7.142857142857143,55.62
15531,1176,20,1176,365,17,3,6.666666666666667,55.65
15532,264,29,264,75,21,8,6.666666666666667,52.61
15533,168,27,168,63,17,10,7.142857142857143,46.56
15534,28932,25,28932,464,25,0,3.8461538461538463,69.86
15535,804420,53,0,15649,44,9,100.0,0.0
15536,5808,24,5808,347,18,6,5.882352941176471,62.69
15537,6916668,242,0,285576,132,110,3.571428571428572,3.0
15538,960,86,0,622,72,14,50.0,0.0
15539,5682216,1621,0,90977,943,678,1.0526315789473684,0.0
15540,696,29,0,35,26,3,100.0,0.0
15541,63840,86,0,10468,71,15,50.0,0.0
15542,67428,74,0,4033,56,18,50.0,0.0
15543,552,60,552,42,56,4,1.7857142857142858,41.04
15544,1236,56,0,468,43,13,100.0,0.0
15545,348,69,348,139,51,18,2.3255813953488373,65.15
15546,3432,1,3432,2004,1,0,33.333333333333336,94.05
15547,3612,0,3612,0,0,0,100.0,100.0
15548,1908,38,1620,1022,36,2,3.0303030303030303,26.43
15549,28260,12,28260,3411,10,2,9.090909090909092,53.05
15550,59220,11,59220,829,10,1,8.333333333333334,50.66
15551,660,51,660,34,48,3,2.083333333333333,61.0
15552,4525392,91,2732904,207446,41,50,5.555555555555555,5.0
15553,204,3,204,0,3,0,20.0,59.2
15554,1020,22,72,81,18,4,5.882352941176471,49.74
15555,488724,29,26604,24701,24,5,11.11111111111111,18.43
15556,888,69,888,251,51,18,2.380952380952381,63.13
15557,4188,9,4188,2090,7,2,11.11111111111111,86.39
15558,564,7,564,286,7,0,16.666666666666668,15.94
15559,19908,24,19908,1010,21,3,10.0,85.25
15560,7220256,18425,1192095,1580256,10601,7824,1.0,0.94
15561,456,118,456,229,112,6,1.0,27.34
15562,2161176,21,56328,132100,20,1,5.882352941176471,54.48
15563,6913356,22,2679480,581018,14,8,20.0,83.6
15564,5066016,20,3914880,124,19,1,5.0,26.3
15565,912,241,0,675,181,60,100.0,0.0
15566,1488,127,0,516,100,27,100.0,0.0
15567,276,33,0,58,29,4,100.0,0.0
15568,419184,89,419184,44143,61,28,2.0408163265306123,63.41
15569,1158960,6,0,200820,2,4,100.0,0.0
15570,4792944,120,0,182581,53,67,5.555555555555555,0.0
15571,5061012,303,2647920,128780,120,183,3.703703703703704,0.0
15572,1524,61,1524,1246,38,23,3.571428571428572,72.38
15573,552,15,168,66,13,2,7.142857142857143,49.78
15574,252,49,252,55,33,16,3.8461538461538463,42.18
15575,4113900,25,6396,569690,21,4,7.6923076923076925,88.25
15576,33552,71,0,1659,53,18,100.0,0.0
15577,588,5,588,360,3,2,25.0,96.33
15578,6655716,122,52836,576334,94,28,1.4705882352941178,13.85
15579,5892,5,5892,398,5,0,12.5,43.6
15580,35340,36,35340,894,34,2,3.571428571428572,0.0
15581,3179292,235,2716236,310133,130,105,1.96078431372549,0.0
15582,1224,16,0,850,15,1,100.0,0.0
15583,14028,25,14028,488,19,6,12.5,18.38
15584,19908,52,0,961,44,8,100.0,0.0
15585,648,15,0,286,11,4,33.333333333333336,99.9
15586,7233336,7779,0,2059187,4252,3527,1.0,0.0
15587,2820,71,2820,1833,47,24,2.702702702702702,42.25
15588,6054840,283,0,66528,147,136,1.96078431372549,0.0
15589,7229904,1616,0,2070033,913,703,1.0,6.0
15590,41532,86,0,2033,66,20,50.0,0.0
15591,6360072,10,480,1908091,8,2,33.333333333333336,99.55
15592,8988,19,8988,1949,17,2,10.0,85.76
15593,87468,42,87468,1566,37,5,3.0303030303030303,33.47
15594,312,30,312,105,26,4,3.8461538461538463,53.36
15595,2868,13,2868,1372,11,2,6.25,41.65
15596,996,0,996,0,0,0,50.0,85.0
15597,7040976,88,4965300,581289,38,50,6.25,0.0
15598,5183808,1318,5080428,116695,729,589,1.0,4.13
15599,120828,148,0,1959,68,80,4.3478260869565215,0.0
15600,1490868,4,80532,78972,3,1,50.0,0.0
15601,5699988,22,0,1795761,7,15,1.4705882352941178,80.01
15602,99492,5,99492,98,3,2,25.0,96.01
15603,44496,48,0,4456,40,8,100.0,0.0
15604,52764,21,52764,1149,20,1,6.25,2.86
15605,6108,28,6108,1902,28,0,3.703703703703704,14.12
15606,28716,60,0,3623,52,8,100.0,0.0
15607,828,41,828,428,41,0,2.3255813953488373,51.77
15608,10584,24,0,2109,24,0,3.4482758620689653,3.84
15609,2352,66,2352,678,50,16,2.4390243902439024,39.29
15610,21804,164,0,2943,103,61,100.0,0.0
15611,6885636,508,0,1551363,264,244,2.0408163265306123,0.0
15612,14952,117,0,1159,81,36,100.0,0.0
15613,3034836,185,2029860,345814,111,74,1.5384615384615383,28.67
15614,1020564,300,0,4532,142,158,3.571428571428572,11.0
15615,204,30,204,35,28,2,3.4482758620689653,48.48
15616,1498884,208,0,55990,120,88,1.098901098901099,4.9
15617,8940,16,8940,1343,15,1,7.6923076923076925,54.48
15618,552,6,552,230,4,2,100.0,100.0
15619,7038912,1176,0,1311244,554,622,1.0,0.0
15620,10752,22,10752,486,21,1,5.2631578947368425,76.65
15621,758136,22,16764,60397,18,4,11.11111111111111,18.35
15622,276,24,276,11,22,2,4.545454545454546,50.53
15623,10896,17,10896,1282,16,1,6.666666666666667,4.19
15624,1863144,41,0,301414,30,11,50.0,0.0
15625,2549448,223,2549424,155754,122,101,4.545454545454546,0.0
15626,2828160,204,0,81445,89,115,4.0,0.0
15627,2348628,31,0,158429,24,7,20.0,0.0
15628,2268,19,2268,594,18,1,6.25,3.01
15629,4203396,17,8448,248959,15,2,11.11111111111111,83.92
15630,94956,85,93444,38337,70,15,1.8867924528301887,2.65
15631,2928,24,2928,771,21,3,6.666666666666667,0.76
15632,7199484,1410,861888,791487,618,792,1.0,0.0
15633,3356148,197,3356148,279932,127,70,1.1363636363636365,37.73
15634,5721516,325,0,551327,158,167,1.0309278350515465,0.95
15635,275400,27,27948,11664,25,2,4.545454545454546,68.44
15636,5552628,899,4740480,237893,351,548,1.9230769230769231,0.0
15637,6900,22,6900,1319,21,1,7.142857142857143,20.88
15638,1664664,22,17988,76767,21,1,5.2631578947368425,73.92
15639,2316,10,2316,646,10,0,9.090909090909092,50.62
15640,5154264,42,0,140950,34,8,100.0,0.0
15641,24396,105,0,1794,75,30,50.0,0.0
15642,14352,18,14352,1388,16,2,8.333333333333334,83.65
15643,6888,20,6888,537,19,1,5.882352941176471,76.78
15644,394104,61,0,22335,51,10,50.0,0.0
15645,2592,14,2592,667,13,1,9.090909090909092,55.86
15646,3888,18,3888,438,17,1,6.25,81.7
15647,352320,15,352320,51929,13,2,14.285714285714286,60.67
15648,84792,36,84792,20457,30,6,9.090909090909092,86.97
15649,8292,8,0,2824,5,3,25.0,0.0
15650,2964,16,2964,827,15,1,8.333333333333334,10.51
15651,9816,46,0,2877,38,8,100.0,0.0
15652,30132,26,30132,72,17,9,10.0,58.01
15653,7246188,59,0,677172,49,10,16.666666666666668,0.0
15654,895512,169,0,44453,92,77,7.142857142857143,0.0
15655,204,68,204,50,36,32,4.761904761904762,60.06
15656,216,0,216,0,0,0,50.0,64.0
15657,6510528,25,36516,784200,22,3,12.5,15.88
15658,7416,40,0,1549,35,5,50.0,0.0
15659,1956,28,1956,553,28,0,3.8461538461538463,44.21
15660,6638004,145,1920303,522918,140,5,1.0,7.42
15661,23004,176,0,5205,111,65,100.0,0.0
15662,2280,27,2280,430,19,8,10.0,23.28
15663,203328,133,0,4310,85,48,100.0,0.0
15664,6432,2,6432,696,2,0,25.0,29.27
15665,972,20,972,297,8,12,25.0,96.03
15666,125772,172,124296,71931,144,28,1.0416666666666667,3.8
15667,204,2,204,180,2,0,25.0,76.0
15668,7440,5,7440,74,3,2,33.333333333333336,60.4
15669,84,30,84,20,20,10,5.882352941176471,41.44
15670,252,0,252,0,0,0,50.0,64.0
15671,44988,31,44988,308,31,0,3.571428571428572,53.88
15672,132,2,132,36,1,1,50.0,66.73
15673,756,12,756,203,12,0,8.333333333333334,58.59
15674,324,214,288,103,134,80,1.0526315789473684,46.23
15675,336,6,336,94,6,0,12.5,73.28
15676,2626668,52,2626452,105290,26,26,9.090909090909092,0.0
15677,68832,282,0,8070,168,114,100.0,0.0
15678,49728,34,49728,167,34,0,2.7777777777777777,49.02
15679,6279396,76,0,368993,63,13,20.0,0.0
15680,7298460,9202,966764,2004648,5115,4087,1.0,0.0
15681,7195284,1416,0,189437,801,615,1.0,0.0
15682,2412,79,2412,667,35,44,9.090909090909092,78.76
15683,492,78,492,102,46,32,6.666666666666667,80.37
15684,340800,12,340800,89561,8,4,20.0,96.96
15685,6608256,873,5143140,140469,359,514,1.25,0.0
15686,4956024,505,0,90658,274,231,1.7543859649122806,0.0
15687,6106164,63,0,961766,12,51,2.702702702702702,3.81
15688,34968,107,34968,3129,89,18,1.4492753623188406,15.8
15689,2640,2,708,2622,1,1,50.0,64.0
15690,5376,1,5376,816,1,0,33.333333333333336,98.0
15691,516,19,0,92,15,4,50.0,0.0
15692,6182784,340,0,32088,184,156,2.0,0.0
15693,360,37,0,128,22,15,100.0,0.0
15694,300,59,120,46,48,11,2.4390243902439024,0.0
15695,396,17,396,110,14,3,7.6923076923076925,55.6
15696,696,6,0,118,5,1,100.0,0.0
15697,5748,41,0,1291,35,6,100.0,0.0
15698,1028808,7,1028808,1693,5,2,20.0,54.09
15699,1596,45,1596,1295,33,12,3.4482758620689653,81.27
15700,4004976,183,0,85829,76,107,2.702702702702702,0.0
15701,507336,2,507336,246,1,1,50.0,15.0
15702,62004,0,31206,0,0,0,100.0,79.8
15703,1188,38,0,538,35,3,100.0,0.0
15704,47208,15,47208,723,15,0,10.0,13.38
15705,7752,27,1116,773,27,0,3.703703703703704,61.88
15706,7127760,178,0,3263432,105,73,5.555555555555555,0.0
15707,4633164,414,0,142960,237,177,1.6129032258064515,1.44
15708,10044,1,10044,7296,1,0,100.0,80.0
15709,52452,212,0,3448,137,75,100.0,0.0
15710,272952,21,5004,13772,19,2,5.882352941176471,78.81
15711,39012,116,0,2438,84,32,50.0,0.0
15712,5460,25,5460,4653,25,0,3.703703703703704,62.34
15713,2064,0,2064,0,0,0,100.0,100.0
15714,123528,238,0,6187,146,92,1.1235955056179776,3.0
15715,6331812,1203,5150916,69376,621,582,1.0,2.0
15716,10956,12,10956,1278,4,8,50.0,99.83
15717,6445032,337,0,53615,197,140,1.3333333333333333,0.0
15718,6750396,929,1785072,928253,484,445,1.0,1.26
15719,84,2,84,0,2,0,25.0,67.71
15720,2688,55,2688,827,29,26,5.2631578947368425,71.66
15721,1500,83,0,401,76,7,100.0,0.0
15722,4694760,92,2732664,67167,35,57,9.090909090909092,85.03
15723,6240,32,6240,648,32,0,4.0,9.92
15724,7021176,596,35940,103866,118,478,1.2345679012345678,35.13
15725,504,24,504,239,16,8,7.142857142857143,48.96
15726,192,6,192,42,5,1,16.666666666666668,19.99
15727,7030032,219,0,207860,113,106,2.702702702702702,0.0
15728,1190100,280,0,253335,95,185,33.333333333333336,0.0
15729,64128,7,64128,3581,7,0,11.11111111111111,47.98
15730,7025556,387,0,259591,155,232,2.5641025641025643,0.0
15731,2076,68,1932,1847,27,41,25.0,97.28
15732,3279612,322,0,55902,148,174,2.127659574468085,0.0
15733,7296384,1126,0,1435645,648,478,1.0,0.0
15734,6304356,1152,0,79327,574,578,1.0,0.0
15735,2460,0,2460,0,0,0,50.0,5.0
15736,43188,11,43188,1149,10,1,11.11111111111111,92.55
15737,1248,17,0,634,13,4,100.0,0.0
15738,8412,10,0,1696,10,0,33.333333333333336,0.0
15739,8412,22,8412,387,21,1,5.0,79.41
15740,6782256,2626,2128704,275431,1535,1091,1.0,0.0
15741,108,0,108,0,0,0,100.0,80.0
15742,3485412,286,0,28914,163,123,2.4390243902439024,1.95
15743,7264380,1770,0,76683,1038,732,1.0,0.0
15744,645120,99,0,21994,50,49,5.2631578947368425,2.83
15745,1356,119,1356,1225,67,52,2.272727272727273,52.68
15746,9420,46,0,741,40,6,50.0,0.0
15747,2412,14,1248,647,14,0,6.666666666666667,79.84
15748,6784812,389,2686728,188990,161,228,3.8461538461538463,0.0
15749,6012432,456,5163900,200048,169,287,2.083333333333333,0.0
15750,324,3,324,80,3,0,20.0,68.36
15751,634440,35,634440,1381,13,22,2.127659574468085,0.0
15752,29520,84,29520,1545,58,26,2.5,45.17
15753,5462424,520,5165592,136323,211,309,2.0,0.0
15754,4248540,501,4210836,42603,291,210,1.0,5.0
15755,1140,19,1140,246,15,4,6.666666666666667,79.87
15756,7258020,1053,0,43022,618,435,1.0,0.0
15757,43152,19,43152,458,17,2,7.6923076923076925,48.37
15758,31176,12,31176,1046,12,0,7.142857142857143,82.09
15759,2319552,321,0,44095,166,155,3.703703703703704,4.94
15760,4116,1,4116,3228,1,0,33.333333333333336,72.28
15761,6690792,211,0,225679,128,83,1.3888888888888888,3.55
15762,5859720,416,0,101164,236,180,1.2820512820512822,0.0
15763,5174376,50,5174088,376630,27,23,1.818181818181818,0.0
15764,228,3,228,124,3,0,20.0,61.25
15765,54036,8,840,7072,8,0,12.5,96.64
15766,7692,21,7692,1377,15,6,9.090909090909092,0.0
15767,279564,32,279564,20432,21,11,7.6923076923076925,31.92
15768,2404968,84,2404968,7032,36,48,6.25,74.55
15769,22428,232,0,4489,151,81,100.0,0.0
15770,24936,105,0,3242,79,26,100.0,0.0
15771,7081536,668,5178168,323186,272,396,2.0408163265306123,0.0
15772,1164,29,1164,93,28,1,3.571428571428572,36.8
15773,62856,16,62856,2242,15,1,8.333333333333334,43.87
15774,269772,48,269772,44,42,6,2.5,17.39
15775,2303232,128,2303232,9447,74,54,5.882352941176471,0.0
15776,18564,19,18564,428,18,1,5.882352941176471,78.19
15777,66636,9,66636,776,7,2,16.666666666666668,90.61
15778,345720,301,266706,133631,297,4,2.1739130434782608,97.3
15779,108,0,108,0,0,0,100.0,100.0
15780,76500,23,0,12100,20,3,20.0,0.0
15781,25428,16,25428,2109,16,0,6.666666666666667,85.71
15782,5184564,40,5184564,169671,25,15,6.25,2.0
15783,2741700,147,2741700,131766,64,83,5.0,0.0
15784,5028,21,5028,922,20,1,9.090909090909092,52.41
15785,1200,2,0,1032,1,1,50.0,0.0
15786,5108268,230,0,32125,126,104,2.9411764705882355,2.63
15787,1200,11,1200,996,11,0,7.6923076923076925,84.47
15788,3683580,47,0,86061,39,8,50.0,0.0
15789,78816,72,78816,24219,64,8,1.694915254237288,53.72
15790,112476,91,768,1419,61,30,2.127659574468085,36.09
15791,6281700,236,0,320878,117,119,2.083333333333333,0.0
15792,464484,15,464484,463495,9,6,12.5,88.28
15793,684,1,684,120,1,0,33.333333333333336,79.76
15794,5438244,206,0,79263,117,89,2.9411764705882355,0.0
15795,22536,12,22536,1212,11,1,11.11111111111111,66.73
15796,7116,16,7116,1209,15,1,8.333333333333334,44.6
15797,7300920,447,4220700,326152,221,226,1.5151515151515151,0.35
15798,7045368,153,5138520,1257792,73,80,1.0,0.0
15799,640776,9,640776,144300,3,6,25.0,0.0
15800,49428,31,49428,216,17,14,8.333333333333334,79.86
15801,7352268,13274,0,1169513,7659,5615,1.0,0.0
15802,1068,87,1068,606,47,40,3.4482758620689653,25.46
15803,8232,23,0,1425,20,3,25.0,0.0
15804,51636,20,51636,3,18,2,5.555555555555555,42.85
15805,6036,10,0,1041,7,3,33.333333333333336,0.0
15806,595968,15,0,40738,10,5,33.333333333333336,0.0
15807,1824,40,1824,700,35,5,4.3478260869565215,39.79
15808,25008,120,0,1165,78,42,100.0,0.0
15809,7006488,152,0,479784,78,74,3.8461538461538463,4.0
15810,2174340,37,0,60422,31,6,50.0,0.0
15811,2784,35,1704,788,31,4,7.142857142857143,36.49
15812,7488,21,7488,1142,20,1,5.555555555555555,1.14
15813,0,4,0,0,4,0,100.0,0.0
15814,82152,91,4380,1402,79,12,1.4705882352941178,23.34
15815,4526232,204,0,879863,100,104,4.0,0.0
15816,564,7,0,162,7,0,50.0,0.0
15817,2004,34,2004,786,30,4,5.882352941176471,46.75
15818,50040,281,0,6632,170,111,100.0,0.0
15819,24864,117,0,1047,70,47,100.0,0.0
15820,1224,28,1224,403,28,0,3.333333333333333,58.95
15821,7366800,3240,0,1803429,1813,1427,1.0,2.85
15822,5424864,229,0,63885,116,113,3.333333333333333,5.0
15823,1104,36,1104,42,29,7,4.166666666666667,37.44
15824,31332,52,31332,111,32,20,4.545454545454546,51.84
15825,143220,3,143220,2144,3,0,25.0,97.59
15826,7233084,3808,2270106,1686362,2743,1065,1.0,0.0
15827,28932,127,0,2278,83,44,100.0,0.0
15828,6598596,119,0,68103,103,16,50.0,0.0
15829,1584,35,1584,1029,13,22,25.0,78.43
15830,324,48,324,79,26,22,10.0,82.5
15831,60,0,60,0,0,0,50.0,95.0
15832,348,10,348,156,10,0,8.333333333333334,63.09
15833,1284,6,1284,1096,6,0,12.5,54.57
15834,2614752,390,2614752,35776,202,188,2.4390243902439024,73.77
15835,4743588,246,0,41764,115,131,2.9411764705882355,0.0
15836,2124,256,2124,169,129,127,1.2195121951219512,40.78
15837,6212364,1371,2797224,100123,760,611,1.0,16.83
15838,96,0,96,0,0,0,50.0,80.0
15839,64704,68,64704,815,44,24,3.125,33.2
15840,1152,41,0,691,34,7,100.0,0.0
15841,5219076,277,2643624,48301,154,123,2.631578947368421,82.07
15842,348,149,0,90,70,79,100.0,0.0
15843,6391140,1817,0,88674,1054,763,1.0,0.0
15844,180,17,180,62,13,4,10.0,16.82
15845,90528,11,90528,678,10,1,16.666666666666668,20.11
15846,6024,72,6024,254,60,12,2.083333333333333,20.86
15847,17028,37,0,3895,30,7,100.0,0.0
15848,624,15,624,179,12,3,8.333333333333334,66.49
15849,348,44,348,77,26,18,10.0,61.16
15850,3035220,1,0,3035220,1,0,33.333333333333336,0.0
15851,64212,46,64212,4872,34,12,3.4482758620689653,44.49
15852,1068,44,1068,917,28,16,4.545454545454546,65.97
15853,5477628,494,0,62995,285,209,1.3333333333333333,4.03
15854,1512,17,1512,967,17,0,7.142857142857143,18.69
15855,120,1,120,0,1,0,50.0,99.5
15856,996,37,996,817,32,5,3.0303030303030303,31.15
15857,4933740,147,696,33957,100,47,1.2048192771084338,30.77
15858,435732,494,0,11423,216,278,1.6666666666666667,4.99
15859,3137832,314,0,39570,163,151,2.857142857142857,0.0
15860,7241616,543,0,832209,348,195,1.0,0.0
15861,6530772,320,0,162494,146,174,2.5641025641025643,0.0
15862,1356,40,1356,339,38,2,3.4482758620689653,48.0
15863,240,2,240,114,2,0,50.0,76.85
15864,5217276,46,5217276,186384,22,24,12.5,54.53
15865,3764700,72,0,55711,59,13,100.0,0.0
15866,252,38,156,60,23,15,9.090909090909092,14.39
15867,300,1,300,156,1,0,33.333333333333336,79.5
15868,4686036,1584,0,518717,919,665,1.162790697674419,0.17
15869,7098372,451,0,246344,241,210,1.639344262295082,0.0
15870,10548,27,10548,453,17,10,7.142857142857143,88.58
15871,192552,24,192552,77548,18,6,5.882352941176471,58.07
15872,7323888,52,0,960932,18,34,1.0638297872340423,0.0
15873,106284,72,106284,7752,44,28,3.125,11.59
15874,5921316,836,4413108,55525,389,447,1.0,65.62
15875,67068,135,0,2580,70,65,4.166666666666667,19.17
15876,5231664,160,4733370,86696,101,59,2.3255813953488373,66.66
15877,1829232,160,48060,45747,138,22,100.0,0.0
15878,3887316,1503,1867164,730103,766,737,1.0,0.0
15879,78348,38,78348,237,38,0,2.7777777777777777,48.01
15880,3042216,94,3042216,3341,45,49,4.3478260869565215,74.42
15881,240,27,240,117,27,0,3.4482758620689653,75.66
15882,7210344,720,2815188,174689,401,319,1.3888888888888888,0.0
15883,528,0,528,0,0,0,50.0,80.0
15884,2892,8,2892,963,6,2,16.666666666666668,73.57
15885,54696,193,0,4919,131,62,100.0,0.0
15886,1644,0,1644,0,0,0,1.492537313432836,59.0
15887,1644,80,1248,878,42,38,4.166666666666667,63.3
15888,585552,31,585552,47290,15,16,20.0,94.6
15889,91740,105,0,8160,46,59,8.333333333333334,0.0
15890,2460,14,2460,285,12,2,7.6923076923076925,80.7
15891,321228,2,321228,132,2,0,33.333333333333336,22.19
15892,84600,240,0,9586,148,92,100.0,0.0
15893,52584,74,52584,56,58,16,1.96078431372549,23.1
15894,7400940,3634,0,1123544,2085,1549,1.0,0.0
15895,82188,0,82188,0,0,0,100.0,100.0
15896,24156,11,24156,931,11,0,12.5,15.6
15897,2607588,383,2607588,11684,170,213,2.5641025641025643,66.27
15898,7068804,10107,1080252,1003616,6189,3918,1.0,0.0
15899,840,40,840,295,26,14,4.761904761904762,61.0
15900,31260,130,0,3223,92,38,50.0,0.0
15901,7017468,2100,511584,262904,1077,1023,1.0,2.61
15902,264,34,0,49,23,11,100.0,0.0
15903,12360,2,12360,1914,2,0,33.333333333333336,74.94
15904,1656,104,0,603,93,11,100.0,0.0
15905,161448,16,161448,12999,12,4,8.333333333333334,83.47
15906,456,290,300,232,129,161,1.0,0.0
15907,15252,6,15252,1910,5,1,25.0,58.24
15908,912,77,480,261,52,25,2.857142857142857,40.0
15909,7401432,11230,518700,2041616,5205,6025,1.0,0.0
15910,2023404,309,0,26085,136,173,1.7543859649122806,0.0
15911,18024,13,252,1452,11,2,9.090909090909092,40.03
15912,1308,192,588,312,104,88,1.2345679012345678,54.96
15913,4925304,567,0,34227,273,294,1.2195121951219512,0.0
15914,6958056,490,5246136,50834,291,199,2.127659574468085,0.0
15915,4642308,32,3768,146236,30,2,6.666666666666667,0.0
15916,4867260,639,235500,142758,493,146,1.0,0.0
15917,1992168,57,576,35234,25,32,20.0,92.73
15918,696,58,516,136,50,8,2.083333333333333,37.67
15919,2892,1,0,2892,0,1,50.0,20.0
15920,4959816,158,2520,32473,155,3,1.0,32.41
15921,5076192,1033,0,238822,501,532,1.075268817204301,0.0
15922,7117980,735,0,57123,370,365,1.351351351351351,0.0
15923,7377036,247,3783288,3666031,83,164,1.0,0.0
15924,7055496,782,5251692,123685,381,401,1.1235955056179776,4.2
15925,6563076,279,0,172570,146,133,3.0303030303030303,3.37
15926,6923832,673,0,64445,368,305,1.2195121951219512,0.0
15927,50280,3,0,21764,2,1,50.0,0.0
15928,324,21,324,159,21,0,5.0,0.0
15929,168,13,168,24,11,2,9.090909090909092,45.92
15930,300,3,300,44,3,0,25.0,83.2
15931,7257732,173,0,372630,71,102,2.857142857142857,4.0
15932,174696,6,174696,172310,4,2,50.0,0.0
15933,1092,87,0,409,77,10,100.0,0.0
15934,372,5,0,112,3,2,100.0,0.0
15935,2688192,30,0,893070,20,10,20.0,0.0
15936,6749868,191,0,110537,99,92,3.571428571428572,0.0
15937,2556,39,2556,1628,17,22,11.11111111111111,70.35
15938,2976,0,2976,0,0,0,100.0,100.0
15939,7313352,414,0,889255,265,149,1.25,0.0
15940,7241460,621,0,166481,349,272,1.162790697674419,0.0
15941,1392,47,0,874,35,12,100.0,100.0
15942,2326380,52,0,434767,45,7,25.0,0.0
15943,7095900,215,4706184,3282855,80,135,1.0,0.0
15944,4287876,355,0,44074,193,162,1.7543859649122806,0.0
15945,7307148,2854,286356,1822270,1373,1481,1.0,0.0
15946,6756252,9,0,2138980,9,0,9.090909090909092,0.0
15947,637248,27,33276,47868,24,3,4.545454545454546,70.79
15948,32040,2,660,16020,2,0,50.0,97.0
15949,4263276,36,0,140075,19,17,25.0,0.0
15950,243288,354,243288,90277,339,15,1.6666666666666667,95.81
15951,130056,54,130056,33964,52,2,2.1739130434782608,4.33
15952,14736,10,0,2223,9,1,50.0,0.0
15953,1164,3,1164,536,3,0,25.0,97.19
15954,28416,1,28416,0,1,0,33.333333333333336,62.01
15955,1632,14,1632,126,14,0,6.666666666666667,67.29
15956,7407336,25818,2080839,2127202,14443,11375,1.0,0.0
15957,12600,31,0,2780,28,3,100.0,0.0
15958,46824,108,0,4262,78,30,50.0,0.0
15959,5705340,426,0,22493,248,178,1.0,0.0
15960,3180,42,2856,2725,31,11,3.703703703703704,0.0
15961,1500,64,1500,101,60,4,1.96078431372549,30.46
15962,5497872,23,9216,239414,20,3,5.555555555555555,72.99
15963,5883480,675,0,1488298,350,325,1.6666666666666667,0.0
15964,1710144,173,0,38444,94,79,2.7777777777777777,0.0
15965,159288,462,0,4870,283,179,100.0,0.0
15966,7318560,435,0,4567477,225,210,4.761904761904762,0.0
15967,6578172,270,0,141607,143,127,3.4482758620689653,3.0
15968,126408,11,126408,4194,6,5,20.0,84.84
15969,6962820,375,5171556,167318,179,196,2.5641025641025643,0.0
15970,0,3,0,0,3,0,100.0,0.0
15971,12600,27,12600,932,24,3,4.761904761904762,71.09
15972,4428,3,4428,368,3,0,100.0,100.0
15973,5280252,101,0,552578,45,56,1.5873015873015872,0.0
15974,3084,8,756,669,5,3,14.285714285714286,64.09
15975,7411488,2600,1144662,462632,1497,1103,1.0,0.0
15976,23076,70,0,4133,57,13,50.0,0.0
15977,8940,134,0,1335,94,40,50.0,0.0
15978,3216,12,0,1278,12,0,100.0,0.0
15979,107820,16,107820,1611,14,2,11.11111111111111,91.01
15980,51012,131,0,1687,84,47,100.0,0.0
15981,7282596,2453,0,220167,1399,1054,1.0,0.0
15982,156,32,156,45,23,9,6.25,46.94
15983,12648,141,0,1212,94,47,100.0,0.0
15984,68172,11,68172,921,10,1,14.285714285714286,29.75
15985,192,16,192,48,16,0,5.555555555555555,60.15
15986,7369068,240,0,825205,116,124,1.851851851851852,0.0
15987,466128,59,0,10680,48,11,50.0,0.0
15988,4722216,87,0,54469,39,48,9.090909090909092,0.0
15989,5232696,626,0,29403,354,272,1.351351351351351,0.0
15990,1068,53,1068,432,41,12,2.702702702702702,48.25
15991,168,54,168,21,54,0,1.7857142857142858,27.68
15992,1176,46,1176,310,34,12,3.571428571428572,39.35
15993,7441488,980,3268128,4197188,617,363,1.0,0.0
15994,156,18,156,46,11,7,16.666666666666668,61.27
15995,17940,14,0,4160,13,1,11.11111111111111,0.0
15996,2824560,41,2824560,1816,24,17,11.11111111111111,92.33
15997,456,32,456,244,20,12,6.25,74.47
15998,7390596,2135,42636,1046334,1185,950,1.0,0.0
15999,5482752,294,4128972,616167,119,175,2.5641025641025643,0.0
16000,348,8,348,73,6,2,16.666666666666668,68.42
16001,7415772,1236,0,2657207,788,448,1.0,0.0
16002,1248,7,1248,3,7,0,11.11111111111111,63.0
16003,2826792,104,2826792,22052,49,55,5.2631578947368425,77.8
16004,17028,8,17028,7198,7,1,16.666666666666668,33.56
16005,1476,76,1476,403,74,2,1.3333333333333333,26.96
16006,6234240,2057,0,33257,1194,863,1.0,0.0
16007,264,189,0,57,99,90,100.0,0.0
16008,4835100,26,122700,527245,22,4,33.333333333333336,0.0
16009,624,15,624,66,9,6,33.333333333333336,21.25
16010,1272,36,1272,9,29,7,4.761904761904762,35.68
16011,360,12,360,261,6,6,20.0,99.13
16012,169752,14,169752,13800,13,1,7.142857142857143,84.53
16013,6281100,489,0,60129,252,237,1.7543859649122806,0.0
16014,5034084,239,0,162919,113,126,5.882352941176471,1.0
16015,2247120,13,2247120,279,7,6,16.666666666666668,72.07
16016,2652,7,2652,96,7,0,25.0,96.88
16017,3269688,2,684,1673676,1,1,50.0,95.0
16018,384,13,384,251,5,8,33.333333333333336,71.6
16019,9624,14,9624,55,14,0,6.25,54.09
16020,408,17,384,158,14,3,8.333333333333334,51.76
16021,5155260,147,0,68597,68,79,3.703703703703704,0.0
16022,2994060,303,1669506,173294,132,171,2.9411764705882355,57.7
16023,4344,29,0,1297,28,1,3.225806451612903,25.0
16024,43344,20,43344,3160,20,0,5.882352941176471,17.94
16025,804,10,804,643,10,0,9.090909090909092,80.0
16026,80160,55,79452,79514,47,8,100.0,100.0
16027,177372,13,177372,518,13,0,7.142857142857143,75.9
16028,6396,143,252,163,121,22,1.0,30.32
16029,3149592,18,3149592,2334,12,6,7.6923076923076925,2.0
16030,540,86,540,298,52,34,2.702702702702702,46.34
16031,2028,32,2028,12,26,6,4.545454545454546,36.23
16032,2672112,62,2672112,791,52,10,2.380952380952381,20.78
16033,336,11,336,141,11,0,7.6923076923076925,66.2
16034,1416,42,1416,638,36,6,3.125,53.15
16035,3724380,509,0,8967,223,286,2.3255813953488373,0.0
16036,252,32,252,11,32,0,2.9411764705882355,22.07
16037,324,8,324,13,8,0,10.0,59.0
16038,132,12,132,61,8,4,12.5,62.84
16039,252,0,252,0,0,0,50.0,59.29
16040,540,160,504,115,86,74,3.225806451612903,72.92
16041,5925060,683,0,608036,276,407,2.857142857142857,0.0
16042,7467552,2411,171018,1613305,1356,1055,1.0,0.33
16043,587712,71,0,21668,58,13,50.0,0.0
16044,3241908,188,3241908,6850,84,104,2.631578947368421,70.39
16045,40440,225,40236,9097,191,34,1.0,1.84
16046,4128,74,4128,1208,52,22,2.702702702702702,84.58
16047,684,4,684,216,3,1,33.333333333333336,94.77
16048,7411128,1534,0,113100,814,720,1.0,0.65
16049,5528436,560,0,71743,293,267,1.3888888888888888,2.38
16050,9432,103,708,370,78,25,1.6129032258064515,32.53
16051,1440,32,1440,397,30,2,3.225806451612903,50.84
16052,336,4,336,60,4,0,100.0,100.0
16053,600,1,600,0,1,0,33.333333333333336,88.6
16054,3072948,210,2680824,4994,93,117,7.142857142857143,44.0
16055,9756,10,9756,1158,10,0,11.11111111111111,16.9
16056,4562556,163,0,29868,112,51,100.0,0.0
16057,95076,288,0,5915,199,89,100.0,0.0
16058,7188720,1154,0,192841,682,472,1.0,0.0
16059,66960,0,66960,0,0,0,100.0,100.0
16060,5453040,360,0,31883,215,145,1.0,0.0
16061,7408668,1185,0,193528,699,486,1.0,0.0
16062,6745932,1953,4368996,99527,1114,839,1.0,0.0
16063,432,25,432,112,25,0,4.166666666666667,76.11
16064,41292,28,41292,7664,13,15,16.666666666666668,86.53
16065,7294344,82,7294344,83498,42,40,5.0,0.0
16066,1008,4,1008,441,3,1,33.333333333333336,89.68
16067,37116,73,0,1907,57,16,50.0,0.0
16068,71928,44,71928,376,42,2,2.631578947368421,48.07
16069,34716,167,0,3994,102,65,100.0,0.0
16070,6695808,269,0,532218,137,132,2.631578947368421,0.0
16071,5325840,27,5325840,15836,21,6,5.555555555555555,0.0
16072,636,12,636,177,10,2,12.5,84.15
16073,7277988,193,0,46078,113,80,3.0303030303030303,18.75
16074,37620,136,0,2320,88,48,50.0,0.0
16075,37212,239,0,4283,146,93,100.0,0.0
16076,720,2,720,210,1,1,100.0,100.0
16077,2351916,147,2324484,120977,69,78,3.125,38.83
16078,254676,2,254676,60,1,1,100.0,99.99
16079,2591184,110,2591184,39582,57,53,7.142857142857143,0.0
16080,2988,34,2988,2631,33,1,2.857142857142857,37.39
16081,12876,5,12876,1130,4,1,20.0,28.65
16082,5713344,757,5329392,47376,372,385,1.0,2.17
16083,348,52,348,46,39,13,2.9411764705882355,74.77
16084,492,47,492,314,37,10,3.703703703703704,60.37
16085,7188,5,7188,1044,5,0,14.285714285714286,95.4
16086,1572,1,1572,24,1,0,50.0,0.0
16087,2688,6,2688,558,3,3,100.0,100.0
16088,2724,104,2724,228,82,22,1.36986301369863,49.24
16089,803544,23,11982,36301,23,0,4.545454545454546,3.92
16090,744,9,744,225,7,2,16.666666666666668,95.23
16091,960,61,960,48,49,12,2.3255813953488373,91.39
16092,14064,17,14064,2342,17,0,5.0,22.9
16093,81060,1,81060,336,1,0,50.0,98.0
16094,2144196,264,0,221694,122,142,3.333333333333333,0.0
16095,2464428,220,2464428,1405,108,112,3.333333333333333,75.53
16096,7401228,466,0,919471,171,295,1.0,0.12
16097,485784,148,0,9093,57,91,9.090909090909092,0.0
16098,7490832,23392,1352196,2496113,14213,9179,1.0,1.51
16099,1548,28,1548,871,21,7,8.333333333333334,74.6
16100,6789300,257,5246076,562631,124,133,1.3157894736842106,0.0
16101,1404,90,0,634,79,11,100.0,0.0
16102,5378964,224,5378964,96209,119,105,2.631578947368421,70.27
16103,5703312,448,5332356,114519,180,268,1.9230769230769231,5.0
16104,372,11,372,64,6,5,100.0,100.0
16105,7099776,358,0,256410,171,187,1.96078431372549,0.0
16106,6517620,216,0,93141,95,121,3.125,0.0
16107,18960,16,18960,16,14,2,7.142857142857143,55.53
16108,2436,37,96,157,33,4,3.125,29.73
16109,1140,7,1140,624,7,0,11.11111111111111,90.76
16110,11328,15,11328,3493,14,1,7.6923076923076925,79.02
16111,5759040,209,5759040,53624,103,106,2.5,78.44
16112,5957844,566,5245032,314817,270,296,1.25,2.14
16113,840,0,756,0,0,0,50.0,31.09
16114,91476,57,91476,493,55,2,1.9230769230769231,49.87
16115,3752904,412,0,27316,177,235,2.380952380952381,10.0
16116,7477200,3915,0,714530,2199,1716,1.0,0.0
16117,5365308,560,5352714,23247,216,344,1.8867924528301887,76.4
16118,1788,89,1788,423,69,20,1.851851851851852,45.1
16119,1320,109,0,332,103,6,100.0,0.0
16120,4008,1,4008,0,1,0,33.333333333333336,46.72
16121,8808,3,8808,2360,3,0,20.0,81.75
16122,4572000,315,0,94167,172,143,1.4705882352941178,0.0
16123,4769940,212,0,52733,98,114,2.7777777777777777,9.0
16124,97584,2,97584,97386,2,0,25.0,37.92
16125,1224,4,1224,393,2,2,100.0,0.0
16126,516,175,516,69,93,82,2.0408163265306123,65.95
16127,3292452,2,0,1646268,1,1,50.0,0.0
16128,192,6,192,22,6,0,12.5,88.0
16129,300,8,0,153,5,3,20.0,0.0
16130,7061952,53,7061952,3951,29,24,5.2631578947368425,72.26
16131,84588,6,84588,280,6,0,14.285714285714286,0.0
16132,456,19,456,168,11,8,33.333333333333336,0.0
16133,1668,69,1668,523,52,17,2.380952380952381,54.2
16134,1030812,19,9924,54726,19,0,5.555555555555555,71.07
16135,3876,254,3876,3192,134,120,1.4705882352941178,42.31
16136,6904992,419,2846112,313686,168,251,2.857142857142857,0.0
16137,45492,160,7524,929,89,71,2.702702702702702,13.37
16138,21528,59,0,1306,47,12,50.0,0.0
16139,7299108,81,456,90256,43,38,4.0,58.76
16140,7479360,16378,0,566489,11727,4651,1.0,10.0
16141,1671156,13,148152,129329,12,1,9.090909090909092,43.46
16142,23556,21,23556,669,19,2,5.882352941176471,73.82
16143,6217404,387,0,56053,204,183,1.9230769230769231,0.0
16144,1608,3,1608,8,3,0,12.5,92.5
16145,684,36,684,348,28,8,4.761904761904762,46.93
16146,2919300,458,2919300,263263,192,266,6.25,0.0
16147,1387740,33,600752,18451,28,5,8.333333333333334,6.69
16148,4919940,146,0,34178,102,44,100.0,0.0
16149,175428,44,175428,42279,43,1,2.4390243902439024,21.02
16150,7506828,4581,1132164,1804131,2525,2056,1.0,0.0
16151,21756,3,21756,9828,3,0,33.333333333333336,49.41
16152,7152,23,7152,733,22,1,5.2631578947368425,0.0
16153,2028,103,0,864,71,32,100.0,0.0
16154,32352,189,0,2148,129,60,50.0,0.0
16155,7263012,1337,0,138681,772,565,1.0,0.3
16156,2544900,57,0,176679,45,12,25.0,0.0
16157,7516944,19419,4308018,3247413,11898,7521,1.0,3.1
16158,17100,3,17100,8476,3,0,25.0,21.12
16159,15240,2,15240,1056,2,0,50.0,99.96
16160,2585640,60,2585640,2913,27,33,5.882352941176471,60.12
16161,15576,1,15576,1644,1,0,50.0,99.97
16162,1595088,241,0,68047,123,118,2.1739130434782608,0.0
16163,334224,1,334224,2988,1,0,50.0,70.05
16164,190248,126,172884,61288,124,2,4.545454545454546,98.59
16165,2270844,12,0,473334,7,5,25.0,20.0
16166,4224,21,4224,579,19,2,6.25,36.87
16167,3901524,2,0,1950894,0,2,1.0,0.0
16168,1632,96,1632,846,65,31,2.083333333333333,43.77
16169,55224,8,55224,1041,8,0,20.0,88.65
16170,4884,69,4884,3431,52,17,2.272727272727273,35.03
16171,1008,22,1008,887,21,1,4.545454545454546,72.07
16172,9264,7,9264,606,7,0,100.0,100.0
16173,88728,2,88728,3882,2,0,50.0,99.77
16174,7193424,112,0,133469,55,57,7.142857142857143,7.0
16175,262224,16,167220,34604,12,4,7.142857142857143,85.92
16176,1584,29,1584,619,28,1,3.333333333333333,70.19
16177,7494864,4227,1280088,1040961,1968,2259,1.0,0.0
16178,300,48,300,79,38,10,2.857142857142857,50.2
16179,294852,395,135000,43062,371,24,1.0,34.3
16180,507564,12,507564,151966,10,2,11.11111111111111,75.33
16181,13644,9,13644,3918,9,0,6.25,2.19
16182,6768,353,0,2752,208,145,100.0,0.0
16183,5671584,48,0,799857,38,10,25.0,0.0
16184,4380,39,4380,1395,33,6,5.882352941176471,0.0
16185,6156,11,0,2030,6,5,20.0,42.38
16186,39828,128,0,2555,92,36,50.0,0.0
16187,7212744,747,0,109466,340,407,1.4705882352941178,0.0
16188,3169416,23,1584,274188,21,2,10.0,0.0
16189,9144,21,9144,858,21,0,5.0,74.2
16190,264,25,264,7,21,4,5.2631578947368425,42.98
16191,2697156,94,2697156,359186,50,44,3.571428571428572,0.0
16192,535668,259,0,99855,219,40,50.0,0.0
16193,7116,20,7116,467,20,0,5.555555555555555,74.75
16194,2512404,2,0,1405908,2,0,100.0,100.0
16195,7532088,12688,3076560,2023164,7885,4803,1.0,0.0
16196,417936,135,417936,4053,101,34,1.3157894736842106,42.87
16197,7506948,220,0,101381,115,105,4.166666666666667,0.0
16198,1373256,68,0,20346,36,32,6.666666666666667,0.0
16199,6398028,1418,0,52320,822,596,1.0,0.0
16200,57420,52,57420,247,40,12,3.0303030303030303,9.58
16201,1512,3,1512,604,3,0,33.333333333333336,60.49
16202,456,28,456,242,14,14,11.11111111111111,58.4
16203,4236,60,3660,1711,45,15,2.5641025641025643,32.29
16204,660,41,660,514,19,22,12.5,91.3
16205,23328,253,0,2286,152,101,100.0,0.0
16206,2412,13,2412,1214,9,4,20.0,79.73
16207,696,36,696,152,24,12,4.0,40.8
16208,24084,342,0,6176,190,152,100.0,0.0
16209,18084,3,18084,560,3,0,25.0,88.53
16210,76884,4,76884,576,3,1,33.333333333333336,99.13
16211,2805900,130,0,22752,90,40,100.0,0.0
16212,504,5,504,225,3,2,33.333333333333336,97.18
16213,21912,478,0,4216,297,181,100.0,0.0
16214,264,0,264,0,0,0,50.0,88.0
16215,444,17,444,174,8,9,25.0,1.0
16216,6516,10,4374,1983,9,1,25.0,73.4
16217,11520,121,0,1766,79,42,50.0,0.0
16218,540,22,540,218,12,10,12.5,22.71
16219,15324,12,15324,417,12,0,10.0,0.0
16220,7337736,389,0,2526282,150,239,1.0,39.58
16221,80520,23,80520,317,18,5,5.555555555555555,88.61
16222,75012,0,75012,0,0,0,50.0,66.0
16223,6976980,16,312,1308318,9,7,14.285714285714286,13.57
16224,4224,144,4224,252,135,9,1.0,79.41
16225,288,66,0,85,29,37,100.0,0.0
16226,18240,473,504,235,243,230,1.0,24.22
16227,5135472,273,0,100006,150,123,2.083333333333333,5.0
16228,7264896,391,0,57715,200,191,1.9230769230769231,0.0
16229,192,192,0,75,115,77,100.0,0.0
16230,1212,47,108,74,36,11,3.125,28.74
16231,168,10,168,57,7,3,16.666666666666668,60.82
16232,252,27,132,46,17,10,7.6923076923076925,55.73
16233,1116,52,1116,78,39,13,2.9411764705882355,36.04
16234,1068,5,1068,276,3,2,25.0,17.66
16235,6515784,221,0,133261,115,106,3.0303030303030303,0.0
16236,4920,73,4920,113,52,21,2.4390243902439024,46.46
16237,7177440,388,0,124721,181,207,1.818181818181818,3.95
16238,144,4,144,51,4,0,16.666666666666668,92.0
16239,88428,16,88428,5706,14,2,14.285714285714286,37.51
16240,1296,65,1296,345,59,6,1.7857142857142858,30.43
16241,52284,32,52284,4332,28,4,3.571428571428572,68.05
16242,7416504,442,1385304,758100,259,183,1.0,0.0
16243,7481880,4506,1176120,652674,1850,2656,1.0,0.0
16244,7208172,20,7208172,2618707,13,7,16.666666666666668,85.81
16245,2578512,121,1332456,52570,95,26,1.162790697674419,0.0
16246,1260,10,1260,452,7,3,16.666666666666668,47.03
16247,1188,16,1188,1142,8,8,16.666666666666668,97.02
16248,33792,4,33792,495,4,0,25.0,98.01
16249,540,12,540,235,9,3,7.142857142857143,44.34
16250,324,20,132,60,15,5,8.333333333333334,44.17
16251,4958340,190,900,53176,92,98,1.1904761904761905,39.64
16252,89292,12,89292,716,12,0,7.142857142857143,82.31
16253,636,18,636,160,18,0,5.0,67.31
16254,4036644,613,0,61347,267,346,1.492537313432836,0.0
16255,30972,65,0,5351,56,9,100.0,0.0
16256,7495896,1237,0,658213,752,485,1.0,3.0
16257,1824,74,0,491,65,9,100.0,0.0
16258,768,48,768,403,35,13,3.225806451612903,74.51
16259,5881944,1269,0,47720,714,555,1.0,0.0
16260,960,44,960,614,42,2,2.272727272727273,34.67
16261,5234844,187,0,80903,96,91,2.7777777777777777,0.5
16262,78588,74,0,13571,33,41,9.090909090909092,0.0
16263,12276,17,996,964,12,5,11.11111111111111,22.19
16264,45744,167,40404,9204,144,23,1.1363636363636365,1.49
16265,82404,34,82404,1688,28,6,2.9411764705882355,27.7
16266,4862484,177,0,47154,95,82,4.761904761904762,0.0
16267,7454868,9815,0,1159695,6391,3424,1.0,0.0
16268,312,36,312,103,24,12,5.0,53.7
16269,4965960,260,3735012,63065,135,125,2.2222222222222223,76.08
16270,6859440,432,6859440,105603,189,243,1.7241379310344829,40.84
16271,23160,271,0,5146,163,108,100.0,0.0
16272,31620,137,0,2992,91,46,50.0,0.0
16273,16104,274,0,3237,171,103,100.0,0.0
16274,108,5,108,62,3,2,100.0,100.0
16275,4613904,190,0,79900,100,90,2.4390243902439024,2.38
16276,384,29,384,4,29,0,3.225806451612903,24.66
16277,108,3,108,8,3,0,20.0,54.9
16278,11412,6,11412,11086,6,0,12.5,77.83
16279,420,33,372,126,33,0,3.703703703703704,72.26
16280,636,115,0,264,78,37,100.0,0.0
16281,79644,38,0,11542,18,20,10.0,6.29
16282,1668,123,0,581,107,16,100.0,0.0
16283,528,12,528,393,5,7,33.333333333333336,79.26
16284,5542560,273,0,72597,134,139,2.0,3.0
16285,1908,20,1908,715,18,2,5.2631578947368425,85.29
16286,1006176,295,0,4878,120,175,2.4390243902439024,1.6
16287,33624,39,936,1362,35,4,3.0303030303030303,64.37
16288,82200,137,0,4511,64,73,4.3478260869565215,3.71
16289,2268,3,2268,768,3,0,33.333333333333336,46.0
16290,1032,17,1032,400,7,10,25.0,97.62
16291,65088,268,24772,5616,85,183,1.6666666666666667,37.81
16292,22236,7,132,3264,5,2,25.0,98.25
16293,97800,0,97800,0,0,0,100.0,100.0
16294,33180,5,33180,0,5,0,14.285714285714286,55.2
16295,1104,10,1104,310,7,3,16.666666666666668,67.89
16296,7125972,87,7125972,94026,37,50,7.142857142857143,82.05
16297,5784,25,5784,235,23,2,4.3478260869565215,77.98
16298,360,24,360,113,14,10,9.090909090909092,94.28
16299,2082216,163,0,26807,69,94,5.0,6.0
16300,7567884,5550,0,1452736,3269,2281,1.0,0.0
16301,58164,148,0,3388,100,48,50.0,0.0
16302,49812,17,49812,2673,17,0,5.882352941176471,13.93
16303,324,13,0,270,9,4,100.0,0.0
16304,63480,393,0,9185,244,149,100.0,0.0
16305,268212,15,268212,268026,7,8,20.0,6.86
16306,2373288,9,2373288,25944,7,2,14.285714285714286,78.9
16307,5052,1,0,5052,0,1,50.0,0.0
16308,1356,123,0,340,113,10,100.0,0.0
16309,144,12,144,25,10,2,9.090909090909092,49.66
16310,444,1,444,0,1,0,100.0,100.0
16311,56724,34,56724,5390,32,2,3.333333333333333,50.95
16312,396,8,396,162,6,2,20.0,94.18
16313,684,8,684,114,5,3,25.0,98.2
16314,540,31,540,330,23,8,4.761904761904762,67.38
16315,5964096,1068,3087468,144609,441,627,1.0,1.96
16316,31056,145,0,2893,101,44,50.0,0.0
16317,29904,44,29904,4438,34,10,3.225806451612903,75.55
16318,35040,3,35040,11684,2,1,33.333333333333336,25.64
16319,3024,42,3024,1215,38,4,5.0,23.79
16320,12312,18,12312,975,11,7,16.666666666666668,57.35
16321,29904,5,29904,6297,5,0,16.666666666666668,0.0
16322,396,35,396,65,31,4,3.333333333333333,46.73
16323,252,1,252,168,1,0,100.0,100.0
16324,7510860,1735,2563974,1713588,991,744,1.0,0.0
16325,262764,71,60336,7961,67,4,1.5384615384615383,28.74
16326,75096,81,75096,562,60,21,2.4390243902439024,68.13
16327,7324152,8627,1102044,2233223,3723,4904,1.0,0.0
16328,384,16,384,206,8,8,16.666666666666668,82.52
16329,4843968,142,0,184662,74,68,2.857142857142857,4.0
16330,7430676,227,7430676,40113,100,127,3.333333333333333,62.59
16331,7579716,33510,0,2187712,22939,10571,1.0,7.4
16332,14148,6,14148,840,6,0,14.285714285714286,81.4
16333,588,29,588,125,20,9,7.142857142857143,38.55
16334,23784,29,23784,1080,27,2,3.571428571428572,63.38
16335,1320,92,0,356,74,18,100.0,0.0
16336,767220,141,767220,1590,107,34,1.1764705882352942,25.26
16337,2448,10,2448,2368,8,2,12.5,64.16
16338,7367340,6162,2379168,499704,3937,2225,1.0,0.0
16339,3348,77,3348,451,77,0,1.36986301369863,83.1
16340,6661212,339,0,93345,193,146,1.8867924528301887,0.5
16341,3504,0,3504,0,0,0,100.0,100.0
16342,7581048,6579,2113204,1060091,3978,2601,1.0,0.0
16343,1428,8,1428,360,7,1,12.5,84.5
16344,5905836,99,0,198248,60,39,2.380952380952381,0.0
16345,108,21,96,38,17,4,6.666666666666667,35.63
16346,6294096,1263,5424060,45855,649,614,1.0,0.0
16347,324,2,324,54,2,0,25.0,61.57
16348,212016,8,212016,72939,4,4,33.333333333333336,99.55
16349,6595380,1178,5425536,91568,614,564,1.0,1.65
16350,49056,5,49056,1101,5,0,16.666666666666668,89.68
16351,1728,25,1728,691,16,9,16.666666666666668,88.32
16352,7157436,1634,5425716,698374,795,839,1.0,0.0
16353,128184,164,1188,1923,106,58,1.0101010101010102,22.69
16354,6765324,1210,0,135158,591,619,1.0,0.0
16355,515928,34,258534,185136,33,1,5.0,14.1
16356,7414620,922,0,153070,348,574,1.0,7.46
16357,123552,24,123552,2660,24,0,3.8461538461538463,69.92
16358,39300,147,19824,130,42,105,7.142857142857143,83.65
16359,781572,2,96,390804,2,0,50.0,99.04
16360,2074308,7,972,296494,4,3,33.333333333333336,95.13
16361,6330216,436,5428440,69241,266,170,1.0,20.0
16362,1464,45,1464,1362,23,22,7.142857142857143,75.33
16363,13224,28,13224,2765,24,4,8.333333333333334,0.0
16364,23652,176,1224,1308,111,65,1.2658227848101269,0.0
16365,2160,234,2160,1912,139,95,1.098901098901099,35.8
16366,989556,465,0,77487,216,249,1.6129032258064515,0.0
16367,7220316,1607,0,648543,923,684,1.0,0.0
16368,588,40,588,422,40,0,2.4390243902439024,38.39
16369,1204200,84,1204200,1004,84,0,1.1904761904761905,0.0
16370,7596060,6173,1535487,2489307,3493,2680,1.0,0.21
16371,136968,10,136968,50,5,5,100.0,100.0
16372,900,19,900,306,11,8,12.5,93.64
16373,1027752,372,0,12179,98,274,4.3478260869565215,0.0
16374,828,40,828,105,32,8,3.333333333333333,60.78
16375,1013928,5,177900,251882,4,1,33.333333333333336,0.01
16376,3689724,652,582420,98480,182,470,2.631578947368421,0.0
16377,364080,46,5364,10571,39,7,6.666666666666667,0.0
16378,3864,39,3864,3782,23,16,5.882352941176471,64.17
16379,30864,71,0,2113,59,12,50.0,0.0
16380,972,72,972,582,34,38,5.882352941176471,81.2
16381,132,7,0,29,7,0,12.5,0.0
16382,7394916,1069,3021288,102686,437,632,1.0,2.5
16383,985860,3,985860,594328,3,0,25.0,41.78
16384,1896,23,1896,605,21,2,9.090909090909092,0.0
16385,4313640,29,4313640,2880,22,7,7.6923076923076925,83.33
16386,7206000,2311,0,269308,1159,1152,1.0,0.0
16387,1368,53,1368,10,41,12,2.702702702702702,37.14
16388,6576876,138,0,96372,60,78,4.761904761904762,0.0
16389,31524,134,0,2154,92,42,100.0,0.0
16390,756,6,756,56,4,2,20.0,16.11
16391,221460,0,221460,0,0,0,100.0,100.0
16392,17220,55,17220,1302,42,13,2.7777777777777777,54.28
16393,132,32,132,25,30,2,3.225806451612903,34.43
16394,7163568,90,7163568,96506,44,46,4.3478260869565215,76.41
16395,41664,33,41664,28016,27,6,4.3478260869565215,41.38
16396,2675580,144,2675580,2822,64,80,4.545454545454546,70.91
16397,7603920,5870,0,2811273,3620,2250,1.0,0.0
16398,7163664,94,7163664,3187,42,52,5.555555555555555,81.47
16399,4917312,218,0,95823,111,107,3.4482758620689653,0.0
16400,15552,76,15552,112,68,8,1.5151515151515151,10.73
16401,7605672,15048,628572,1646769,8126,6922,1.0,0.0
16402,120,7,120,27,7,0,11.11111111111111,5.36
16403,7028844,1294,0,171882,706,588,1.0,2.88
16404,7692,20,7692,391,20,0,5.2631578947368425,74.05
16405,6495744,243,0,122821,121,122,3.125,0.0
16406,1608,132,1608,1148,74,58,2.127659574468085,52.17
16407,2854884,77,0,61030,43,34,14.285714285714286,0.62
16408,444,1,444,360,1,0,50.0,95.25
16409,5931948,1158,0,80130,664,494,1.0,0.0
16410,11412,262,0,3036,163,99,100.0,0.0
16411,46836,179,0,3498,105,74,100.0,0.0
16412,4990704,289,165828,101597,221,68,1.0,0.0
16413,43380,112,0,2418,74,38,100.0,0.0
16414,2420148,200,0,22329,98,102,2.9411764705882355,4.0
16415,7617084,101174,4309346,3413236,57852,43322,1.0,0.0
16416,4956852,23,3552,462727,21,2,5.555555555555555,75.93
16417,2700,90,2700,115,37,53,8.333333333333334,88.63
16418,4864200,325,2693910,42232,191,134,1.2345679012345678,0.0
16419,14940,155,0,1487,95,60,100.0,0.0
16420,7508988,3221,25968,440412,1778,1443,1.0,0.0
16421,453732,14,447744,56260,14,0,6.666666666666667,27.16
16422,388896,808,162271,46725,772,36,1.0,51.8
16423,5553636,31,108036,453975,25,6,8.333333333333334,33.1
16424,1119984,19,6888,92418,18,1,6.25,76.62
16425,30108,5,30108,4084,5,0,20.0,76.26
16426,18036,81,18036,908,63,18,1.851851851851852,56.01
16427,17268,0,17268,0,0,0,100.0,100.0
16428,1749840,60,0,121107,50,10,50.0,0.0
16429,14892,23,14892,496,20,3,9.090909090909092,0.0
16430,4005168,20,5532,200670,20,0,5.555555555555555,77.53
16431,5271132,123,5271132,68938,61,62,3.8461538461538463,82.26
16432,4008,21,4008,1145,19,2,7.6923076923076925,25.05
16433,65568,68,0,2998,55,13,100.0,0.0
16434,5232,30,2364,897,26,4,7.6923076923076925,45.03
16435,252,6,252,82,4,2,25.0,74.64
16436,2544,20,2496,903,18,2,9.090909090909092,0.0
16437,5468148,247,5467548,104636,147,100,1.0,0.0
16438,2784,6,2784,200,6,0,14.285714285714286,0.0
16439,3048,18,3048,741,17,1,7.6923076923076925,0.0
16440,177672,6,177672,1336,6,0,20.0,94.56
16441,176988,4,176988,501,4,0,33.333333333333336,98.04
16442,3110076,361,3110076,13478,199,162,2.0408163265306123,79.2
16443,89676,4,89676,348,4,0,25.0,90.63
16444,2568,55,2568,2106,35,20,3.8461538461538463,49.36
16445,7630884,36526,3578374,2180560,23952,12574,1.0,0.0
16446,7358844,1678,1252980,631660,1080,598,1.6129032258064515,0.34
16447,30336,14,30336,418,10,4,7.6923076923076925,80.65
16448,1092,22,0,548,19,3,100.0,0.0
16449,7584192,6137,0,1719732,4065,2072,1.0,0.0
16450,3878544,553,0,206487,272,281,3.333333333333333,0.0
16451,2616,40,2616,1087,39,1,2.5641025641025643,66.44
16452,1495428,20,3984,298710,16,4,16.666666666666668,55.73
16453,420,20,360,112,14,6,9.090909090909092,57.98
16454,924,34,924,278,28,6,3.703703703703704,72.29
16455,5436,12,5436,1307,11,1,20.0,78.11
16456,960,8,960,226,7,1,14.285714285714286,69.37
16457,312,61,312,71,35,26,4.166666666666667,54.51
16458,888,47,888,97,35,12,3.4482758620689653,9.98
16459,2304,6,2304,408,5,1,20.0,89.61
16460,636,17,636,225,16,1,8.333333333333334,58.0
16461,6975372,516,5342808,114411,284,232,1.5873015873015872,0.0
16462,11364,11,2616,1862,5,6,12.5,48.27
16463,6450324,849,0,113683,471,378,1.0416666666666667,1.86
16464,2984460,87,698388,138445,63,24,1.8867924528301887,4.0
16465,119760,4,119760,7944,4,0,100.0,100.0
16466,6863712,2273,1075132,168050,1310,963,1.075268817204301,0.0
16467,33396,7,33396,822,5,2,16.666666666666668,89.85
16468,72,0,72,0,0,0,50.0,60.84
16469,53940,19,0,3544,9,10,50.0,0.0
16470,144,5,144,12,5,0,14.285714285714286,70.42
16471,1024344,17,0,60532,11,6,12.5,10.64
16472,696,124,696,252,88,36,1.3888888888888888,49.5
16473,564,35,564,176,21,14,7.6923076923076925,67.55
16474,312,3,312,8,3,0,20.0,66.29
16475,636252,73,0,11218,59,14,100.0,0.0
16476,7628364,1026,0,1084676,448,578,1.0,0.0
16477,228,10,228,38,6,4,16.666666666666668,74.63
16478,1999284,14,48,142822,12,2,9.090909090909092,76.79
16479,75684,150,732,1894,119,31,1.0,32.01
16480,13632,1567,13536,8722,1355,212,1.0,80.17
16481,84,39,84,20,33,6,3.125,34.14
16482,196944,87,0,2872,32,55,20.0,0.0
16483,7401000,540,0,103811,277,263,1.3333333333333333,2.0
16484,32040,246,0,4114,154,92,100.0,0.0
16485,5051544,155,3411564,190768,75,80,3.125,78.68
16486,1044,18,1044,620,13,5,11.11111111111111,99.17
16487,12,1,0,12,1,0,33.333333333333336,0.0
16488,432,38,432,42,24,14,4.545454545454546,37.51
16489,7535712,370,0,99035,222,148,1.4705882352941178,0.5
16490,396348,29,792,13889,28,1,3.333333333333333,40.9
16491,2673048,1900,1718286,102293,946,954,1.0,62.61
16492,32556,176,0,3761,111,65,100.0,0.0
16493,184776,4,184776,240,2,2,50.0,5.0
16494,216,2,216,54,2,0,50.0,95.24
16495,287364,234,35280,11095,206,28,1.0,2.32
16496,264,16,264,74,9,7,11.11111111111111,20.33
16497,13032,356,0,3146,205,151,100.0,0.0
16498,618732,303,0,8882,169,134,1.9230769230769231,0.0
16499,1392,172,1392,1034,116,56,5.882352941176471,97.12
16500,48,4,48,21,3,1,25.0,47.23
16501,7516944,9061,67380,218694,4483,4578,1.0,0.0
16502,1368,125,0,429,104,21,100.0,0.0
16503,6944844,642,5266608,334568,241,401,1.96078431372549,0.0
16504,864,0,864,0,0,0,100.0,100.0
16505,120,2,120,30,1,1,100.0,100.0
16506,16956,106,16956,731,76,30,1.3157894736842106,31.85
16507,6848304,82,14424,85473,50,32,4.166666666666667,77.41
16508,6356820,799,0,110010,420,379,1.0101010101010102,0.0
16509,1164,11,1164,69,9,2,11.11111111111111,86.04
16510,215928,53,215928,911,37,16,3.4482758620689653,75.38
16511,7380,2,7380,186,2,0,33.333333333333336,99.51
16512,2184,8,1200,1174,7,1,100.0,100.0
16513,5349720,115,5349720,13445,56,59,4.761904761904762,75.29
16514,204,162,204,83,132,30,1.0,30.16
16515,43584,26,22500,1957,26,0,3.333333333333333,51.87
16516,516,20,516,93,18,2,5.882352941176471,78.96
16517,5059176,67,3203268,449177,51,16,2.1739130434782608,47.62
16518,672,0,672,0,0,0,50.0,65.0
16519,1248,165,0,435,109,56,100.0,0.0
16520,30048,24,300,1303,18,6,6.666666666666667,42.34
16521,7213008,223,0,152249,109,114,2.702702702702702,0.0
16522,38268,1,38268,4704,1,0,33.333333333333336,82.59
16523,2592,12,2592,143,12,0,7.142857142857143,86.46
16524,15960,3,15960,1780,3,0,25.0,99.43
16525,336,29,336,42,18,11,6.666666666666667,80.3
16526,4919892,32,120,308302,28,4,3.571428571428572,43.61
16527,674784,288,0,3625,159,129,2.0,0.0
16528,2988,65,168,139,49,16,2.380952380952381,5.87
16529,7655664,2276,143772,1505747,1254,1022,1.0,0.0
16530,192,55,192,49,43,12,2.5641025641025643,26.93
16531,6239736,706,0,91963,260,446,1.25,0.0
16532,7449888,3113,4906560,357632,1363,1750,1.0,5.0
16533,624180,138,0,26154,66,72,4.761904761904762,0.0
16534,6617256,279,657552,474278,109,170,1.0,3.24
16535,5509152,180,5509152,47422,93,87,4.166666666666667,75.95
16536,59340,41,59340,154,36,5,3.0303030303030303,8.77
16537,78696,49,78696,2592,45,4,2.380952380952381,38.28
16538,468,65,0,95,54,11,2.0,0.0
16539,4934484,256,0,44804,129,127,3.333333333333333,6.22
16540,677676,5,677676,6218,4,1,7.142857142857143,41.22
16541,317040,130,317040,14784,101,29,1.0,41.28
16542,56808,144,0,1169,67,77,5.882352941176471,0.0
16543,7639236,2464,0,1356690,1370,1094,1.0,0.0
16544,156,56,156,58,38,18,3.225806451612903,39.17
16545,7412400,366,0,93394,223,143,1.25,0.0
16546,7605168,1347,0,966634,743,604,1.0,4.97
16547,7580136,4499,699744,589831,2725,1774,1.0,0.0
16548,5863320,880,0,85243,508,372,1.0,0.0
16549,5349576,185,5349576,9107,112,73,1.2658227848101269,54.01
16550,780,124,780,522,91,33,1.2345679012345678,37.38
16551,336,64,0,94,35,29,100.0,100.0
16552,7379760,420,0,229536,244,176,1.4492753623188406,0.0
16553,828,10,828,181,9,1,10.0,49.77
16554,56832,100,56832,1143,90,10,1.162790697674419,44.35
16555,7485528,3130,5515620,167858,1636,1494,1.0,1.86
16556,36096,57,36096,330,48,9,2.1739130434782608,63.48
16557,7123392,1720,3955704,1986712,973,747,1.0,0.0
16558,312,4,312,66,4,0,25.0,88.71
16559,2496,21,2496,226,13,8,20.0,82.77
16560,7473552,4622,623352,267107,2442,2180,1.0,0.0
16561,7396356,1960,0,194884,922,1038,1.0,6.0
16562,207684,99,207684,63170,86,13,1.4705882352941178,3.9
16563,7594608,4379,2487516,269814,1844,2535,1.0,0.0
16564,2427048,271,0,12835,136,135,2.857142857142857,0.0
16565,48168,18,48168,5113,17,1,14.285714285714286,0.0
16566,86292,26,86292,963,21,5,5.882352941176471,54.06
16567,2678316,52,2678316,2600,46,6,2.380952380952381,59.14
16568,2618556,194,2618556,29293,136,58,1.0,0.27
16569,660,17,660,181,15,2,8.333333333333334,50.79
16570,597024,156,0,51723,71,85,3.8461538461538463,2.5
16571,1164,10,1164,162,10,0,10.0,97.43
16572,1752,18,1752,540,17,1,12.5,0.0
16573,4843836,26,50532,186651,18,8,7.6923076923076925,63.07
16574,39624,64,0,3169,50,14,100.0,0.0
16575,1584,21,1476,1412,19,2,4.761904761904762,47.62
16576,2772,104,2772,239,55,49,3.703703703703704,67.5
16577,7176024,506,0,236808,243,263,1.5384615384615383,0.0
16578,1140,93,0,192,61,32,100.0,0.0
16579,29124,89,29124,378,70,19,1.639344262295082,61.39
16580,708,17,708,104,17,0,5.2631578947368425,79.14
16581,57912,13,57912,4110,12,1,25.0,93.0
16582,2400,38,2400,741,32,6,9.090909090909092,31.19
16583,428928,17,52476,28341,16,1,25.0,87.46
16584,132,24,132,39,24,0,4.0,55.37
16585,1620,364,1620,1207,174,190,1.408450704225352,41.38
16586,492,24,492,120,20,4,5.555555555555555,17.7
16587,7480656,107,5535624,140378,49,58,5.2631578947368425,71.85
16588,408,27,408,91,16,11,8.333333333333334,69.34
16589,69960,82,0,6350,72,10,100.0,0.0
16590,1111260,80,0,28864,33,47,16.666666666666668,0.0
16591,468,15,468,65,13,2,7.142857142857143,71.3
16592,1612776,16,1176,101172,14,2,10.0,0.0
16593,7177452,954,0,134521,519,435,1.0,0.0
16594,816,67,816,331,39,28,3.8461538461538463,47.66
16595,2022900,22,780,92036,19,3,5.882352941176471,52.39
16596,5224164,293,0,45896,148,145,2.380952380952381,2.0
16597,7307076,286,0,924897,166,120,1.9230769230769231,0.0
16598,912,10,672,198,8,2,12.5,77.74
16599,1956,41,1956,1242,39,2,2.5,55.24
16600,144984,9,732,16162,5,4,25.0,1.9
16601,1992,29,1992,20,27,2,3.703703703703704,26.37
16602,2220,25,2220,1030,22,3,9.090909090909092,47.37
16603,120,22,120,52,17,5,7.142857142857143,51.97
16604,636,48,636,32,34,14,3.4482758620689653,44.47
16605,7701540,31165,3619452,5209430,17918,13247,1.0,0.0
16606,7225692,2679,1892892,751866,1091,1588,1.0,0.0
16607,1404,28,1404,469,25,3,12.5,31.12
16608,13272,21,13272,772,21,0,4.761904761904762,73.39
16609,249480,79,249480,37235,55,24,2.127659574468085,47.92
16610,636,76,636,307,52,24,2.380952380952381,49.15
16611,17700,57,0,2201,47,10,100.0,0.0
16612,228,37,228,28,29,8,12.5,67.87
16613,1716,15,1716,504,13,2,11.11111111111111,0.0
16614,7704840,10688,0,2832537,6006,4682,1.0,0.0
16615,1416,22,1416,191,22,0,4.3478260869565215,55.18
16616,168,20,168,47,20,0,4.761904761904762,44.83
16617,684,18,684,554,18,0,5.0,52.33
16618,18960,21,18960,797,21,0,4.761904761904762,74.13
16619,720,0,720,0,0,0,50.0,59.29
16620,16956,5,16956,1543,5,0,33.333333333333336,95.14
16621,98184,154,0,2839,90,64,100.0,0.0
16622,6972,52,0,1546,47,5,100.0,0.0
16623,2532,10,0,855,8,2,100.0,0.0
16624,6876,19,6876,426,19,0,5.555555555555555,76.48
16625,2484,48,2484,954,22,26,10.0,0.0
16626,420,2,0,324,1,1,100.0,0.0
16627,2124,15,2124,664,12,3,100.0,0.0
16628,8772,328,0,2913,185,143,100.0,0.0
16629,240,4,168,123,3,1,25.0,76.0
16630,540,9,156,116,8,1,12.5,87.2
16631,158040,5,0,37257,3,2,33.333333333333336,99.54
16632,22392,21,22392,868,18,3,16.666666666666668,90.73
16633,1500,44,1500,1258,28,16,4.761904761904762,85.7
16634,6536112,382,0,383605,267,115,7.6923076923076925,70.12
16635,102648,205,0,3115,147,58,100.0,0.0
16636,468,2,0,462,1,1,100.0,0.0
16637,7668840,5572,1932438,1661664,3199,2373,1.0,0.0
16638,252,1,0,252,0,1,100.0,0.0
16639,9492,35,0,1525,31,4,100.0,0.0
16640,7705776,15572,2820432,1765862,8810,6762,1.0,0.0
16641,106464,127,0,3377,79,48,100.0,0.0
16642,711540,17,0,130837,12,5,7.6923076923076925,3.69
16643,66396,206,0,2575,122,84,100.0,0.0
16644,64584,53,0,2534,40,13,100.0,0.0
16645,253176,25,253176,1407,24,1,4.3478260869565215,28.98
16646,7435008,97,3064392,174017,74,23,1.6129032258064515,1.99
16647,17304,358,0,3482,219,139,100.0,0.0
16648,482328,4,482328,13998,4,0,20.0,85.88
16649,82284,1,82284,0,1,0,33.333333333333336,61.41
16650,54756,10,54756,31248,10,0,12.5,29.44
16651,32616,50,32616,1464,36,14,5.882352941176471,23.67
16652,7812,1,0,7812,0,1,100.0,0.0
16653,7723620,34649,4480989,3863853,19710,14939,1.0,0.0
16654,233796,62,233796,5718,38,24,5.555555555555555,70.57
16655,57012,55,57012,15444,47,8,1.2048192771084338,14.49
16656,65256,11,65256,384,11,0,8.333333333333334,88.61
16657,8460,124,0,989,80,44,100.0,0.0
16658,240,0,240,0,0,0,50.0,64.0
16659,276,1,276,0,1,0,33.333333333333336,53.96
16660,612,1,612,228,1,0,33.333333333333336,60.13
16661,89088,10,89088,26,7,3,16.666666666666668,68.15
16662,54060,44,54060,937,36,8,3.333333333333333,7.25
16663,288,167,240,74,100,67,1.694915254237288,26.01
16664,312,81,312,95,69,12,1.5625,34.42
16665,1920,77,0,129,50,27,100.0,0.0
16666,5421336,175,5421336,95239,88,87,4.0,77.8
16667,264,18,264,47,17,1,5.555555555555555,46.26
16668,12180,90,0,771,64,26,100.0,0.0
16669,2196,26,2196,512,26,0,3.703703703703704,53.82
16670,136848,61,86316,2748,54,7,1.9230769230769231,0.0
16671,1116972,31,733446,39075,15,16,50.0,0.0
16672,72,0,72,0,0,0,50.0,82.0
16673,84,27,84,16,21,6,5.2631578947368425,44.34
16674,420,39,420,159,22,17,6.666666666666667,60.16
16675,37332,106,37332,2689,86,20,1.5873015873015872,10.1
16676,360,14,360,114,10,4,12.5,63.7
16677,7625988,1998,0,815007,1167,831,1.0,1.0
16678,7650984,692,0,37649,390,302,1.2195121951219512,0.0
16679,1980,106,924,213,95,11,1.1235955056179776,0.0
16680,6484944,230,0,123157,121,109,3.0303030303030303,0.0
16681,2791332,88,2791332,63482,42,46,5.555555555555555,95.4
16682,7648068,501,0,76784,282,219,1.2345679012345678,4.43
16683,1199964,242,604344,110450,122,120,3.125,89.29
16684,672,5,672,196,5,0,14.285714285714286,73.8
16685,20004,153,0,2440,107,46,100.0,0.0
16686,7727844,8171,0,1910419,4977,3194,1.0,0.0
16687,14160,25,14160,1464,25,0,3.8461538461538463,66.64
16688,5931996,129,5931996,11812,62,67,5.555555555555555,76.26
16689,1079412,138,0,9551,71,67,4.761904761904762,1.0
16690,118296,469,0,15502,307,162,100.0,0.0
16691,76452,11,76452,24834,9,2,12.5,99.46
16692,168,6,168,62,4,2,25.0,57.04
16693,12048,235,0,2361,148,87,100.0,0.0
16694,876,26,876,269,20,6,5.2631578947368425,1.36
16695,2788224,51,2788224,280910,22,29,2.631578947368421,57.85
16696,1488,78,1488,257,52,26,3.225806451612903,62.09
16697,7273968,374,0,186903,224,150,1.4492753623188406,0.0
16698,7592856,8029,152214,233914,4447,3582,1.0,0.0
16699,5046336,2951,63156,230096,1594,1357,1.0,0.0
16700,2820,153,2820,304,109,44,1.162790697674419,44.02
16701,3289008,198,0,47838,102,96,3.703703703703704,0.0
16702,276,30,0,113,16,14,50.0,0.0
16703,288,12,0,109,10,2,100.0,100.0
16704,108,1,108,12,1,0,33.333333333333336,83.75
16705,6701004,1161,0,207507,656,505,1.0,0.0
16706,2993160,234,0,16022,117,117,4.3478260869565215,0.0
16707,480,102,480,248,56,46,3.125,45.62
16708,5727108,360,0,105161,189,171,1.7857142857142858,0.0
16709,2016,5,2016,1449,4,1,14.285714285714286,44.08
16710,7528260,310,5591784,431456,118,192,3.225806451612903,0.05
16711,696,21,696,410,17,4,6.666666666666667,50.08
16712,1716,6,1716,650,4,2,20.0,94.15
16713,924,10,924,852,4,6,33.333333333333336,96.39
16714,7232280,3124,2086768,207948,1665,1459,1.0,0.0
16715,420,12,420,174,6,6,20.0,95.45
16716,24144,35,24144,262,23,12,5.555555555555555,85.44
16717,1284,10,1284,172,6,4,25.0,21.38
16718,1944,15,1944,49,12,3,9.090909090909092,58.45
16719,7522800,2329,2565036,197995,932,1397,1.0,1.98
16720,2836512,125,2836512,9309,50,75,6.666666666666667,59.03
16721,72,30,72,14,28,2,3.571428571428572,31.5
16722,504,15,504,134,8,7,25.0,70.52
16723,71340,94,71340,5909,51,43,4.761904761904762,73.57
16724,7450968,866,3178740,210246,475,391,1.0,6.8
16725,348,59,348,100,37,22,5.555555555555555,75.88
16726,7667052,1843,0,131737,849,994,1.0,7.0
16727,683100,745,683100,211288,441,304,1.0,40.51
16728,28368,186,0,4106,124,62,100.0,0.0
16729,5196,143,0,477,96,47,100.0,0.0
16730,276,7,264,109,5,2,33.333333333333336,98.03
16731,2609568,113,2609568,77146,58,55,4.545454545454546,73.98
16732,7171500,2636,0,114605,1280,1356,1.0,12.0
16733,28296,9,28296,777,9,0,11.11111111111111,76.9
16734,708,136,0,475,106,30,1.25,2.0
16735,31152,105,0,766,83,22,100.0,0.0
16736,13416,44,13416,490,43,1,2.272727272727273,56.73
16737,2239548,51,2239548,598,39,12,2.9411764705882355,0.0
16738,497256,136,497256,222117,105,31,1.408450704225352,0.29
16739,7595784,837,0,1881169,450,387,1.4285714285714286,0.0
16740,7263420,1086,0,201519,508,578,1.0,0.0
16741,34944,109,0,1352,73,36,100.0,0.0
16742,2688,43,2688,826,38,5,2.7777777777777777,62.75
16743,142008,34,142008,1508,29,5,8.333333333333334,1.05
16744,6339768,407,0,265981,258,149,1.4492753623188406,0.0
16745,6029904,85,0,75636,63,22,100.0,0.0
16746,34860,157,0,6394,97,60,100.0,0.0
16747,4100808,47,0,1017394,39,8,6.666666666666667,74.21
16748,38976,165,0,1954,110,55,100.0,0.0
16749,6858792,94,0,738572,63,31,3.125,0.0
16750,4421844,77,0,61027,65,12,50.0,0.0
16751,51972,49,51972,8882,41,8,2.702702702702702,4.4
16752,6186744,79,0,297016,68,11,33.333333333333336,0.0
16753,1176,10,1176,422,4,6,33.333333333333336,98.39
16754,3564,72,3564,1098,44,28,3.225806451612903,73.15
16755,2112,48,2112,846,28,20,6.666666666666667,32.49
16756,8532,41,0,1819,36,5,100.0,0.0
16757,8544,39,8544,1236,35,4,3.225806451612903,49.18
16758,26364,297,0,5770,183,114,100.0,0.0
16759,23088,61,0,1557,48,13,50.0,0.0
16760,304308,28,0,32484,17,11,10.0,5.0
16761,11508,102,0,1117,79,23,100.0,0.0
16762,1188,65,1188,650,58,7,1.851851851851852,52.52
16763,8292,11,0,1052,6,5,100.0,0.0
16764,2934204,158,0,21471,115,43,100.0,100.0
16765,2858640,348,2858640,18427,186,162,2.0,59.73
16766,2232,67,2232,1903,45,22,2.857142857142857,55.05
16767,6948,62,0,2164,54,8,50.0,0.0
16768,0,0,0,0,0,0,50.0,0.0
16769,14124,21,14124,489,21,0,4.761904761904762,75.43
16770,16404,82,0,1254,60,22,33.333333333333336,0.0
16771,291516,3,291516,3684,3,0,25.0,99.71
16772,5172,9,0,1344,8,1,33.333333333333336,0.0
16773,7331568,3282,0,237442,1906,1376,1.0,0.0
16774,33396,15,33396,2455,14,1,10.0,5.65
16775,720,1,720,132,1,0,33.333333333333336,46.99
16776,7896,148,0,1194,109,39,33.333333333333336,0.0
16777,84,4,84,42,2,2,50.0,59.62
16778,1725324,407,0,15044,200,207,1.5625,0.0
16779,396,52,396,72,44,8,2.3255813953488373,25.04
16780,9396,167,9396,2659,102,65,3.4482758620689653,62.32
16781,11148,129,0,966,93,36,33.333333333333336,0.0
16782,3691296,99,0,54723,81,18,25.0,0.0
16783,132432,29,132432,19315,19,10,10.0,30.88
16784,408,47,0,208,29,18,100.0,0.0
16785,36444,53,36444,571,33,20,4.166666666666667,11.67
16786,7521060,205,0,568688,103,102,4.545454545454546,0.0
16787,156,35,156,56,24,11,6.666666666666667,12.87
16788,21828,22,21828,49,20,2,4.761904761904762,79.16
16789,552,17,0,242,12,5,100.0,100.0
16790,276,3,276,44,2,1,33.333333333333336,60.84
16791,28680,3,28680,484,3,0,20.0,73.7
16792,84,0,84,0,0,0,100.0,90.0
16793,2484,0,2484,0,0,0,50.0,63.16
16794,3607896,321,0,14512,167,154,3.225806451612903,0.0
16795,190572,107,0,8176,54,53,5.555555555555555,0.0
16796,8568,46,960,269,40,6,2.5641025641025643,67.89
16797,7812960,143456,3543108,4111610,85745,57711,1.0,0.0
16798,1350096,167,0,31429,83,84,3.333333333333333,5.0
16799,144,2,144,24,2,0,25.0,58.29
16800,1932,31,0,732,27,4,50.0,0.0
16801,56916,17,56916,812,17,0,5.555555555555555,75.63
16802,7068216,2224,3230076,133658,1279,945,1.0,0.0
16803,85968,0,85968,0,0,0,100.0,100.0
16804,3960,57,0,361,49,8,100.0,0.0
16805,180,53,180,38,43,10,2.5,32.26
16806,5207556,801,53604,30214,173,628,1.0,51.03
16807,2508,27,2508,457,27,0,3.8461538461538463,50.88
16808,3000,101,2892,2112,77,24,1.5151515151515151,27.43
16809,6760824,1245,2623872,126759,698,547,1.0,0.0
16810,210264,16,210264,2795,14,2,6.25,87.19
16811,89328,22,89328,249,22,0,4.3478260869565215,62.9
16812,123636,65,0,7168,45,20,3.225806451612903,0.0
16813,32136,35,0,3707,24,11,5.555555555555555,0.0
16814,2038476,94,0,195887,78,16,25.0,0.0
16815,528,33,528,106,31,2,3.125,47.65
16816,6554076,321,0,254900,168,153,1.4705882352941178,0.0
16817,6185724,61,0,694501,42,19,11.11111111111111,36.64
16818,168768,138,41352,5703,113,25,1.1764705882352942,4.63
16819,47160,188,0,5519,119,69,100.0,0.0
16820,392772,15,392772,776,7,8,20.0,90.28
16821,95160,36,95160,810,30,6,3.571428571428572,56.26
16822,33276,204,0,3907,131,73,100.0,0.0
16823,7821168,9464,3389487,2537149,5607,3857,1.0,0.0
16824,5700060,138,5664600,136790,74,64,2.631578947368421,0.07
16825,3026244,121,3026244,5482,55,66,5.2631578947368425,0.0
16826,2868,4,2868,1545,4,0,14.285714285714286,47.23
16827,1152,54,1152,303,49,5,2.127659574468085,34.3
16828,516,16,516,169,12,4,7.6923076923076925,74.06
16829,5261040,556,0,224526,262,294,1.36986301369863,0.0
16830,6205560,758,2298960,1277057,268,490,1.0,0.0
16831,107892,58,0,38910,32,26,4.761904761904762,0.0
16832,311568,11,77040,28758,11,0,6.25,1.87
16833,25884,182,0,1896,112,70,100.0,0.0
16834,624,55,624,61,52,3,1.9230769230769231,33.81
16835,2904780,5,2904780,662,4,1,12.5,61.77
16836,7283364,2881,0,1091846,1489,1392,1.0,0.0
16837,744,9,444,177,9,0,10.0,77.27
16838,18552,142,18552,465,99,43,1.5625,94.23
16839,1188,200,0,383,124,76,100.0,0.0
16840,41796,160,0,3042,114,46,1.3888888888888888,0.0
16841,3408,43,0,1001,32,11,100.0,0.0
16842,144,28,144,46,20,8,5.555555555555555,38.96
16843,7379376,56,7379376,8675,30,26,5.2631578947368425,75.05
16844,288,7,288,97,5,2,20.0,55.99
16845,60168,9,60168,1380,9,0,10.0,11.92
16846,82176,221,0,2037,148,73,100.0,0.0
16847,50556,39,50556,8819,36,3,3.125,4.51
16848,2064,33,0,175,26,7,4.761904761904762,0.0
16849,6787872,1143,0,112504,501,642,1.0,0.0
16850,5673240,432,5672652,37718,248,184,1.4705882352941178,9.89
16851,2916,81,2916,599,59,22,1.96078431372549,48.49
16852,852,3,852,704,3,0,20.0,51.52
16853,7992,7,7992,42,3,4,20.0,3.88
16854,1440,153,0,401,115,38,50.0,0.0
16855,492,5,300,163,5,0,16.666666666666668,78.66
16856,3873792,1,3873792,60,1,0,50.0,74.91
16857,204,4,204,3,4,0,16.666666666666668,74.75
16858,7115856,4278,292650,409275,2413,1865,1.0,0.0
16859,39660,106,1512,855,106,0,1.0,38.43
16860,252,3,252,200,1,2,50.0,77.03
16861,7833540,5440,962394,1797306,3534,1906,1.0,4.26
16862,7412028,319,0,87796,145,174,2.3255813953488373,2.72
16863,8868,172,2052,1915,116,56,1.2195121951219512,95.58
16864,84,13,84,14,10,3,10.0,62.76
16865,1536,104,0,582,88,16,100.0,0.0
16866,10980,1,10980,1680,1,0,33.333333333333336,98.69
16867,5722080,354,0,101512,166,188,1.818181818181818,1.87
16868,4239576,410,0,27386,160,250,1.851851851851852,25.0
16869,5681532,87,5681064,145202,41,46,5.882352941176471,10.0
16870,5484,3,5484,376,3,0,50.0,99.55
16871,8592,8,8592,498,8,0,12.5,74.32
16872,960,6,960,408,6,0,14.285714285714286,50.63
16873,15096,13,15096,1308,13,0,9.090909090909092,15.13
16874,6811092,1751,0,112114,892,859,1.0,0.0
16875,7266408,8,0,2257824,6,2,33.333333333333336,0.0
16876,5532396,378,2650824,17524,183,195,1.2658227848101269,0.0
16877,7411356,584,4561248,135608,290,294,1.0638297872340423,0.0
16878,2315484,133,2315484,4226,98,35,1.2820512820512822,0.0
16879,8268,42,8268,149,30,12,3.8461538461538463,51.65
16880,5410260,165,0,387120,82,83,3.0303030303030303,4.75
16881,7809828,2062,345732,182215,1148,914,1.0,0.0
16882,6447756,414,5685300,101229,238,176,2.0408163265306123,1.54
16883,7233780,2970,5685264,237992,1628,1342,1.0,0.0
16884,22008,69,22008,1803,69,0,1.408450704225352,26.36
16885,7740936,928,0,427664,532,396,1.0,0.0
16886,169836,99,690,2193,71,28,1.7543859649122806,34.28
16887,3573252,11,288,1232095,7,4,14.285714285714286,98.7
16888,41448,50,41448,1476,43,7,2.5,66.94
16889,7679316,1612,0,142720,869,743,1.0,8.5
16890,144,4,144,6,3,1,33.333333333333336,95.17
16891,125160,13,125160,492,9,4,16.666666666666668,90.85
16892,828,1,120,828,1,0,50.0,64.0
16893,5930328,118,5694840,206187,53,65,5.555555555555555,0.0
16894,7405884,1893,0,190707,927,966,1.0,5.0
16895,0,0,0,0,0,0,5.2631578947368425,37.96
16896,24504,130,0,1139,93,37,100.0,0.0
16897,4735464,60,0,129455,40,20,100.0,100.0
16898,5712,31,3084,794,21,10,8.333333333333334,53.26
16899,27480,132,0,1193,104,28,33.333333333333336,0.0
16900,5148,6,3342,2480,6,0,14.285714285714286,79.92
16901,19812,82,0,1380,62,20,100.0,0.0
16902,168,25,168,48,19,6,4.166666666666667,53.49
16903,5412,52,5412,5067,36,16,3.571428571428572,65.62
16904,37704,182,0,2530,118,64,50.0,0.0
16905,7174428,97,7174104,111974,52,45,4.0,0.0
16906,4303704,37,360,232705,31,6,3.571428571428572,43.64
16907,6156708,60,0,294430,48,12,25.0,0.0
16908,2679396,108,2679156,63194,66,42,4.166666666666667,0.0
16909,38076,254,0,2541,148,106,1.162790697674419,3.0
16910,11484,165,0,1424,101,64,100.0,0.0
16911,5274924,105,4581900,317114,57,48,5.0,67.81
16912,5004,110,0,1051,75,35,100.0,0.0
16913,31356,11,31164,31130,10,1,8.333333333333334,76.28
16914,5364396,72,5364396,88208,30,42,11.11111111111111,82.7
16915,5440068,116,0,548496,49,67,6.666666666666667,0.0
16916,7788744,583,0,4261549,226,357,1.3888888888888888,0.0
16917,804420,139,0,9795,70,69,6.666666666666667,0.0
16918,7429812,41,7429812,1516942,19,22,10.0,85.49
16919,2292,10,2262,553,6,4,25.0,92.77
16920,2783256,41,0,157117,33,8,100.0,0.0
16921,104796,23,104796,1663,20,3,7.142857142857143,43.33
16922,6288,116,0,1053,69,47,50.0,0.0
16923,12936,140,0,1287,95,45,100.0,0.0
16924,9612,17,0,2976,13,4,50.0,0.0
16925,3024,126,0,906,79,47,100.0,0.0
16926,511212,35,0,394112,16,19,11.11111111111111,0.0
16927,1916112,73,0,99211,64,9,50.0,0.0
16928,824580,24,0,35882,21,3,50.0,0.0
16929,4140,17,4140,908,16,1,7.142857142857143,0.68
16930,13296,22,13296,716,22,0,4.761904761904762,76.05
16931,5344584,123,0,780135,63,60,3.703703703703704,4.0
16932,3756,10,180,418,10,0,9.090909090909092,91.76
16933,7400616,1601,0,158215,890,711,1.0,0.0
16934,89532,29,0,6990,18,11,12.5,9.0
16935,5150712,203,0,63796,96,107,4.761904761904762,5.0
16936,720,5,720,571,3,2,25.0,96.59
16937,833172,36,0,47708,30,6,100.0,0.0
16938,19320,144,0,2321,89,55,100.0,0.0
16939,71880,1,71880,396,1,0,50.0,97.1
16940,7740,78,0,1324,54,24,2.4390243902439024,0.0
16941,6120,145,0,1025,92,53,100.0,0.0
16942,6706548,136,3353370,214111,98,38,33.333333333333336,0.01
16943,78384,3,78384,208,2,1,33.333333333333336,62.02
16944,876,27,876,697,17,10,7.142857142857143,77.66
16945,10524,154,0,1386,100,54,100.0,0.0
16946,80760,10,80760,28,9,1,10.0,62.86
16947,6277836,1191,6277560,23215,702,489,1.0,0.0
16948,9888,19,9888,877,18,1,7.6923076923076925,1.19
16949,2184,27,0,698,23,4,50.0,99.8
16950,7860768,864,270780,4715698,555,309,1.0,0.43
16951,18432,202,0,1852,127,75,100.0,0.0
16952,323544,106,323544,1586,54,52,3.0303030303030303,42.06
16953,660,26,660,243,15,11,16.666666666666668,49.84
16954,4128,50,2262,314,38,12,3.0303030303030303,37.36
16955,3324,14,3324,810,11,3,12.5,53.53
16956,1668,13,1584,156,11,2,6.25,33.77
16957,20112,1,20112,12,1,0,20.0,75.82
16958,5946480,185,0,43653,101,84,3.225806451612903,0.0
16959,7795212,19242,52602,430151,10350,8892,1.0,0.12
16960,7031076,857,0,3150724,464,393,1.1904761904761905,0.0
16961,22296,14,22296,657,12,2,7.6923076923076925,90.67
16962,40680,8,40680,2751,8,0,12.5,63.3
16963,65856,2,65856,306,2,0,50.0,76.38
16964,2626884,718,2626884,54147,281,437,1.408450704225352,66.42
16965,648,50,648,242,48,2,2.0408163265306123,55.39
16966,1896,58,1896,1333,52,6,1.96078431372549,8.19
16967,4279296,76,0,97707,38,38,7.6923076923076925,0.0
16968,1011852,9,1011852,5828,5,4,33.333333333333336,93.01
16969,232428,26,232428,12008,13,13,50.0,76.46
16970,3575112,41,3575112,1500,37,4,2.5641025641025643,20.0
16971,7127352,53,0,187269,43,10,50.0,0.0
16972,70428,4,70428,510,2,2,33.333333333333336,99.8
16973,3024,93,3024,626,60,33,3.8461538461538463,25.75
16974,1920,48,1920,1589,34,14,3.703703703703704,49.22
16975,5306292,223,960,29849,135,88,1.0,27.93
16976,914952,39,1836,23786,34,5,3.125,78.1
16977,10572,142,0,878,96,46,100.0,0.0
16978,456,5,456,213,3,2,33.333333333333336,93.11
16979,744,9,528,166,8,1,11.11111111111111,0.0
16980,1920,1,1920,888,1,0,50.0,89.47
16981,75408,103,75408,5779,83,20,1.5625,10.64
16982,7211388,785,0,148066,431,354,1.0309278350515465,0.0
16983,6899064,192,0,64490,94,98,4.3478260869565215,5.0
16984,2942952,102,2942952,43812,42,60,8.333333333333334,87.81
16985,7902348,29205,3015984,2639842,17850,11355,1.0,0.0
16986,11124,147,0,797,91,56,50.0,0.0
16987,216,1,216,0,1,0,33.333333333333336,84.83
16988,228,4,228,30,4,0,16.666666666666668,48.74
16989,4779132,482,0,32173,271,211,2.0,5.06
16990,912,49,912,305,38,11,2.9411764705882355,85.25
16991,444,23,444,134,22,1,4.545454545454546,49.61
16992,108,0,108,0,0,0,50.0,80.0
16993,96,34,96,21,30,4,3.333333333333333,32.15
16994,14868,171,0,1353,117,54,50.0,0.0
16995,7911588,64685,1608867,3017576,43392,21293,1.0,0.0
16996,792,27,732,238,23,4,7.6923076923076925,42.29
16997,7795764,432,7795764,126741,222,210,1.6666666666666667,67.13
16998,29112,86,0,2544,68,18,2.127659574468085,0.0
16999,7910724,10577,1170036,1879505,6209,4368,1.0,0.0
17000,3431568,60,3431568,26890,38,22,9.090909090909092,0.0
17001,7885164,2050,565872,2463321,814,1236,1.0,8.21
17002,3388392,423,301284,162364,325,98,1.0,0.0
17003,27096,85,0,3638,64,21,100.0,0.0
17004,7914024,35705,2289216,1635938,22597,13108,1.0,0.0
17005,7164,124,0,1029,79,45,100.0,0.0
17006,6499608,121,0,273438,53,68,6.25,0.0
17007,5248284,104,5248284,259184,54,50,2.9411764705882355,61.94
17008,5402820,502,3432420,196287,300,202,1.0,0.0
17009,420,27,420,48,24,3,4.166666666666667,61.43
17010,14844,99,0,2096,69,30,2.272727272727273,0.0
17011,7131384,420,0,94622,215,205,2.5,0.0
17012,4824,15,4824,151,5,10,50.0,99.65
17013,1608,128,0,605,105,23,100.0,0.0
17014,7887084,391,2723652,2042267,159,232,1.0,0.0
17015,144,4,144,12,3,1,25.0,73.08
17016,2681544,15,2681544,7144,6,9,9.090909090909092,87.02
17017,4320,8,4320,1138,5,3,7.142857142857143,63.34
17018,43392,274,43392,79,143,131,1.3888888888888888,27.85
17019,11100,96,0,1856,65,31,100.0,0.0
17020,8832,88,8832,255,72,16,1.639344262295082,33.72
17021,5187468,98,0,53497,48,50,3.703703703703704,0.0
17022,2376120,310,2376120,7592,144,166,2.857142857142857,67.82
17023,6546144,1166,605124,165205,617,549,1.0,0.0
17024,418656,36,418656,2032,16,20,12.5,95.19
17025,7864584,1209,0,101106,611,598,1.0,0.0
17026,936,56,936,92,42,14,2.702702702702702,79.69
17027,44004,70,0,2881,40,30,7.6923076923076925,0.0
17028,7726836,1631,319044,243938,820,811,1.0,0.0
17029,24408,31,24408,220,25,6,4.166666666666667,71.76
17030,18300,16,336,1263,12,4,25.0,51.89
17031,49596,89,49596,256,61,28,2.0408163265306123,36.34
17032,882576,3,882576,208,3,0,20.0,84.39
17033,408,83,408,86,77,6,2.1739130434782608,29.46
17034,8880,37,8880,430,34,3,2.857142857142857,33.46
17035,7790952,2252,5766600,228731,1244,1008,1.0,0.0
17036,600,3,600,116,3,0,20.0,82.07
17037,34128,21,34128,568,21,0,4.3478260869565215,64.14
17038,384,145,384,38,87,58,1.6666666666666667,23.33
17039,7188,6,396,1360,5,1,14.285714285714286,45.37
17040,7930248,2563,1184928,2362242,1440,1123,1.0,0.0
17041,4125492,750,0,18002,301,449,1.2820512820512822,5.0
17042,10812,109,10812,161,69,40,2.0408163265306123,28.89
17043,2592348,336,2592348,30891,192,144,1.36986301369863,55.23
17044,912,16,912,281,11,5,12.5,24.77
17045,468,2,468,102,2,0,25.0,52.66
17046,82560,1,82560,468,1,0,50.0,89.12
17047,7732164,4190,1884840,291406,2147,2043,1.0,0.0
17048,7585356,2101,0,216716,1164,937,1.0,9.2
17049,7596804,888,0,155231,422,466,1.0101010101010102,0.0
17050,7860540,1033,0,1308054,508,525,5.882352941176471,0.0
17051,1789992,501,0,15503,222,279,2.2222222222222223,11.5
17052,3625956,302,3625956,109642,166,136,3.4482758620689653,0.0
17053,7460124,924,0,314940,547,377,1.0,0.0
17054,912,19,912,24,19,0,4.761904761904762,53.69
17055,5329800,60,0,280075,28,32,9.090909090909092,5.0
17056,7645296,483,5776464,313170,212,271,1.408450704225352,10.0
17057,1606008,187,0,28437,90,97,3.571428571428572,4.0
17058,1488,156,0,563,134,22,100.0,0.0
17059,7728840,2583,0,161719,1439,1144,1.0,0.0
17060,7392936,698,4822128,104265,388,310,1.0,0.0
17061,1137156,243,0,15048,102,141,2.7777777777777777,0.0
17062,110136,0,110136,0,0,0,50.0,77.0
17063,39516,35,39516,1835,35,0,2.7777777777777777,54.53
17064,11148,38,0,2153,35,3,1.0,8.58
17065,7943424,23477,3560883,2068605,16728,6749,1.0,0.0
17066,7755552,3999,490050,106156,2273,1726,1.0,5.41
17067,348,20,312,130,19,1,5.555555555555555,32.26
17068,1068,3,1068,132,2,1,33.333333333333336,49.36
17069,6165672,402,5781288,115947,228,174,1.0416666666666667,5.0
17070,6473232,489,3361032,162556,237,252,2.380952380952381,0.13
17071,6693588,2878,590892,371604,1517,1361,1.0,0.0
17072,684,0,684,0,0,0,100.0,0.0
17073,144,42,60,26,38,4,2.857142857142857,26.65
17074,6235836,124,280728,370493,119,5,1.0416666666666667,35.1
17075,7936872,2000,2171400,1914246,930,1070,1.0,0.0
17076,516828,11,516828,214176,11,0,10.0,48.18
17077,4788,98,4788,2153,76,22,1.492537313432836,17.6
17078,88476,9,88476,4294,9,0,12.5,90.69
17079,7344,43,1236,414,39,4,2.631578947368421,42.93
17080,4668,16,4668,4152,14,2,6.666666666666667,44.89
17081,942156,273,366288,172961,269,4,3.0303030303030303,97.43
17082,427896,0,427896,0,0,0,100.0,100.0
17083,5439876,40,5439876,42847,16,24,14.285714285714286,85.73
17084,34152,95,0,2100,65,30,33.333333333333336,0.0
17085,14880,1,14880,14736,1,0,50.0,98.0
17086,28260,48,0,2204,35,13,100.0,0.0
17087,294408,129,294408,79678,114,15,1.0,7.93
17088,1260,67,1260,119,65,2,1.5151515151515151,29.99
17089,5640516,412,3799836,429819,244,168,1.694915254237288,0.0
17090,732,9,0,257,4,5,100.0,0.0
17091,18540,1,18540,84,1,0,50.0,66.73
17092,7815012,6633,2541084,1256270,3164,3469,1.0,4.78
17093,145404,1,145404,72,1,0,33.333333333333336,68.15
17094,7536,19,7536,565,19,0,5.2631578947368425,73.28
17095,6626280,463,5445960,217828,269,194,1.3333333333333333,62.33
17096,180912,134,180912,165382,88,46,3.225806451612903,37.44
17097,8676,119,0,485,54,65,7.6923076923076925,0.0
17098,42936,37,42936,25795,37,0,2.9411764705882355,40.0
17099,8868,3,0,4352,1,2,100.0,0.0
17100,902352,62,0,18549,51,11,100.0,0.0
17101,4104,69,0,938,47,22,100.0,0.0
17102,7963680,29212,2193180,2129697,16771,12441,1.0,0.0
17103,225792,13,116634,30305,13,0,8.333333333333334,77.4
17104,4056,18,4056,324,18,0,5.555555555555555,76.16
17105,43572,145,0,1831,92,53,100.0,0.0
17106,339444,10,339444,3840,10,0,10.0,35.68
17107,1788,5,1788,628,4,1,20.0,97.07
17108,3472380,147,3472380,5104,87,60,1.639344262295082,0.0
17109,27420,31,27420,809,29,2,3.333333333333333,73.07
17110,7332,164,0,2527,108,56,100.0,0.0
17111,120072,1,120072,119712,1,0,50.0,98.0
17112,10008,84,0,518,63,21,50.0,0.0
17113,11352,259,0,3651,157,102,100.0,0.0
17114,456,7,456,15,7,0,11.11111111111111,86.0
17115,540,79,540,358,67,12,1.5873015873015872,35.24
17116,23412,35,21948,21911,31,4,3.125,58.86
17117,96,9,60,17,8,1,10.0,49.02
17118,3540,119,0,1050,69,50,100.0,0.0
17119,13524,19,13524,444,19,0,5.555555555555555,74.69
17120,1116,1,0,1116,0,1,100.0,0.0
17121,2004,3,0,1208,2,1,33.333333333333336,0.0
17122,888,13,0,270,11,2,9.090909090909092,0.0
17123,18672,22,18672,1049,22,0,4.545454545454546,70.73
17124,55992,0,55992,0,0,0,100.0,100.0
17125,7369056,1312,0,125739,733,579,1.0,3.16
17126,7480944,217,0,222762,108,109,2.2222222222222223,0.0
17127,51084,321,0,3316,204,117,50.0,0.0
17128,7800,20,7800,845,20,0,5.2631578947368425,74.56
17129,44904,5,44904,12182,5,0,100.0,100.0
17130,465336,7,465336,258912,7,0,50.0,99.96
17131,465516,1,465516,744,1,0,50.0,99.97
17132,7934964,242,5927620,3581996,137,105,2.5,0.0
17133,77676,15,77676,729,15,0,7.6923076923076925,54.17
17134,6828,132,6828,820,117,15,1.1111111111111112,12.22
17135,372,4,372,174,4,0,16.666666666666668,69.79
17136,168,47,168,37,31,16,4.0,39.49
17137,5169480,125,0,88414,69,56,3.4482758620689653,5.0
17138,25596,5,25596,15844,5,0,20.0,99.8
17139,516,23,516,73,23,0,4.0,77.21
17140,300,17,300,47,14,3,7.6923076923076925,43.96
17141,6920532,705,5811168,72298,342,363,1.5625,0.0
17142,88680,384,0,1259,203,181,2.7777777777777777,0.0
17143,5765616,5,5765424,2318817,1,4,50.0,26.0
17144,48,8,0,12,6,2,7.142857142857143,0.83
17145,5670348,547,2835168,102061,259,288,1.36986301369863,0.0
17146,3797784,34,3797472,175192,18,16,16.666666666666668,0.0
17147,96,6,96,28,4,2,25.0,56.5
17148,6420,69,0,794,55,14,33.333333333333336,0.0
17149,30660,2,30660,816,2,0,33.333333333333336,99.63
17150,3110748,231,3110748,13189,130,101,3.8461538461538463,73.94
17151,5820,39,624,502,35,4,3.225806451612903,76.44
17152,7976616,5578,0,870638,3031,2547,1.0,0.0
17153,1332,4,1332,78,4,0,20.0,96.07
17154,2807424,404,2807424,32350,216,188,2.702702702702702,65.39
17155,19740,4,19740,2484,3,1,33.333333333333336,96.35
17156,324,1,324,36,1,0,33.333333333333336,99.0
17157,6031896,199,0,42459,105,94,3.4482758620689653,0.0
17158,2029584,7,1972812,279605,7,0,16.666666666666668,99.84
17159,960,39,960,80,39,0,2.4390243902439024,39.38
17160,1476,22,1476,262,20,2,4.761904761904762,83.47
17161,468,5,468,88,3,2,33.333333333333336,78.72
17162,388260,1,10452,388260,1,0,100.0,70.0
17163,16692,71,0,1784,50,21,100.0,0.0
17164,5544552,696,2787036,100661,400,296,1.639344262295082,0.0
17165,13452,144,0,958,90,54,50.0,0.0
17166,12876,57,0,2553,47,10,100.0,0.0
17167,12096,87,0,8328,59,28,100.0,0.0
17168,11688,9,11688,2334,9,0,14.285714285714286,97.33
17169,7771236,71,0,371153,33,38,6.25,0.0
17170,63156,172,63156,2431,94,78,2.3255813953488373,72.34
17171,154764,14,154764,291,14,0,7.142857142857143,93.79
17172,7773528,258,0,78375,138,120,1.851851851851852,10.0
17173,5823924,589,5823600,59159,255,334,1.25,0.0
17174,5340,8,0,1257,7,1,11.11111111111111,0.0
17175,5575164,206,5575164,26308,101,105,3.703703703703704,79.2
17176,20340,116,20340,150,59,57,1.851851851851852,21.5
17177,180,6,180,72,6,0,12.5,94.38
17178,600,36,600,278,30,6,3.333333333333333,58.29
17179,3137592,1,3137592,168,1,0,50.0,54.13
17180,7695708,551,0,246901,212,339,1.0,0.0
17181,2208,173,2208,1826,113,60,1.0869565217391304,43.59
17182,624,113,624,216,75,38,1.7857142857142858,60.97
17183,2136,45,2136,838,22,23,50.0,97.82
17184,11016,94,0,2670,69,25,100.0,0.0
17185,5388,51,0,1371,41,10,100.0,0.0
17186,112740,19,112740,833,17,2,5.555555555555555,46.71
17187,913680,23,913680,55332,16,7,11.11111111111111,84.36
17188,3090744,0,3090744,0,0,0,33.333333333333336,0.0
17189,1632,30,1632,179,28,2,3.225806451612903,69.55
17190,1164,52,0,507,35,17,1.2345679012345678,16.0
17191,192,23,192,38,18,5,5.555555555555555,63.72
17192,1409568,100,0,88287,44,56,6.25,0.0
17193,7427580,479,0,120249,265,214,1.492537313432836,8.5
17194,1236,44,1236,120,44,0,2.2222222222222223,42.7
17195,6510048,387,0,42980,199,188,2.272727272727273,0.0
17196,2855196,104,2855196,33199,43,61,8.333333333333334,86.55
17197,1548,23,1548,370,13,10,10.0,87.72
17198,4051284,75,2466048,217350,57,18,2.0,10.0
17199,46944,50,35472,5825,40,10,2.857142857142857,66.27
17200,59292,76,59292,3829,50,26,2.9411764705882355,63.87
17201,7483956,480,0,147515,251,229,2.3255813953488373,0.0
17202,25692,20,25692,259,12,8,16.666666666666668,77.0
17203,7984788,402,2804232,790472,217,185,2.380952380952381,0.53
17204,7977540,5301,989892,536312,2947,2354,1.0,4.93
17205,94920,18,94920,537,18,0,5.2631578947368425,70.76
17206,8002752,3663,472548,914583,2030,1633,1.0,0.0
17207,3744,18,0,512,12,6,11.11111111111111,0.0
17208,132,17,132,51,11,6,14.285714285714286,49.88
17209,1116,68,1116,102,43,25,3.703703703703704,55.43
17210,3132,21,3132,84,19,2,5.0,76.26
17211,1896,66,1896,76,40,26,5.0,64.6
17212,204,203,192,62,117,86,1.5873015873015872,27.77
17213,96480,236,96480,309,130,106,2.272727272727273,69.58
17214,1392312,5,1944,279820,3,2,25.0,69.71
17215,7004460,116,1108128,237616,67,49,4.761904761904762,5.0
17216,109812,2,312,54906,2,0,50.0,98.0
17217,7974708,1339,2473620,2580381,887,452,1.0,0.0
17218,468,3,468,20,3,0,20.0,70.31
17219,6644484,86,0,556814,71,15,100.0,0.0
17220,4980420,237,0,75991,108,129,2.702702702702702,0.5
17221,46668,7,46668,2792,6,1,14.285714285714286,55.14
17222,8002944,8400,4331364,1978349,5165,3235,1.0,0.97
17223,5822292,321,0,100682,135,186,2.857142857142857,0.0
17224,127596,45,127596,3144,29,16,4.545454545454546,58.37
17225,456,31,456,48,24,7,4.761904761904762,73.94
17226,684,216,612,201,165,51,1.0,0.0
17227,516,38,396,109,25,13,6.666666666666667,47.85
17228,7723416,2009,1118628,334265,1189,820,1.0,0.0
17229,7709292,560,0,74414,249,311,1.1111111111111112,0.0
17230,2750640,119,2750640,733,101,18,1.36986301369863,0.0
17231,528,30,528,187,27,3,3.571428571428572,67.21
17232,588,167,288,108,89,78,2.5641025641025643,44.44
17233,84,17,48,19,15,2,7.142857142857143,53.22
17234,552,11,0,102,10,1,100.0,0.0
17235,7498464,1091,5846712,249146,562,529,1.0,4.7
17236,7320,14,7320,7248,14,0,6.25,74.88
17237,936,85,792,122,59,26,2.272727272727273,47.65
17238,1140,50,1140,750,50,0,1.9230769230769231,87.98
17239,5402976,228,2760396,44397,108,120,2.9411764705882355,81.14
17240,25452,114,0,1723,58,56,4.761904761904762,0.0
17241,12084,37,12084,952,27,10,4.166666666666667,66.47
17242,5555664,258,0,24212,135,123,50.0,0.0
17243,576,68,576,277,42,26,3.4482758620689653,57.62
17244,149700,60,696,2614,60,0,1.7857142857142858,94.78
17245,7956876,1405,7956876,93151,854,551,1.0,54.46
17246,64248,122,64248,294,104,18,1.1494252873563218,16.45
17247,8328,144,4056,482,101,43,1.5151515151515151,0.0
17248,6711456,136,5849796,245146,81,55,1.851851851851852,0.0
17249,7928532,1643,0,1493371,911,732,1.0,0.0
17250,141240,93,116340,4216,91,2,1.162790697674419,28.8
17251,133248,39,672,3576,29,10,5.0,72.86
17252,7154328,36,6503904,159601,21,15,5.882352941176471,85.71
17253,204,3,192,92,2,1,50.0,79.44
17254,7731672,2649,2821428,101549,1160,1489,1.0,1.99
17255,1428,2,0,786,2,0,20.0,14.89
17256,744,12,744,34,12,0,7.142857142857143,77.63
17257,68340,460,2460,493,279,181,1.0,34.81
17258,1920,0,1920,0,0,0,14.285714285714286,24.75
17259,708,78,708,250,72,6,1.5873015873015872,34.76
17260,548892,44,60,12491,36,8,3.0303030303030303,29.85
17261,7490676,601,5856180,86518,358,243,1.0,0.0
17262,180,1,0,180,1,0,33.333333333333336,0.0
17263,7945920,849,0,1604396,451,398,20.0,0.0
17264,7348380,528,0,64936,266,262,1.2987012987012987,0.0
17265,2790312,53,2790312,11348,23,30,12.5,0.0
17266,6751044,210,0,142108,107,103,2.857142857142857,0.0
17267,1224,9,0,365,8,1,10.0,14.89
17268,36,1,36,0,1,0,50.0,54.61
17269,67284,77,67284,28,75,2,1.3157894736842106,31.8
17270,7570068,2194,4904460,99902,917,1277,1.0,0.0
17271,264,9,264,73,5,4,50.0,99.84
17272,74616,98,74616,229,82,16,1.3888888888888888,17.5
17273,50928,22,50928,27336,22,0,7.6923076923076925,99.46
17274,648,32,648,115,30,2,3.225806451612903,64.86
17275,59916,42,59916,18,36,6,2.857142857142857,35.04
17276,5496,7,1560,1323,5,2,20.0,72.44
17277,192,29,0,68,19,10,50.0,0.0
17278,324,8,324,111,6,2,14.285714285714286,81.3
17279,1548,24,1536,732,20,4,5.555555555555555,62.16
17280,1284,36,1284,230,24,12,7.6923076923076925,44.11
17281,2904,3,2904,72,1,2,50.0,76.45
17282,1368,5,1368,271,4,1,25.0,90.98
17283,7749792,3805,995628,150576,2160,1645,1.0,0.0
17284,7196712,55,5483772,669673,33,22,7.6923076923076925,0.0
17285,9480,47,0,288,39,8,50.0,0.0
17286,7843560,5039,672936,396994,2693,2346,1.0,1.58
17287,1932,10,336,651,7,3,25.0,59.31
17288,636,123,636,157,71,52,2.083333333333333,52.44
17289,7987884,5001,501336,1324934,2584,2417,1.0,0.0
17290,86556,0,86556,0,0,0,100.0,100.0
17291,312,7,0,68,6,1,25.0,0.0
17292,26448,11,26448,17648,11,0,10.0,93.4
17293,7954908,3258,2831184,237527,1860,1398,1.0,0.0
17294,1092,34,1092,244,25,9,5.882352941176471,45.72
17295,2921256,657,2920962,481737,306,351,1.0,29.95
17296,600,15,600,56,14,1,6.666666666666667,76.88
17297,900,4,900,39,4,0,16.666666666666668,82.71
17298,2544,76,0,540,68,8,100.0,0.0
17299,44640,63,0,2379,54,9,50.0,0.0
17300,9672,92,0,4648,67,25,100.0,0.0
17301,5523120,83,5523120,145240,37,46,5.882352941176471,75.59
17302,8010516,7393,0,455273,4294,3099,1.0,2.86
17303,8364,19,8364,1564,19,0,5.882352941176471,38.12
17304,504,1,504,84,1,0,33.333333333333336,83.35
17305,7812204,8097,1205304,1134294,3637,4460,1.0,0.0
17306,624,43,624,125,39,4,2.5641025641025643,50.98
17307,43176,102,0,3538,74,28,100.0,0.0
17308,2064,62,840,175,48,14,2.5641025641025643,51.58
17309,315876,3,315876,120,2,1,50.0,94.46
17310,19500,6,19500,1092,6,0,9.090909090909092,0.36
17311,12984,83,0,1504,57,26,100.0,0.0
17312,2590608,59,2590608,19168,45,14,2.7777777777777777,46.75
17313,576,9,576,313,6,3,14.285714285714286,69.62
17314,7788,131,0,785,77,54,50.0,0.0
17315,713796,92,0,26339,72,20,16.666666666666668,0.0
17316,7685208,2975,671856,380408,1285,1690,1.0,0.0
17317,98172,1,98172,18216,1,0,50.0,99.5
17318,4225920,943,2226432,143823,354,589,1.3157894736842106,0.0
17319,52440,216,0,2135,153,63,20.0,0.0
17320,2623548,115,2623548,265149,49,66,5.0,0.0
17321,141480,64,141480,25743,56,8,2.0,4.53
17322,912,5,468,307,5,0,16.666666666666668,83.54
17323,54168,15,54168,211,15,0,5.882352941176471,61.71
17324,8064,23,8064,86,13,10,10.0,84.92
17325,7766220,118,5534616,107551,56,62,6.25,81.28
17326,10776,142,0,622,86,56,33.333333333333336,0.0
17327,9672,182,0,2929,114,68,100.0,0.0
17328,56052,70,56052,201,58,12,1.9230769230769231,14.66
17329,5820,109,0,1463,62,47,100.0,0.0
17330,13668,22,13668,811,22,0,4.761904761904762,78.83
17331,130392,6,103284,86796,6,0,16.666666666666668,99.68
17332,7810740,1216,5858172,230596,694,522,1.0,0.0
17333,8027280,5641,0,524254,3325,2316,1.0,0.0
17334,405696,52,405696,44103,29,23,14.285714285714286,49.03
17335,896040,21,896040,17796,12,9,20.0,69.39
17336,12000,195,0,3209,125,70,100.0,0.0
17337,98676,179,0,1832,121,58,50.0,0.0
17338,156,4,156,3,4,0,16.666666666666668,57.54
17339,13512,210,0,2438,126,84,100.0,0.0
17340,869220,23,17232,38272,21,2,5.555555555555555,71.51
17341,7402440,841,0,123539,440,401,1.5625,5.0
17342,76872,70,76872,1950,40,30,16.666666666666668,53.6
17343,8021052,33217,0,1331578,21287,11930,1.0,8.41
17344,7381956,782,5849184,138770,363,419,2.083333333333333,0.37
17345,5259180,246,1779180,62852,133,113,1.0309278350515465,0.0
17346,47448,22,15516,2672,22,0,4.761904761904762,69.54
17347,8026380,1380,1013400,1869599,789,591,1.0,0.0
17348,2600844,115,2600844,11231,56,59,3.225806451612903,68.62
17349,5900892,699,0,78245,428,271,1.3157894736842106,0.0
17350,6779772,151,0,47225,84,67,5.555555555555555,0.0
17351,228,10,228,34,10,0,9.090909090909092,84.14
17352,612,0,612,0,0,0,100.0,100.0
17353,216,2,216,66,2,0,25.0,68.62
17354,204,2,204,24,1,1,50.0,60.23
17355,12696,98,0,980,82,16,1.351351351351351,0.0
17356,24192,7,24192,468,5,2,25.0,92.67
17357,13116,31,13116,4321,25,6,4.166666666666667,79.39
17358,396,12,396,147,6,6,25.0,97.15
17359,396,28,396,40,24,4,4.166666666666667,45.04
17360,446712,85,446712,272,69,16,1.5625,3.78
17361,7856028,1011,3083376,115640,543,468,1.0,39.22
17362,7991700,2821,0,1383166,2501,320,1.0,0.5
17363,15180,73,0,640,63,10,100.0,0.0
17364,6634752,143,5905560,356077,90,53,5.2631578947368425,0.0
17365,169248,10,0,17145,8,2,100.0,100.0
17366,1812,247,1812,350,137,110,1.0309278350515465,12.4
17367,7919544,227,7919544,85891,122,105,3.125,0.0
17368,16932,80,0,1576,57,23,100.0,0.0
17369,1332,38,1332,502,38,0,3.0303030303030303,50.45
17370,144720,7,144720,64524,7,0,100.0,100.0
17371,708,4,708,165,3,1,25.0,43.89
17372,6060,143,0,962,93,50,33.333333333333336,0.0
17373,7537800,311,0,1713886,170,141,1.0,0.25
17374,2595732,146,2595732,4928,60,86,5.882352941176471,72.74
17375,1272,8,1272,609,5,3,50.0,0.0
17376,384,28,384,119,28,0,3.333333333333333,47.21
17377,2700,107,0,1162,74,33,100.0,0.0
17378,178752,2,66864,89820,2,0,50.0,98.04
17379,8060484,2482,5908896,128188,1082,1400,1.0,1.0
17380,312,15,312,131,10,5,10.0,76.55
17381,372,137,360,112,80,57,2.4390243902439024,67.7
17382,408,158,168,135,111,47,1.0,0.0
17383,996,9,996,281,3,6,25.0,80.49
17384,996,82,996,315,41,41,5.0,88.72
17385,3788988,3,192,1263060,3,0,33.333333333333336,99.28
17386,2424,399,2424,545,165,234,1.4285714285714286,67.92
17387,276,14,276,96,11,3,10.0,98.44
17388,239568,4,239568,1278,2,2,33.333333333333336,90.47
17389,7946436,1425,4329884,91529,846,579,1.0,63.14
17390,8031612,175,8031612,100787,84,91,3.125,0.0
17391,11304,129,0,1487,89,40,33.333333333333336,0.0
17392,3019620,124,3019620,592,54,70,8.333333333333334,0.0
17393,84336,102,84336,1332,80,22,1.4285714285714286,10.23
17394,7766508,274,7766508,38807,163,111,4.0,80.45
17395,288,77,288,101,43,34,3.571428571428572,62.81
17396,10932,283,0,3422,180,103,100.0,0.0
17397,8964,176,0,3626,121,55,33.333333333333336,0.0
17398,486156,129,0,5157,68,61,3.333333333333333,0.0
17399,204,2,204,18,2,0,25.0,80.49
17400,8074176,1025,1070868,4751967,501,524,1.0,94.79
17401,6834852,524,0,24346,453,71,1.0,0.0
17402,7854540,2067,115500,81621,1118,949,1.0,12.03
17403,6143916,74,6068836,658556,12,62,1.1904761904761905,43.64
17404,312,3,312,128,2,1,50.0,99.98
17405,168,3,168,120,1,2,100.0,100.0
17406,39804,123,39804,3224,105,18,1.3157894736842106,8.17
17407,420,53,216,72,33,20,4.0,71.08
17408,84,28,84,24,20,8,7.142857142857143,38.32
17409,276,19,276,132,12,7,14.285714285714286,52.05
17410,984,72,0,421,63,9,100.0,0.0
17411,38988,16,38988,52,16,0,5.555555555555555,52.72
17412,7296132,126,7296132,109002,67,59,4.761904761904762,79.08
17413,7441656,1019,0,220150,591,428,1.0,0.0
17414,7642128,494,0,698396,268,226,1.639344262295082,0.0
17415,3314088,7,192,1604734,3,4,50.0,85.79
17416,48,8,48,9,6,2,14.285714285714286,64.97
17417,2515680,84,0,89312,42,42,14.285714285714286,0.0
17418,6168,30,6036,1254,24,6,6.666666666666667,94.27
17419,1116,168,180,31,159,9,1.0,72.96
17420,252,43,252,85,21,22,8.333333333333334,73.37
17421,1728,102,0,397,91,11,50.0,0.0
17422,58800,370,0,1224,201,169,1.0,3.88
17423,132,1,132,0,1,0,50.0,73.5
17424,7617384,1115,0,89651,655,460,1.0,0.0
17425,24912,3,24912,52,3,0,20.0,71.63
17426,600,19,72,72,17,2,5.882352941176471,38.34
17427,6204,59,6204,453,47,12,2.3255813953488373,31.24
17428,5736,321,1350,770,189,132,2.083333333333333,1.06
17429,4922412,132,0,40248,69,63,3.4482758620689653,0.0
17430,588300,252,0,4101,137,115,2.083333333333333,0.0
17431,34536,292,34536,1308,169,123,2.127659574468085,67.89
17432,1228656,191,1704,6676,126,65,1.020408163265306,0.47
17433,252,48,252,81,29,19,8.333333333333334,96.77
17434,11256,8,11256,411,8,0,14.285714285714286,75.79
17435,492,6,0,176,5,1,100.0,0.0
17436,336,9,336,80,7,2,12.5,92.1
17437,1020,43,1020,146,35,8,3.125,60.94
17438,8026488,99,8026488,120173,35,64,5.0,11.55
17439,64872,37,17328,2327,33,4,3.4482758620689653,58.68
17440,192,23,192,40,21,2,4.545454545454546,59.31
17441,56772,13,56772,1386,13,0,8.333333333333334,16.9
17442,157620,1045,0,42757,572,473,3.125,0.0
17443,5204448,643,0,152716,380,263,1.0,0.1
17444,128760,125,0,4462,69,56,2.5641025641025643,0.0
17445,6816204,384,0,37734,223,161,1.6129032258064515,2.0
17446,5329932,202,5329932,18984,107,95,2.4390243902439024,68.84
17447,5935800,211,5935344,106340,126,85,2.0,10.0
17448,15540,81,2556,244,59,22,1.8867924528301887,8.69
17449,6630960,238,6630960,104383,125,113,1.0,55.78
17450,384,100,324,253,91,9,1.1235955056179776,26.79
17451,744,35,0,260,23,12,7.142857142857143,0.0
17452,8074188,7815,572052,686104,4416,3399,1.0,0.0
17453,80256,197,80256,67,112,85,1.639344262295082,26.06
17454,3852,24,3048,1307,21,3,33.333333333333336,0.0
17455,216,6,216,56,4,2,33.333333333333336,71.38
17456,2523240,113,0,67363,51,62,5.555555555555555,0.0
17457,88656,124,88656,445,83,41,1.6666666666666667,33.94
17458,38868,5,168,7785,4,1,16.666666666666668,58.49
17459,420,30,420,70,26,4,3.8461538461538463,69.34
17460,156,10,156,30,8,2,11.11111111111111,60.47
17461,4100316,139,0,144435,66,73,4.0,0.0
17462,360,14,0,126,11,3,100.0,0.0
17463,2323908,129,0,44990,65,64,4.545454545454546,0.0
17464,53628,120,53628,1026,73,47,3.571428571428572,76.61
17465,8580,78,144,265,51,27,2.5,0.0
17466,8097936,20341,0,2356816,12556,7785,1.0,0.5
17467,1800,287,1320,225,198,89,1.0,0.0
17468,16848,12,0,7027,8,4,50.0,0.0
17469,66528,22,66528,9892,16,6,11.11111111111111,90.95
17470,372,8,372,135,8,0,10.0,48.76
17471,32292,47,0,3246,42,5,100.0,0.0
17472,7032,16,7032,190,16,0,6.666666666666667,0.0
17473,276,7,276,37,7,0,9.090909090909092,86.56
17474,33216,82,0,4208,56,26,100.0,0.0
17475,8118504,15974,218016,1935249,9381,6593,1.0,0.0
17476,3564612,731,0,19962,356,375,1.1904761904761905,3.95
17477,5662932,98,0,58343,92,6,100.0,0.0
17478,7589400,340,5959164,163982,174,166,2.2222222222222223,0.0
17479,2592,45,2580,2358,45,0,2.1739130434782608,22.49
17480,5683416,402,1896864,46467,241,161,3.4482758620689653,0.0
17481,268584,31,268584,169826,31,0,3.333333333333333,45.69
17482,597000,23,14736,47012,22,1,4.761904761904762,74.04
17483,8196,78,0,2104,59,19,100.0,0.0
17484,47940,143,0,1445,93,50,50.0,0.0
17485,900,96,0,244,65,31,100.0,0.0
17486,4209432,195,0,91256,103,92,2.9411764705882355,0.0
17487,828,66,828,640,34,32,5.0,79.57
17488,6734616,139,6345066,136793,57,82,5.2631578947368425,92.02
17489,2591064,175,0,47690,99,76,3.125,0.0
17490,5748,44,5748,1417,28,16,3.571428571428572,10.68
17491,13992,10,13992,37,6,4,25.0,81.0
17492,7213800,124,0,903243,43,81,4.761904761904762,0.0
17493,8020704,566,6981054,79532,269,297,1.5151515151515151,65.31
17494,7710216,744,0,144994,413,331,1.2820512820512822,0.0
17495,432,0,432,0,0,0,9.090909090909092,0.0
17496,7804536,1168,0,452354,573,595,1.0,0.0
17497,0,0,0,0,0,0,50.0,25.93
17498,5232,10,5232,0,10,0,9.090909090909092,99.89
17499,53592,74,0,1774,55,19,100.0,0.0
17500,605160,41,605160,488234,41,0,6.666666666666667,99.09
17501,21672,3,1380,7320,2,1,1.0,0.0
17502,274368,40,274368,153441,40,0,100.0,100.0
17503,10656,393,0,3808,238,155,100.0,0.0
17504,7399416,1141,686580,575793,632,509,1.0,0.0
17505,10944,23,10944,9590,13,10,10.0,91.05
17506,2861376,144,2861376,48974,61,83,2.4390243902439024,69.23
17507,315516,154,0,5014,93,61,33.333333333333336,0.0
17508,10980,248,0,3063,152,96,100.0,0.0
17509,5583708,190,2604444,144347,100,90,1.851851851851852,0.0
17510,8057136,8683,0,473047,5051,3632,1.0,0.0
17511,1904592,110,1904592,218207,51,59,4.761904761904762,60.97
17512,14676,135,0,4027,99,36,50.0,0.0
17513,6357156,44,0,559601,30,14,4.166666666666667,5.0
17514,372,3,0,152,3,0,20.0,0.95
17515,951924,148,0,6979,76,72,4.761904761904762,0.0
17516,17748,22,17748,696,22,0,4.545454545454546,71.28
17517,7489308,508,0,368318,285,223,1.25,0.0
17518,7645056,616,0,330757,364,252,1.2987012987012987,0.0
17519,7502952,563,0,817482,309,254,1.2820512820512822,3.5
17520,204,58,204,83,39,19,4.761904761904762,90.22
17521,7734996,1236,0,588440,714,522,1.0,0.0
17522,7908,6,5856,3990,4,2,33.333333333333336,56.06
17523,132,25,132,24,19,6,6.666666666666667,51.69
17524,120,18,120,30,14,4,7.6923076923076925,43.28
17525,168,4,168,24,4,0,16.666666666666668,57.6
17526,5545824,92,0,574755,45,47,5.2631578947368425,0.0
17527,6385176,418,5390808,92703,226,192,1.0416666666666667,0.0
17528,6744096,483,0,100297,268,215,1.5625,0.0
17529,11772,9,528,3997,6,3,25.0,56.42
17530,144,6,144,20,6,0,12.5,66.02
17531,1380,43,1380,904,37,6,2.7777777777777777,67.36
17532,240,44,240,22,44,0,2.1739130434782608,39.23
17533,216,33,144,44,25,8,4.545454545454546,47.57
17534,8149404,30604,4472620,2903286,17346,13258,1.0,0.0
17535,9312,26,108,425,20,6,5.555555555555555,35.77
17536,816,71,636,506,59,12,1.851851851851852,27.45
17537,108,27,108,12,27,0,3.4482758620689653,32.32
17538,3701736,627,0,26727,331,296,1.4492753623188406,0.0
17539,6763776,170,0,572190,79,91,4.3478260869565215,3.57
17540,144,22,144,24,15,7,10.0,58.95
17541,79956,10,0,8149,7,3,100.0,100.0
17542,7774464,1269,0,231217,709,560,1.0,0.0
17543,264,31,0,145,17,14,100.0,0.0
17544,6806832,799,0,730790,419,380,1.3157894736842106,0.0
17545,96,51,96,24,37,14,3.125,34.98
17546,2472,20,2472,57,12,8,16.666666666666668,47.74
17547,288,21,0,102,14,7,100.0,0.0
17548,3696,26,3696,19,23,3,4.545454545454546,46.52
17549,1668,5,1668,105,4,1,25.0,80.87
17550,60,34,48,4,34,0,2.857142857142857,42.98
17551,6028068,267,0,31531,138,129,3.333333333333333,5.0
17552,7943328,170,900,82807,91,79,4.3478260869565215,0.0
17553,8152920,2889,0,1640414,1600,1289,1.0,0.0
17554,336,46,144,85,43,3,2.272727272727273,23.77
17555,2292,325,1452,347,111,214,1.1111111111111112,26.43
17556,7547940,99,7547940,29038,54,45,4.0,66.1
17557,396,17,396,23,13,4,7.6923076923076925,79.36
17558,231624,70,1464,3429,46,24,2.7777777777777777,37.85
17559,348,69,348,87,67,2,1.5384615384615383,43.09
17560,7190076,413,0,107452,236,177,1.9230769230769231,0.0
17561,7981776,385,0,4447327,203,182,2.631578947368421,0.0
17562,156,4,156,39,4,0,16.666666666666668,68.05
17563,1400052,23,1400052,358,18,5,6.25,57.17
17564,3107340,11,3107340,2308,8,3,14.285714285714286,3.0
17565,1536,29,1536,246,27,2,3.703703703703704,43.31
17566,6004008,499,0,355074,285,214,1.492537313432836,3.47
17567,81660,231,0,2774,87,144,2.272727272727273,0.0
17568,85992,88,372,2329,80,8,1.2658227848101269,22.44
17569,9768,2,9768,3864,2,0,33.333333333333336,98.74
17570,138216,8,138216,516,8,0,9.090909090909092,18.87
17571,576,42,348,76,25,17,5.2631578947368425,53.62
17572,924,2,828,702,2,0,100.0,100.0
17573,242604,101,198,4896,69,32,1.7543859649122806,31.1
17574,2866368,156,0,99857,72,84,4.0,0.0
17575,6005028,81,3029868,569,43,38,3.703703703703704,59.41
17576,1320,2,1320,276,1,1,50.0,99.92
17577,1584,10,1584,626,8,2,14.285714285714286,53.83
17578,4548,20,4548,38,20,0,4.545454545454546,43.79
17579,192,5,192,55,4,1,20.0,57.09
17580,7958340,171,0,215138,82,89,3.703703703703704,0.0
17581,2410824,6,2410824,140,4,2,20.0,62.36
17582,468,104,0,147,41,63,12.5,0.0
17583,264,3,264,56,2,1,33.333333333333336,95.5
17584,8110176,202,4988790,178748,105,97,4.3478260869565215,66.43
17585,590292,30,590292,48160,25,5,4.166666666666667,78.44
17586,276,34,276,122,32,2,3.225806451612903,55.18
17587,168,24,168,53,15,9,12.5,51.59
17588,174000,489,0,3696,261,228,1.7543859649122806,5.0
17589,396,8,396,87,8,0,10.0,59.54
17590,6984708,197,0,129759,95,102,2.702702702702702,0.0
17591,7724304,69,7724304,3537,37,32,4.3478260869565215,63.64
17592,12000,13,12000,79,9,4,14.285714285714286,66.32
17593,1576776,162,0,15197,83,79,2.9411764705882355,0.0
17594,384,71,384,121,67,4,1.492537313432836,42.86
17595,7116,1,7116,552,1,0,100.0,100.0
17596,8171136,646,0,3866431,432,214,11.11111111111111,0.0
17597,242880,34,0,40351,15,19,14.285714285714286,0.0
17598,7971216,195,6991368,266280,88,107,7.142857142857143,94.37
17599,408,62,408,129,42,20,4.166666666666667,55.05
17600,1440,87,516,305,78,9,1.5625,24.56
17601,8176452,10864,252,2651335,6216,4648,1.0,2.46
17602,283740,76,283740,6530,31,45,11.11111111111111,93.15
17603,8107800,8073,0,1547470,5077,2996,1.0,0.0
17604,5568840,170,0,66222,87,83,3.4482758620689653,0.0
17605,732,106,732,153,67,39,2.9411764705882355,66.65
17606,8108040,61,8108040,1023,59,2,1.6666666666666667,88.6
17607,1266540,23,1266540,758,14,9,12.5,53.32
17608,7966248,351,6015060,351944,147,204,3.0303030303030303,2.5
17609,6614688,117,0,238914,54,63,5.555555555555555,3.0
17610,12420,7,12420,510,7,0,12.5,89.42
17611,8166156,6030,0,1320263,3618,2412,1.0,0.0
17612,8177364,3417,0,758180,1907,1510,1.0,0.0
17613,55140,77,696,919,75,2,1.6129032258064515,84.29
17614,8148972,127,8148972,320355,54,73,1.639344262295082,67.14
17615,336,48,336,63,40,8,2.9411764705882355,34.99
17616,14388,464,0,3204,276,188,1.0,0.02
17617,100308,18,100308,12029,16,2,5.882352941176471,92.98
17618,2388,59,2388,59,59,0,1.639344262295082,27.51
17619,5741472,189,0,366954,80,109,5.0,0.0
17620,830844,109,0,15825,58,51,4.0,0.0
17621,180,7,180,51,6,1,16.666666666666668,88.92
17622,6092796,327,256836,131758,250,77,1.0,0.0
17623,3007404,788,3007152,21472,325,463,1.408450704225352,56.77
17624,96,0,96,0,0,0,50.0,64.0
17625,756,42,624,448,29,13,4.0,0.0
17626,8019252,29,8019252,7872,18,11,8.333333333333334,30.59
17627,8173332,2492,0,2689101,1522,970,1.0,0.0
17628,7860960,1938,827220,778667,974,964,1.0,0.0
17629,5342616,776,0,47868,396,380,1.0,2.3
17630,4320,4,0,2844,3,1,16.666666666666668,30.0
17631,2808,3,2808,172,3,0,33.333333333333336,94.45
17632,4109256,20,0,438405,13,7,10.0,3.22
17633,180,17,180,47,17,0,5.2631578947368425,39.81
17634,8137176,6760,327972,430639,3995,2765,1.0,0.0
17635,3816,4,3816,165,4,0,20.0,94.87
17636,7948560,525,6018072,85899,317,208,1.4492753623188406,0.0
17637,216,0,216,0,0,0,100.0,100.0
17638,456,4,456,288,3,1,33.333333333333336,0.0
17639,5748420,241,0,297081,128,113,2.9411764705882355,0.0
17640,6403680,273,0,195827,148,125,3.0303030303030303,0.0
17641,1740,6,1740,682,6,0,14.285714285714286,94.49
17642,828,51,828,44,43,8,2.5,24.71
17643,7890984,300,0,380359,151,149,2.272727272727273,0.0
17644,8192028,19108,924636,2474222,9878,9230,1.0,18.31
17645,5591952,47,156,119064,40,7,2.7777777777777777,31.34
17646,5115108,471,2605212,70238,222,249,1.1494252873563218,0.0
17647,7935096,899,4384596,221542,502,397,1.0,19.1
17648,4382928,39,4382928,5263,21,18,14.285714285714286,0.0
17649,7106292,584,0,432480,267,317,1.1111111111111112,0.0
17650,88740,45,3504,2019,28,17,5.555555555555555,71.82
17651,8064924,1562,248280,142561,764,798,1.0,0.0
17652,2640,103,2640,566,67,36,2.0,41.49
17653,768,6,768,24,3,3,33.333333333333336,96.02
17654,9384,4,9384,177,4,0,20.0,93.05
17655,2981328,1133,40548,60513,557,576,1.0,0.0
17656,6966288,98,0,164460,52,46,4.166666666666667,0.0
17657,7809696,1590,0,167806,890,700,1.0,0.0
17658,3127164,26,483444,496759,25,1,3.8461538461538463,16.96
17659,8200080,14767,4107412,2608187,9128,5639,1.0,0.0
17660,8204388,7629,760464,3422765,4281,3348,1.0,22.63
17661,9216,14,9216,1379,11,3,10.0,64.67
17662,1872,13,1872,25,12,1,11.11111111111111,55.56
17663,5467428,276,0,46298,136,140,2.272727272727273,0.0
17664,6768,69,6768,1294,49,20,2.5,53.64
17665,120,38,120,32,38,0,2.5,25.75
17666,756,31,756,188,29,2,3.4482758620689653,96.1
17667,28956,18,28956,826,18,0,5.555555555555555,74.04
17668,35640,82,0,1062,37,45,6.666666666666667,0.0
17669,1151796,506,0,3216,277,229,1.2820512820512822,0.0
17670,6948,19,6948,4075,11,8,14.285714285714286,79.39
17671,5811684,56,2892,104608,54,2,1.851851851851852,27.35
17672,6817236,63,6817236,555984,28,35,3.333333333333333,0.0
17673,2409552,52,2167212,198006,52,0,16.666666666666668,99.91
17674,7692624,836,0,93209,456,380,1.0,0.0
17675,257088,99,257088,101159,99,0,4.3478260869565215,98.48
17676,69996,136,0,2005,99,37,50.0,0.0
17677,8215668,10536,856692,2814876,5630,4906,1.0,0.0
17678,50772,11,50772,1641,8,3,16.666666666666668,91.1
17679,4344,8,4344,1882,6,2,50.0,99.98
17680,8112624,367,0,220832,208,159,2.0408163265306123,0.0
17681,6928056,610,0,80089,290,320,2.2222222222222223,0.0
17682,8208660,191,1207080,3371704,107,84,1.0,2.22
17683,2679408,201,2679408,437406,112,89,2.702702702702702,62.12
17684,6446916,676,0,593628,418,258,1.0,0.0
17685,5424,13,5424,1367,6,7,33.333333333333336,99.93
17686,17604,1,17262,17304,1,0,100.0,100.0
17687,7458648,379,0,116061,201,178,2.083333333333333,4.51
17688,8964,181,0,2221,108,73,100.0,0.0
17689,7578816,571,1471284,1017751,173,398,1.0,0.0
17690,210168,16,109182,2969,16,0,9.090909090909092,12.62
17691,35676,68,35676,35525,66,2,1.5151515151515151,23.74
17692,564,5,564,33,4,1,20.0,41.68
17693,7056,19,6816,6683,17,2,5.882352941176471,31.51
17694,522648,509,348216,125449,487,22,1.0,25.45
17695,1626528,107,0,18371,63,44,4.545454545454546,0.0
17696,8011248,44,4397412,874484,24,20,11.11111111111111,74.66
17697,891684,0,891684,0,0,0,100.0,100.0
17698,1604220,23,0,596549,15,8,16.666666666666668,0.0
17699,61560,159,0,4651,105,54,100.0,0.0
17700,1748076,23,24792,81058,22,1,5.0,72.17
17701,8149512,4182,0,376674,2358,1824,1.0,0.0
17702,624,12,624,62,12,0,7.6923076923076925,82.0
17703,4719024,23,108,205447,20,3,5.2631578947368425,0.0
17704,84948,208,0,2567,134,74,100.0,0.0
17705,276,0,276,0,0,0,100.0,100.0
17706,624,6,624,12,6,0,12.5,91.0
17707,14712,268,0,2277,154,114,100.0,0.0
17708,6433260,288,1513584,62844,151,137,2.631578947368421,0.0
17709,492,7,492,221,7,0,11.11111111111111,51.51
17710,6202932,115,0,202461,53,62,5.882352941176471,5.0
17711,8218464,6905,199977,930317,3864,3041,1.0,0.32
17712,13620,18,13620,386,18,0,5.555555555555555,72.94
17713,1740,4,1374,555,2,2,33.333333333333336,30.84
17714,6009012,170,0,73930,86,84,5.882352941176471,4.92
17715,6759624,50,211932,264111,50,0,7.142857142857143,96.55
17716,120,57,120,48,45,12,2.380952380952381,27.33
17717,164064,10,0,16705,7,3,50.0,0.0
17718,46548,21,46548,19469,20,1,7.142857142857143,98.27
17719,2368152,3,204,789468,3,0,50.0,99.17
17720,2918268,457,2918268,1844,245,212,1.7543859649122806,67.19
17721,6072,13,0,564,12,1,6.666666666666667,17.76
17722,2798412,112,2798412,8934,62,50,4.545454545454546,61.75
17723,421296,6,421296,54,6,0,12.5,60.77
17724,5496372,85,0,152227,38,47,12.5,0.0
17725,5795040,181,0,194134,84,97,3.333333333333333,5.0
17726,840,6,840,234,6,0,20.0,80.12
17727,40992,49,40992,1416,31,18,4.166666666666667,48.84
17728,7953228,77,7952904,189924,38,39,7.142857142857143,0.0
17729,276,101,276,65,67,34,2.1739130434782608,59.74
17730,3348,46,276,137,42,4,2.7777777777777777,48.65
17731,5999364,380,0,76674,202,178,2.1739130434782608,3.0
17732,2100,27,2100,1779,23,4,4.3478260869565215,54.46
17733,180,0,180,0,0,0,50.0,61.33
17734,2661180,52,2661084,51687,45,7,3.0303030303030303,0.0
17735,276,10,0,122,6,4,100.0,0.0
17736,8226660,1820,2115372,985420,918,902,1.0,0.87
17737,156,5,156,43,3,2,25.0,98.16
17738,5638860,34,2683800,363442,21,13,6.666666666666667,76.42
17739,5511408,176,0,170156,84,92,7.142857142857143,0.0
17740,2364,13,2364,352,9,4,16.666666666666668,71.75
17741,8057220,1812,0,1080308,929,883,1.0,0.0
17742,38736,131,0,2540,101,30,100.0,0.0
17743,840,7,840,416,5,2,16.666666666666668,95.69
17744,108,12,108,41,6,6,20.0,92.54
17745,8244948,1034,0,1664234,573,461,1.0,0.0
17746,384,8,0,166,5,3,100.0,0.0
17747,6964044,211,0,33538,106,105,4.545454545454546,0.0
17748,1728,81,0,390,40,41,6.666666666666667,0.0
17749,14412,675,14412,417,655,20,1.0,31.6
17750,176916,30,176916,646,27,3,4.0,67.24
17751,312,4,312,54,4,0,20.0,92.61
17752,21876,14,564,1715,10,4,11.11111111111111,39.04
17753,480,32,480,32,24,8,4.3478260869565215,67.27
17754,1116,96,1116,202,87,9,1.2048192771084338,18.14
17755,19632,225,0,3143,137,88,100.0,0.0
17756,6248004,208,0,60737,108,100,4.3478260869565215,0.0
17757,3089688,131,3089688,2502,61,70,4.166666666666667,82.06
17758,542160,28,0,43136,11,17,50.0,0.02
17759,672,23,672,21,17,6,6.25,72.22
17760,8210940,1040,0,2336973,569,471,1.0,0.0
17761,348,13,348,81,9,4,11.11111111111111,84.01
17762,4164,44,960,241,30,14,4.166666666666667,37.54
17763,365352,61,365352,9002,15,46,12.5,62.19
17764,360,129,360,94,85,44,2.0408163265306123,20.7
17765,156,10,156,39,5,5,14.285714285714286,82.38
17766,624,24,624,172,14,10,16.666666666666668,68.37
17767,552,120,0,102,97,23,1.1363636363636365,0.0
17768,276,12,0,202,10,2,8.333333333333334,10.0
17769,7522728,1029,0,82797,615,414,1.0,0.0
17770,252,45,252,55,23,22,7.142857142857143,78.98
17771,168,2,168,0,2,0,25.0,57.72
17772,336,72,336,90,68,4,1.639344262295082,41.33
17773,565344,16,286752,104952,15,1,7.142857142857143,0.0
17774,8109900,1922,2880,63716,934,988,1.0,0.22
17775,8212044,1583,477732,134806,897,686,1.098901098901099,0.0
17776,28284,112,0,958,75,37,100.0,0.0
17777,3568092,319,3568092,20356,191,128,1.639344262295082,71.19
17778,42228,124,0,3200,76,48,100.0,0.0
17779,8013924,10777,1867680,2777650,6728,4049,1.0,0.0
17780,216,49,216,143,45,4,2.857142857142857,47.54
17781,4152,39,786,1274,22,17,100.0,0.0
17782,3588,51,3588,681,42,9,2.857142857142857,5.34
17783,8242800,1251,0,605720,764,487,1.0,0.0
17784,16824,50,0,656,42,8,100.0,0.0
17785,8189580,121,5070090,2930,70,51,2.083333333333333,41.49
17786,103860,104,0,5622,62,42,3.8461538461538463,0.0
17787,432,50,432,81,36,14,3.225806451612903,53.46
17788,6140832,175,0,36552,108,67,50.0,0.0
17789,7517940,281,0,101233,159,122,2.127659574468085,0.0
17790,336,43,144,82,42,1,2.4390243902439024,35.51
17791,6158460,1222,1368288,150385,696,526,1.0,0.0
17792,276,2,276,66,2,0,33.333333333333336,99.06
17793,1020,285,1020,175,175,110,1.0,14.71
17794,123504,205,0,7081,134,71,100.0,0.0
17795,168,9,168,25,6,3,20.0,52.84
17796,19344,98,0,928,66,32,50.0,0.0
17797,1824,18,1824,155,14,4,6.666666666666667,61.73
17798,144,26,120,31,19,7,6.666666666666667,43.16
17799,2652,156,2652,452,92,64,1.2820512820512822,32.9
17800,4655076,150,0,208479,86,64,2.5,0.0
17801,312,74,312,85,42,32,4.0,71.6
17802,492,68,144,46,51,17,2.2222222222222223,6.51
17803,13392,109,13392,3462,89,20,1.492537313432836,1.68
17804,8115852,115,5382762,96134,79,36,1.7241379310344829,50.93
17805,228,16,216,15,15,1,100.0,100.0
17806,120,4,120,36,2,2,50.0,60.07
17807,7342008,1436,0,56029,830,606,1.0,0.0
17808,2676,73,2676,307,71,2,1.4492753623188406,34.2
17809,108,0,108,0,0,0,50.0,90.0
17810,348,10,348,170,10,0,8.333333333333334,87.94
17811,1788,60,480,276,41,19,4.166666666666667,51.99
17812,2674632,47,2674632,29776,22,25,7.6923076923076925,48.5
17813,1956,0,1956,0,0,0,33.333333333333336,3.33
17814,1308,32,684,142,24,8,5.0,63.6
17815,28956,21,28956,5834,18,3,7.6923076923076925,10.55
17816,1092,4,180,336,2,2,50.0,67.82
17817,8271696,319,1120584,3622297,188,131,1.7857142857142858,10.0
17818,141036,66,141036,33306,57,9,2.0,4.3
17819,4161600,25,0,3086526,17,8,100.0,100.0
17820,5532504,197,0,65134,99,98,4.166666666666667,0.0
17821,18888,159,18888,602,119,40,1.2987012987012987,95.45
17822,480,14,216,151,6,8,20.0,83.82
17823,372,12,0,80,9,3,100.0,100.0
17824,8030736,157,8030736,116618,83,74,4.0,26.15
17825,1284,74,1284,310,56,18,2.0408163265306123,51.97
17826,5254356,239,5254356,21924,127,112,2.0408163265306123,72.99
17827,396,207,396,197,103,104,2.127659574468085,51.51
17828,86820,30,0,9867,24,6,5.555555555555555,0.0
17829,936,41,936,409,41,0,2.631578947368421,26.86
17830,20940,165,0,718,85,80,4.0,5.0
17831,300,11,300,27,7,4,14.285714285714286,63.6
17832,2168952,65,2168952,176465,34,31,20.0,0.0
17833,7742232,257,7742232,87550,143,114,2.9411764705882355,72.77
17834,8280,18,1524,525,13,5,10.0,56.58
17835,828,16,828,96,10,6,14.285714285714286,77.93
17836,456,73,456,325,67,6,1.5384615384615383,39.39
17837,180,0,180,0,0,0,50.0,95.0
17838,7145280,839,0,75358,468,371,1.0,0.0
17839,59604,83,59604,185,65,18,1.7543859649122806,44.16
17840,1164,65,1164,504,51,14,2.1739130434782608,61.79
17841,1812,22,0,488,15,7,100.0,100.0
17842,1680,105,612,182,74,31,1.694915254237288,27.42
17843,61200,139,61200,229,89,50,1.1764705882352942,36.78
17844,8175372,2997,1267368,927801,1695,1302,1.0,6.01
17845,5911920,830,0,235372,334,496,1.0638297872340423,0.0
17846,1548,157,0,435,104,53,100.0,0.0
17847,2663820,322,2663820,37885,178,144,1.9230769230769231,57.28
17848,28800,198,0,3370,130,68,100.0,0.0
17849,7777056,1207,3791292,408300,688,519,1.0,0.0
17850,388572,274,62532,1950,187,87,1.0,36.55
17851,3396444,360,0,15627,185,175,1.6666666666666667,1.27
17852,705948,10,705948,24144,7,3,20.0,84.88
17853,8258460,646,0,3710764,484,162,11.11111111111111,0.0
17854,6108,0,6108,0,0,0,100.0,0.0
17855,313440,0,313440,0,0,0,50.0,89.0
17856,1248,56,1248,500,50,6,2.083333333333333,35.83
17857,6891528,1522,3795924,76485,815,707,1.0,2.5
17858,39084,10,39084,73,9,1,10.0,62.75
17859,8099784,1314,0,86737,746,568,1.0,0.0
17860,2635584,677,2635584,80985,336,341,1.6129032258064515,61.09
17861,2340516,180,2340516,2314,96,84,3.125,0.0
17862,204,37,204,39,31,6,3.333333333333333,51.53
17863,16632,20,16164,1149,19,1,5.555555555555555,77.37
17864,591456,186,8238,10152,120,66,33.333333333333336,0.0
17865,8275068,750,0,2041421,548,202,11.11111111111111,0.0
17866,576,52,384,118,44,8,2.380952380952381,39.11
17867,180,9,180,86,6,3,20.0,53.0
17868,12132,9,12132,942,8,1,20.0,95.26
17869,45744,79,45744,45503,63,16,1.818181818181818,17.54
17870,10548,7,10524,2718,6,1,25.0,0.0
17871,1140,23,1140,785,18,5,7.6923076923076925,73.12
17872,10272,20,10272,540,20,0,5.0,75.05
17873,111096,27,111096,30145,26,1,5.0,59.39
17874,6795360,72,0,1507949,60,12,20.0,0.0
17875,11136,20,11136,502,20,0,5.2631578947368425,78.4
17876,3529632,80,0,46372,65,15,12.5,0.0
17877,7239144,1269,0,150294,510,759,1.0,0.0
17878,2755872,36,2755872,4715,21,15,6.666666666666667,71.64
17879,768,3,204,312,3,0,25.0,73.29
17880,5576208,109,0,155017,54,55,6.25,0.0
17881,348,9,348,52,5,4,33.333333333333336,83.43
17882,984756,137,276114,126102,137,0,1.9230769230769231,95.64
17883,8017440,29,14172,279374,26,3,5.0,75.51
17884,82392,20,82392,8797,16,4,8.333333333333334,51.16
17885,790116,17,790116,713,7,10,12.5,1.52
17886,28512,69,744,588,51,18,2.702702702702702,62.21
17887,7394616,184,0,2016814,121,63,3.333333333333333,0.0
17888,7010880,658,3942864,151628,378,280,1.4285714285714286,60.0
17889,1872,207,1872,622,128,79,1.020408163265306,41.64
17890,5763624,70,4259640,261,60,10,1.8867924528301887,46.13
17891,288,13,288,131,8,5,20.0,53.84
17892,648,34,180,110,34,0,2.857142857142857,68.32
17893,13668,83,0,2634,68,15,16.666666666666668,0.0
17894,22212,4,22212,12,2,2,50.0,76.58
17895,8111544,244,0,133061,119,125,4.545454545454546,5.0
17896,1776,58,816,109,39,19,3.4482758620689653,45.67
17897,26532,115,26532,5597,70,45,2.2222222222222223,61.15
17898,151008,18,151008,3790,11,7,16.666666666666668,92.32
17899,7548276,111,0,442946,73,38,2.272727272727273,0.0
17900,21468,63,0,2206,51,12,100.0,0.0
17901,240,18,240,64,18,0,5.2631578947368425,58.43
17902,3984,6,3984,556,6,0,14.285714285714286,57.36
17903,7590024,614,0,157429,290,324,1.1494252873563218,0.0
17904,8074344,1453,0,180990,822,631,1.0,0.0
17905,384,52,384,64,52,0,1.851851851851852,49.46
17906,6480,11,6480,631,7,4,20.0,56.51
17907,1988304,146,0,14031,74,72,3.225806451612903,0.0
17908,6571404,194,0,34305,97,97,3.225806451612903,0.0
17909,708,130,708,231,100,30,1.2658227848101269,35.27
17910,8194152,763,0,219353,375,388,1.1111111111111112,0.0
17911,504,31,504,109,29,2,3.333333333333333,53.03
17912,2148,47,0,746,39,8,100.0,0.0
17913,1934784,8,0,1764031,8,0,20.0,0.0
17914,4236,613,2376,371,342,271,1.0,35.43
17915,343200,16,343200,139,15,1,6.25,79.52
17916,432,15,432,152,11,4,10.0,61.9
17917,345600,78,345600,1444,72,6,1.5625,31.75
17918,5076,50,5076,3287,46,4,2.1739130434782608,27.68
17919,7978032,1360,0,947112,717,643,1.0,0.0
17920,7248000,264,0,39163,163,101,33.333333333333336,0.0
17921,9516,8,0,4654,5,3,25.0,0.0
17922,600,23,432,374,19,4,5.555555555555555,58.85
17923,1764,42,1764,194,23,19,6.666666666666667,62.83
17924,51780,66,0,976,51,15,50.0,0.0
17925,1275648,45,0,86950,38,7,100.0,0.0
17926,324,7,324,138,4,3,33.333333333333336,51.27
17927,1848,58,1848,525,26,32,8.333333333333334,62.12
17928,8017764,1326,0,134014,649,677,1.0,0.0
17929,80280,43,80280,1869,37,6,4.0,62.62
17930,34632,187,0,2809,112,75,100.0,0.0
17931,8323212,20895,2661460,2291028,11514,9381,1.0,0.0
17932,44808,68,44808,124,52,16,2.1739130434782608,59.51
17933,300,23,264,120,21,2,5.555555555555555,35.15
17934,47064,120,47064,415,102,18,1.020408163265306,25.45
17935,4362060,187,0,30961,94,93,3.333333333333333,3.96
17936,7260,46,7260,1266,28,18,6.25,65.42
17937,8160720,147,0,252799,83,64,2.631578947368421,0.0
17938,456,44,456,139,38,6,2.702702702702702,67.57
17939,8275740,6810,0,1386077,3880,2930,1.0,0.0
17940,73812,34,73812,4539,30,4,4.166666666666667,5.44
17941,53376,12,53376,1607,11,1,14.285714285714286,47.09
17942,0,1,0,0,1,0,33.333333333333336,10.0
17943,43140,141,43140,4512,118,23,1.1494252873563218,4.65
17944,2040,12,2040,730,7,5,25.0,94.89
17945,7902660,9,7902660,489,7,2,12.5,86.08
17946,255828,568,255828,58885,263,305,1.408450704225352,63.31
17947,135960,53,240,5282,36,17,4.3478260869565215,0.0
17948,1113048,12,0,93504,11,1,7.6923076923076925,3.0
17949,1332,6,1332,464,4,2,25.0,91.42
17950,6256344,801,0,28626,434,367,1.0638297872340423,4.93
17951,2594784,267,2594784,2526,131,136,1.7543859649122806,0.0
17952,51132,199,0,3649,120,79,100.0,0.0
17953,108,3,108,36,2,1,33.333333333333336,78.34
17954,8363712,62178,145896,2875592,39213,22965,1.0,0.0
17955,264,5,264,81,4,1,20.0,56.72
17956,1152,1,1152,0,1,0,33.333333333333336,54.89
17957,7221204,14,0,517802,10,4,5.555555555555555,0.0
17958,2302752,84,1560,27916,68,16,1.694915254237288,49.1
17959,7367640,670,0,86675,373,297,1.0869565217391304,0.0
17960,8101080,542,5191962,3346865,252,290,1.0,24.85
17961,4521168,116,0,214500,57,59,3.703703703703704,0.0
17962,17988,182,0,2370,114,68,100.0,0.0
17963,364632,13,364632,21115,8,5,33.333333333333336,0.01
17964,74628,90,0,4943,64,26,100.0,0.0
17965,360,4,360,288,2,2,33.333333333333336,78.34
17966,20772,40,20772,498,38,2,2.5641025641025643,56.81
17967,38976,2,38976,6,2,0,33.333333333333336,79.36
17968,51576,11,51576,174,11,0,10.0,8.54
17969,77916,30,0,11642,24,6,100.0,0.0
17970,8369580,3564,1101096,4947504,1836,1728,1.0,0.0
17971,8361156,753,2833368,2751923,408,345,1.0,0.0
17972,8280684,1366,0,125724,787,579,1.0,0.0
17973,2988384,224,0,28073,120,104,2.5641025641025643,0.0
17974,492,31,492,69,30,1,4.545454545454546,20.2
17975,81780,92,0,4294,60,32,100.0,0.0
17976,169332,0,169332,0,0,0,100.0,100.0
17977,6552,21,6552,1153,16,5,8.333333333333334,56.63
17978,3103956,123,3103956,14184,57,66,4.0,77.93
17979,6928836,868,0,43745,373,495,1.2820512820512822,5.0
17980,2352,15,2352,602,11,4,12.5,70.7
17981,528,77,528,202,41,36,4.0,54.32
17982,432,21,0,145,13,8,50.0,0.0
17983,32412,29,32412,55,23,6,5.2631578947368425,45.82
17984,5028408,219,0,24386,114,105,2.857142857142857,0.0
17985,1871160,415,0,32109,222,193,2.0408163265306123,0.0
17986,636,59,360,174,41,18,3.125,66.56
17987,11976,158,0,855,104,54,100.0,0.0
17988,120,45,120,32,30,15,5.555555555555555,52.68
17989,348,105,0,67,55,50,100.0,0.0
17990,7297656,718,0,77822,402,316,1.0416666666666667,0.0
17991,165456,11,0,15714,8,3,16.666666666666668,0.0
17992,32556,131,0,8758,74,57,100.0,0.0
17993,8371992,2750,1363596,643510,1492,1258,1.0,6.5
17994,324,7,324,97,4,3,33.333333333333336,61.95
17995,5448,204,0,1981,126,78,100.0,0.0
17996,28272,9,28272,912,9,0,16.666666666666668,69.36
17997,4972620,137,0,52743,94,43,2.857142857142857,0.0
17998,127800,230,0,6140,149,81,100.0,0.0
17999,354456,389,0,25050,298,91,50.0,0.0
18000,156,1,156,0,1,0,33.333333333333336,65.6
18001,684,8,684,67,7,1,20.0,98.79
18002,552,1,552,156,1,0,33.333333333333336,52.47
18003,5944380,24,192288,344130,22,2,7.142857142857143,61.93
18004,7759224,776,0,111018,452,324,1.0,0.0
18005,7655196,184,0,1686863,81,103,1.694915254237288,1.9
18006,2684988,168,2684988,17386,84,84,2.702702702702702,70.09
18007,4680,30,4680,990,25,5,4.761904761904762,57.79
18008,7772832,136,7772832,570726,70,66,5.882352941176471,83.72
18009,5616036,43,12660,892536,36,7,4.545454545454546,64.17
18010,2506944,52,2506944,11580,31,21,12.5,0.0
18011,123744,166,0,2467,110,56,100.0,0.0
18012,2052,36,2052,960,16,20,25.0,88.01
18013,78852,100,78852,27731,50,50,6.25,83.62
18014,12804,261,0,5028,158,103,100.0,0.0
18015,12744,84,0,1425,56,28,100.0,0.0
18016,5978856,294,0,98759,139,155,2.5641025641025643,4.5
18017,8399880,8936,1344816,1730227,5368,3568,1.0,0.0
18018,8193828,1080,0,146898,608,472,1.0869565217391304,0.0
18019,2376,77,0,1615,49,28,2.631578947368421,10.0
18020,240,40,240,35,33,7,3.703703703703704,47.37
18021,36,0,36,0,0,0,50.0,72.25
18022,60,0,60,0,0,0,50.0,72.25
18023,17244,25,12384,1261,23,2,4.545454545454546,72.9
18024,28812,13,28812,164,13,0,7.6923076923076925,79.81
18025,2496,29,2496,612,27,2,3.571428571428572,75.57
18026,62628,37,0,5058,33,4,100.0,0.0
18027,24672,14,24672,2606,13,1,14.285714285714286,65.78
18028,1712904,155,0,111448,91,64,3.225806451612903,0.0
18029,147204,22,12768,7288,22,0,5.0,75.02
18030,3060,7,3060,1141,5,2,16.666666666666668,93.16
18031,62400,5,0,25183,4,1,100.0,100.0
18032,5201592,304,5201148,643987,122,182,3.703703703703704,0.0
18033,1896,21,0,758,17,4,100.0,0.0
18034,72024,64,0,3963,53,11,100.0,0.0
18035,211524,152,211410,187219,99,53,1.5873015873015872,25.38
18036,96,26,96,7,24,2,4.166666666666667,56.25
18037,336,11,0,46,5,6,100.0,0.0
18038,648,23,648,136,18,5,6.666666666666667,34.2
18039,156,39,156,17,39,0,2.4390243902439024,21.51
18040,6266148,701,0,33529,333,368,1.4285714285714286,0.0
18041,6859200,443,0,32745,226,217,2.380952380952381,0.0
18042,70920,26,70920,336,22,4,4.545454545454546,62.83
18043,144,32,144,22,25,7,4.761904761904762,45.28
18044,528,205,0,121,116,89,100.0,0.0
18045,8416176,8045,62164,341384,4627,3418,1.0,0.0
18046,984,12,0,282,8,4,100.0,100.0
18047,6138348,376,0,97343,175,201,3.333333333333333,2.5
18048,5930256,3,1008,1976944,2,1,25.0,58.02
18049,216,8,216,27,6,2,16.666666666666668,69.74
18050,7996572,190,7996572,51792,96,94,4.0,78.35
18051,384,4,384,207,4,0,20.0,98.09
18052,1008,6,1008,750,6,0,12.5,88.82
18053,1212,66,1212,562,62,4,1.639344262295082,46.27
18054,1044,67,1044,628,53,14,2.083333333333333,30.39
18055,8295312,47,8295312,18514,29,18,6.25,79.47
18056,91608,23,0,4603,19,4,50.0,0.0
18057,252,28,252,106,10,18,33.333333333333336,99.41
18058,732,16,0,307,14,2,6.666666666666667,5.0
18059,76308,41,76308,325,37,4,2.702702702702702,38.3
18060,1140,12,1140,255,8,4,14.285714285714286,48.62
18061,1452,14,1452,987,13,1,7.142857142857143,56.4
18062,8229624,640,0,490863,374,266,1.3888888888888888,0.0
18063,85740,30,0,4509,24,6,5.555555555555555,0.0
18064,113604,25,624,4784,19,6,6.666666666666667,71.78
18065,132,5,0,48,4,1,16.666666666666668,4.76
18066,10548,7,10548,53,7,0,11.11111111111111,66.11
18067,132,0,132,0,0,0,50.0,68.89
18068,7233936,181,0,95778,84,97,9.090909090909092,0.0
18069,552,53,552,189,25,28,7.142857142857143,84.56
18070,396,6,396,76,6,0,12.5,68.91
18071,1302036,131,0,11555,62,69,4.761904761904762,4.0
18072,32976,32,0,4231,26,6,100.0,0.0
18073,6281916,331,0,53328,135,196,1.6666666666666667,0.0
18074,8419620,9497,494484,1892910,5479,4018,1.0,0.0
18075,8211516,190,0,4065423,138,52,1.0,0.0
18076,1824,13,1824,198,13,0,7.142857142857143,75.71
18077,43272,161,0,6653,95,66,100.0,0.0
18078,1164012,54,172068,95883,53,1,7.6923076923076925,98.81
18079,3852576,269,2599380,159683,153,116,2.1739130434782608,0.0
18080,626544,0,626544,0,0,0,50.0,97.0
18081,7010952,189,0,54512,95,94,3.0303030303030303,0.0
18082,7990332,580,0,196282,308,272,2.127659574468085,0.0
18083,55632,111,0,4383,77,34,100.0,0.0
18084,71736,171,0,3357,115,56,100.0,0.0
18085,6010836,188,5309844,69216,78,110,4.0,0.0
18086,8359212,353,5279202,74086,122,231,1.0526315789473684,44.8
18087,1572,254,1092,320,105,149,1.2345679012345678,46.77
18088,288,3,132,112,3,0,25.0,61.8
18089,8183976,166,5230590,889504,87,79,2.5,65.84
18090,6732,221,0,1219,119,102,100.0,0.0
18091,8227488,187,3310548,53842,95,92,3.8461538461538463,81.76
18092,4140,158,4140,457,116,42,1.0309278350515465,15.97
18093,792,120,792,64,71,49,1.5151515151515151,47.2
18094,108,0,108,0,0,0,100.0,97.0
18095,7582620,844,0,79319,426,418,1.0,0.0
18096,6213084,239,2736576,408752,121,118,3.0303030303030303,39.27
18097,840,38,132,84,36,2,2.702702702702702,67.43
18098,612,61,612,176,59,2,1.96078431372549,40.84
18099,8441856,1089,0,1414441,730,359,1.0,5.42
18100,1353852,395,1270026,526557,204,191,1.0,0.0
18101,19248,3,19248,28,3,0,25.0,98.51
18102,7910220,706,0,113620,266,440,1.5625,0.92
18103,8391888,4097,0,1975169,2517,1580,1.0,0.0
18104,8407260,1695,0,1297429,978,717,1.0,1.7
18105,1195620,145,1195620,11511,75,70,2.857142857142857,74.54
18106,61776,0,61776,0,0,0,100.0,100.0
18107,4158792,69,0,489075,38,31,50.0,0.0
18108,978420,11,15924,89866,10,1,10.0,40.45
18109,71748,70,0,6393,32,38,6.25,2.5
18110,156,2,156,36,1,1,50.0,68.4
18111,5256,32,5256,677,13,19,16.666666666666668,92.82
18112,21228,6,21228,56,4,2,25.0,59.99
18113,193044,24,193044,23371,19,5,6.666666666666667,64.4
18114,8122272,2634,0,169782,1415,1219,1.0,0.0
18115,1578060,5,753696,484584,3,2,2.857142857142857,2.46
18116,144,0,144,0,0,0,100.0,100.0
18117,228,18,228,28,16,2,6.25,49.63
18118,468,40,468,232,30,10,4.545454545454546,75.07
18119,5868,15,5868,795,12,3,7.6923076923076925,82.48
18120,7926132,2413,525408,173759,1259,1154,1.0,0.0
18121,5268804,358,5268804,21855,178,180,2.0408163265306123,61.75
18122,27480,21,27480,1687,21,0,4.545454545454546,77.4
18123,8292024,640,0,528659,315,325,1.2987012987012987,0.0
18124,7725192,497,5441532,191072,226,271,1.5151515151515151,0.0
18125,680292,4,0,170751,3,1,50.0,0.0
18126,8157240,1191,0,123811,632,559,1.0,0.0
18127,12000,92,12000,571,70,22,1.818181818181818,11.92
18128,77352,27,77352,1510,27,0,3.4482758620689653,64.5
18129,7017900,328,7017852,31816,150,178,2.4390243902439024,76.43
18130,6974628,207,0,233294,83,124,1.4492753623188406,0.0
18131,8124252,521,4062288,188736,282,239,1.3157894736842106,57.24
18132,876,10,876,164,9,1,12.5,0.0
18133,6421272,1752,0,92197,886,866,1.0,0.0
18134,108,20,108,10,20,0,4.545454545454546,36.0
18135,8443392,5303,927204,806495,3064,2239,1.0,0.0
18136,8464980,63872,6537112,4727873,40606,23266,1.0,0.0
18137,7923576,151,7923420,94020,77,74,5.555555555555555,0.0
18138,8462616,10888,5271108,2435368,6486,4402,1.0,0.0
18139,624,48,108,59,38,10,2.9411764705882355,34.97
18140,32928,141,0,1929,101,40,100.0,0.0
18141,8055144,1858,0,140575,1157,701,1.0,0.0
18142,660,31,660,288,15,16,11.11111111111111,71.44
18143,3600,135,0,1204,78,57,100.0,0.0
18144,192,20,192,61,11,9,100.0,100.0
18145,8364264,16757,903312,1082252,9680,7077,1.0,0.0
18146,86484,231,0,4018,150,81,100.0,0.0
18147,9096,0,9096,0,0,0,33.333333333333336,28.0
18148,5088,36,0,1383,29,7,100.0,0.0
18149,55812,24,0,2882,20,4,100.0,0.0
18150,28980,5,28980,192,5,0,14.285714285714286,93.75
18151,151104,24,151104,97986,22,2,4.761904761904762,72.78
18152,7818012,526,456552,280297,275,251,1.8867924528301887,5.0
18153,10932,22,10932,743,20,2,5.2631578947368425,34.64
18154,8002392,362,8002392,126694,152,210,2.5,77.79
18155,6263796,342,0,80838,189,153,2.3255813953488373,0.0
18156,8426652,622,0,4234273,424,198,1.0,46.93
18157,7714752,440,0,104226,231,209,2.1739130434782608,2.28
18158,45132,75,0,3005,53,22,100.0,0.0
18159,15204,198,0,1831,125,73,100.0,0.0
18160,14232,345,0,2915,197,148,100.0,0.0
18161,1134072,9,1134072,103957,6,3,25.0,98.76
18162,73656,12,0,14176,8,4,100.0,0.0
18163,1086324,342,0,7746,196,146,1.0,0.0
18164,8463300,5968,1043664,1381226,3932,2036,1.0,0.0
18165,4869384,21,9492,232268,21,0,5.0,66.94
18166,4740,2,4740,324,2,0,25.0,45.09
18167,80868,7,80868,392,7,0,16.666666666666668,77.05
18168,80724,76,5472,1155,76,0,1.2987012987012987,13.6
18169,3549372,49,3549372,3595,22,27,11.11111111111111,83.7
18170,670248,21,11952,32325,21,0,5.0,74.92
18171,504,12,504,232,12,0,7.6923076923076925,54.86
18172,7404,21,7404,2777,16,5,11.11111111111111,71.51
18173,107052,14,107052,7704,14,0,10.0,81.0
18174,0,5,0,0,5,0,12.5,3.0
18175,5756916,92,0,98061,41,51,9.090909090909092,0.0
18176,64500,185,0,12830,121,64,100.0,0.0
18177,8478408,12,0,5157544,12,0,50.0,99.98
18178,62496,1,62496,62376,1,0,50.0,98.0
18179,1056,61,1056,505,51,10,3.0303030303030303,28.43
18180,20196,14,20196,350,14,0,6.666666666666667,66.2
18181,252,4,252,180,4,0,20.0,74.14
18182,1416,4,1416,795,4,0,100.0,100.0
18183,8428920,5199,2163670,853960,2904,2295,1.0,0.0
18184,17856,317,0,4238,183,134,100.0,0.0
18185,14028,32,0,1056,23,9,50.0,0.0
18186,3924,5,3924,1917,5,0,14.285714285714286,90.05
18187,2349612,191,3924,15554,84,107,1.351351351351351,21.67
18188,32532,327,0,7231,187,140,100.0,0.0
18189,120,7,120,0,7,0,11.11111111111111,53.36
18190,18948,7,0,3421,4,3,100.0,100.0
18191,5956980,263,3058992,321451,169,94,1.7857142857142858,43.41
18192,9384,5,9384,892,4,1,20.0,36.56
18193,6068796,195,0,313335,90,105,3.703703703703704,0.0
18194,46128,5,46128,192,5,0,16.666666666666668,97.5
18195,220392,9,220392,392,9,0,9.090909090909092,84.11
18196,2568,5,2568,705,4,1,6.666666666666667,46.88
18197,6557976,56,0,290292,36,20,8.333333333333334,0.0
18198,8211660,47,335856,259868,25,22,9.090909090909092,0.0
18199,6645924,383,0,390598,187,196,2.0,1.98
18200,2594040,45,2594040,9678,26,19,7.142857142857143,73.49
18201,5354388,42,5354388,1058,36,6,3.0303030303030303,9.75
18202,992112,0,992112,0,0,0,100.0,100.0
18203,2484,84,2484,646,43,41,4.3478260869565215,52.77
18204,610584,2,610584,18,1,1,100.0,100.0
18205,6420,65,6420,1388,39,26,4.166666666666667,61.85
18206,58584,81,0,7715,64,17,100.0,0.0
18207,8448900,5820,1704612,1716449,2565,3255,1.0,0.0
18208,8353596,318,330840,303502,251,67,1.0,0.0
18209,312,0,312,0,0,0,100.0,100.0
18210,5220,4,5220,2835,4,0,20.0,73.62
18211,1428,81,1008,703,56,25,2.4390243902439024,0.0
18212,8208768,611,0,427917,337,274,1.5873015873015872,7.03
18213,59820,99,59820,8688,83,16,1.5873015873015872,4.25
18214,1872,12,1872,608,8,4,20.0,5.0
18215,636,34,636,325,24,10,4.761904761904762,83.23
18216,1944,9,1944,174,5,4,33.333333333333336,78.12
18217,516,8,516,448,3,5,50.0,99.61
18218,2652420,32,2652420,122084,18,14,12.5,47.13
18219,264,5,264,9,5,0,16.666666666666668,70.86
18220,288,4,288,78,2,2,50.0,55.81
18221,60,11,0,24,5,6,50.0,0.0
18222,5737872,485,0,136371,268,217,1.3888888888888888,6.06
18223,8265456,1079,0,144625,563,516,1.0,0.0
18224,84,45,84,17,36,9,2.9411764705882355,29.82
18225,8078568,8,8078568,418,6,2,14.285714285714286,88.47
18226,27216,11,0,2816,8,3,100.0,100.0
18227,3060,44,3060,506,44,0,2.631578947368421,53.34
18228,252,7,252,97,7,0,10.0,40.61
18229,514740,21,11046,27693,21,0,5.555555555555555,27.6
18230,514860,5,62796,104397,5,0,20.0,97.45
18231,8529864,8978,1999500,1477579,5293,3685,1.0,0.0
18232,2328,16,336,275,10,6,12.5,88.92
18233,5688,88,0,508,58,30,4.0,0.6
18234,7662600,2006,0,161083,1132,874,1.0,0.0
18235,7369104,126,0,123977,78,48,4.3478260869565215,4.0
18236,3936,6,3936,1504,6,0,9.090909090909092,9.6
18237,1008,6,1008,862,2,4,50.0,99.98
18238,465384,0,465384,0,0,0,100.0,100.0
18239,8264244,918,764464,355949,388,530,1.6129032258064515,0.0
18240,8484084,44086,2908740,2520271,26704,17382,1.0,0.36
18241,3288,19,3288,1569,13,6,7.6923076923076925,96.91
18242,5800332,131,0,50671,58,73,6.666666666666667,0.0
18243,288,2,288,18,2,0,25.0,62.37
18244,8327484,1377,3954564,78354,551,826,1.2048192771084338,4.96
18245,144,6,120,56,6,0,14.285714285714286,49.32
18246,518988,82,518988,181,60,22,1.96078431372549,39.55
18247,1587708,216,0,24051,122,94,2.5641025641025643,0.0
18248,7840440,830,0,116010,463,367,1.075268817204301,0.0
18249,8495832,523,5148472,2882315,301,222,1.0,0.47
18250,8416704,805,4058844,1298167,486,319,1.0,0.0
18251,8414508,648,0,89028,339,309,1.5625,0.0
18252,2460132,373,2460132,9795,156,217,1.96078431372549,0.0
18253,68388,69,68388,253,51,18,2.5641025641025643,63.44
18254,7186260,180,0,356782,88,92,3.4482758620689653,0.0
18255,6480,48,6480,542,40,8,2.857142857142857,46.17
18256,1088100,326,0,12538,207,119,33.333333333333336,0.0
18257,24336,321,0,5845,209,112,100.0,0.0
18258,5484,19,5484,405,19,0,5.2631578947368425,76.07
18259,86688,67,0,5599,49,18,100.0,0.0
18260,88692,114,0,5551,80,34,100.0,0.0
18261,2004,19,2004,356,14,5,7.6923076923076925,40.06
18262,6368196,117,0,281371,50,67,6.25,0.0
18263,6135864,117,0,305318,43,74,11.11111111111111,0.0
18264,4013076,116,0,51483,49,67,7.6923076923076925,0.0
18265,2748,7,0,1719,5,2,100.0,0.0
18266,69144,79,69144,596,58,21,100.0,0.0
18267,8449956,703,0,1343116,387,316,1.36986301369863,0.0
18268,5214480,211,0,41833,122,89,2.3255813953488373,0.0
18269,132,14,132,8,14,0,6.25,41.69
18270,168,21,168,25,19,2,5.2631578947368425,48.06
18271,2148,13,2148,668,8,5,33.333333333333336,0.0
18272,4739172,275,0,103288,146,129,2.702702702702702,1.86
18273,180,53,180,44,31,22,4.545454545454546,55.91
18274,204,0,204,0,0,0,50.0,85.75
18275,456,2,456,132,2,0,33.333333333333336,96.0
18276,4741668,108,0,82654,48,60,9.090909090909092,5.8
18277,336,2,336,162,1,1,50.0,58.82
18278,2042280,222,0,57680,106,116,3.125,1.97
18279,5844276,118,0,98200,53,65,4.545454545454546,0.0
18280,4072728,291,0,22973,148,143,3.0303030303030303,0.0
18281,264,94,120,38,58,36,2.380952380952381,33.15
18282,1044,3,1044,708,2,1,100.0,0.0
18283,59784,109,0,1903,72,37,100.0,0.0
18284,7823652,288,7823652,42062,152,136,5.0,89.46
18285,53184,0,53184,0,0,0,100.0,100.0
18286,348,32,348,79,28,4,3.571428571428572,60.31
18287,3264,30,3264,9,29,1,3.333333333333333,31.23
18288,66144,51,66144,111,28,23,5.2631578947368425,47.6
18289,22824,151,0,11445,108,43,100.0,0.0
18290,240,0,240,0,0,0,33.333333333333336,87.3
18291,2904072,60,2904072,21705,35,25,4.3478260869565215,0.0
18292,7923108,858,6192438,68444,485,373,1.020408163265306,54.32
18293,23748,267,0,4316,178,89,100.0,0.0
18294,31716,185,0,533,94,91,2.2222222222222223,0.0
18295,46284,159,46284,4778,91,68,2.5,79.44
18296,8367504,207,0,143481,112,95,3.571428571428572,7.5
18297,216,9,216,85,7,2,14.285714285714286,73.0
18298,5989236,90,0,118770,51,39,4.0,0.0
18299,83580,93,83580,1140,55,38,25.0,0.0
18300,1704,14,0,863,11,3,100.0,100.0
18301,8496504,5270,1851681,1594356,3052,2218,1.0,0.0
18302,3408,14,3408,954,9,5,12.5,46.79
18303,6556236,599,0,111505,269,330,2.702702702702702,0.0
18304,73452,4,73452,11346,2,2,33.333333333333336,98.14
18305,387096,4,387096,102903,2,2,33.333333333333336,99.35
18306,444,5,444,110,4,1,25.0,1.79
18307,7958148,2061,0,315045,1126,935,1.0,0.0
18308,7071540,172,7071540,81801,84,88,3.8461538461538463,78.95
18309,7229880,437,0,1061577,314,123,1.0,0.0
18310,7954452,1472,3977430,174673,842,630,1.0,0.46
18311,1212,74,348,143,36,38,7.142857142857143,86.27
18312,7008,63,3984,318,49,14,2.3255813953488373,18.23
18313,5257788,51,4563720,116157,27,24,6.666666666666667,58.11
18314,8001144,45,660,178095,26,19,7.142857142857143,2.63
18315,8457024,566,2288996,456437,268,298,1.694915254237288,3.1
18316,144,49,144,29,43,6,2.380952380952381,23.28
18317,876,38,876,294,18,20,14.285714285714286,0.0
18318,396,20,396,150,16,4,7.142857142857143,57.56
18319,5860512,100,0,62788,49,51,16.666666666666668,0.0
18320,1141392,24,0,74845,10,14,4.166666666666667,41.09
18321,540,59,540,129,55,4,1.851851851851852,35.48
18322,5166168,66,5166009,70993,32,34,5.2631578947368425,1.96
18323,588,1,0,588,1,0,33.333333333333336,0.0
18324,37368,1,37368,9120,1,0,33.333333333333336,59.66
18325,2843868,302,2843868,19533,142,160,2.702702702702702,83.71
18326,4007916,82,4007916,699,70,12,1.5151515151515151,15.0
18327,108,2,108,0,2,0,25.0,71.0
18328,660,4,660,570,2,2,25.0,68.04
18329,156,5,156,62,3,2,33.333333333333336,58.19
18330,96,11,96,13,10,1,1.7241379310344829,59.89
18331,101016,23,0,4974,17,6,100.0,100.0
18332,1176,8,1176,136,7,1,11.11111111111111,63.7
18333,457800,4,457800,1926,2,2,33.333333333333336,99.01
18334,120,0,120,0,0,0,50.0,72.25
18335,336,23,324,182,19,4,6.666666666666667,37.37
18336,156,17,156,7,17,0,5.0,54.35
18337,53448,21,53448,25985,21,0,5.2631578947368425,96.05
18338,588,1,588,0,1,0,50.0,98.56
18339,408,10,408,7,10,0,9.090909090909092,80.0
18340,6090060,120,6090060,42935,54,66,11.11111111111111,93.97
18341,220944,98,220944,84391,85,13,1.36986301369863,3.84
18342,8534364,3659,13860,238118,2087,1572,1.0,0.0
18343,8088,8,8088,61,8,0,10.0,63.25
18344,7005936,25,324,1120967,22,3,4.761904761904762,37.0
18345,420,40,420,138,23,17,14.285714285714286,89.37
18346,7628712,1031,0,763944,654,377,1.0,0.0
18347,1056,72,804,752,59,13,2.5641025641025643,47.44
18348,148596,2,148596,148506,1,1,100.0,100.0
18349,6120,0,6120,0,0,0,100.0,100.0
18350,1248,1,1248,96,1,0,50.0,99.69
18351,1091088,121,0,68680,55,66,6.25,0.0
18352,1188,50,1188,483,50,0,1.96078431372549,77.85
18353,7433028,909,0,32348,469,440,1.0869565217391304,0.0
18354,37668,66,0,2145,37,29,12.5,0.0
18355,2520,66,2520,224,36,30,4.545454545454546,75.06
18356,49980,20,49980,638,18,2,6.666666666666667,60.34
18357,7768248,246,7768248,183637,131,115,3.8461538461538463,72.73
18358,132,0,132,0,0,0,100.0,100.0
18359,228,18,228,28,16,2,6.25,40.33
18360,552,84,516,181,68,16,1.7857142857142858,73.26
18361,276,1,276,60,1,0,50.0,98.87
18362,4980,48,4980,1244,28,20,5.0,67.2
18363,2712,3,0,956,3,0,25.0,0.0
18364,840,74,840,187,74,0,1.5151515151515151,38.41
18365,396,2,396,18,2,0,25.0,60.89
18366,10212,18,10212,546,18,0,5.2631578947368425,82.5
18367,1056,21,656,189,13,8,100.0,100.0
18368,7825308,327,7825308,137717,162,165,1.6129032258064515,67.65
18369,7390668,454,0,210835,304,150,2.702702702702702,0.0
18370,2597976,136,2597976,30424,67,69,4.761904761904762,82.2
18371,259968,24,0,20961,16,8,8.333333333333334,5.0
18372,8387496,4254,1866768,895158,2425,1829,1.0,0.0
18373,4392,23,4392,1435,23,0,5.555555555555555,21.06
18374,216,5,216,0,5,0,16.666666666666668,63.13
18375,1344,5,1344,804,3,2,50.0,98.16
18376,6178140,144,204,161298,80,64,2.857142857142857,5.51
18377,5888988,342,0,72673,176,166,2.272727272727273,5.0
18378,3756,8,3756,747,5,3,20.0,73.81
18379,252,0,252,0,0,0,50.0,64.0
18380,302460,29,504,10681,18,11,6.666666666666667,64.4
18381,168,54,168,56,46,8,2.380952380952381,23.4
18382,1992,63,1992,1039,31,32,5.882352941176471,33.56
18383,8557080,7470,1091400,1792294,4416,3054,1.0,0.0
18384,8375988,532,8375988,65551,314,218,1.1904761904761905,69.36
18385,392976,17,392976,1794,17,0,6.666666666666667,17.59
18386,1164,160,1164,372,78,82,2.5641025641025643,74.51
18387,8574720,24324,4630106,3593397,14716,9608,1.0,0.0
18388,1642032,47,1642032,26,45,2,2.1739130434782608,20.92
18389,8354244,108,2711952,199558,59,49,3.333333333333333,78.02
18390,4896,1,4896,4680,1,0,50.0,98.0
18391,5643240,245,2587680,102154,120,125,2.702702702702702,44.69
18392,23268,9,0,3641,6,3,100.0,0.0
18393,8184492,287,7173300,177450,145,142,3.8461538461538463,0.0
18394,8592912,12638,2020098,2915238,7721,4917,1.0,0.0
18395,2472,1,2472,660,1,0,50.0,99.97
18396,7709328,591,0,102864,336,255,1.351351351351351,0.64
18397,636,68,324,50,48,20,2.5,37.31
18398,1728,34,1728,416,30,4,3.333333333333333,0.0
18399,31872,9,31872,62,9,0,9.090909090909092,70.17
18400,324,53,216,100,43,10,2.5641025641025643,31.62
18401,3924,84,3240,154,79,5,1.351351351351351,6.16
18402,15684,41,15684,14481,37,4,3.0303030303030303,51.52
18403,456,14,456,139,8,6,16.666666666666668,93.38
18404,8598216,30544,552024,2042782,18941,11603,1.0,0.0
18405,528,13,528,154,11,2,9.090909090909092,44.18
18406,213696,18,0,53506,14,4,6.25,20.0
18407,8538804,2481,1115112,1330990,1280,1201,1.0,0.0
18408,79104,303,0,4813,193,110,100.0,0.0
18409,8552700,758,0,461787,409,349,1.2820512820512822,1.17
18410,696,39,252,72,28,11,4.545454545454546,0.0
18411,828,22,564,199,13,9,8.333333333333334,42.71
18412,8247684,61,168,135251,39,22,3.4482758620689653,55.63
18413,1020,30,1020,125,30,0,2.9411764705882355,45.65
18414,18084,9,18084,2968,8,1,25.0,11.63
18415,132,0,132,0,0,0,50.0,60.84
18416,264,2,264,12,2,0,25.0,56.21
18417,63744,6,63744,20092,2,4,50.0,95.41
18418,62340,158,0,7897,101,57,100.0,0.0
18419,8201436,61,8201436,715078,29,32,6.666666666666667,81.8
18420,63072,19,0,3778,14,5,100.0,100.0
18421,8784,175,0,1584,121,54,100.0,0.0
18422,1044,7,1044,72,4,3,33.333333333333336,59.03
18423,528,4,528,54,3,1,25.0,55.58
18424,8580492,837,0,1626607,462,375,1.162790697674419,0.0
18425,2964,24,0,1198,20,4,100.0,0.0
18426,1332,4,1332,189,2,2,50.0,56.43
18427,8255316,4351,3097284,296522,1945,2406,1.0,0.0
18428,66300,243,0,4686,162,81,50.0,0.0
18429,8480748,52,0,412290,45,7,20.0,0.0
18430,165636,19,165636,1017,17,2,7.142857142857143,70.85
18431,305148,20,4368,15562,19,1,5.882352941176471,70.47
18432,252,1,252,24,1,0,50.0,0.0
18433,6524772,27,0,269003,22,5,33.333333333333336,0.0
18434,257772,44,257772,8356,42,2,2.4390243902439024,22.52
18435,9456,21,9456,1698,15,6,5.882352941176471,35.29
18436,2016,36,2016,235,22,14,5.882352941176471,88.74
18437,10740,25,10740,417,24,1,5.0,70.6
18438,58020,7,58020,31109,7,0,16.666666666666668,81.07
18439,360,2,240,180,1,1,12.5,67.5
18440,4368,116,0,341,54,62,4.761904761904762,4.35
18441,228,39,180,140,27,12,4.166666666666667,49.04
18442,72,48,60,17,40,8,2.9411764705882355,34.33
18443,8573856,1220,0,380084,658,562,1.0,0.0
18444,1916676,27,1916568,1296735,22,5,5.2631578947368425,64.32
18445,178608,15,178608,1196,15,0,11.11111111111111,61.5
18446,4233180,153,0,167082,93,60,100.0,0.0
18447,7672308,742,0,136159,423,319,1.1764705882352942,0.0
18448,93384,61,93384,4661,53,8,2.5641025641025643,0.0
18449,3420,18,3420,854,14,4,6.25,42.14
18450,11988,133,0,1279,87,46,33.333333333333336,0.0
18451,1452,29,1452,921,19,10,11.11111111111111,71.15
18452,71760,17,71760,28,9,8,33.333333333333336,68.49
18453,6230736,99,0,63173,58,41,4.166666666666667,0.0
18454,2073468,36,354312,114510,32,4,5.882352941176471,54.58
18455,156,25,156,71,17,8,10.0,97.39
18456,7947732,884,0,273435,411,473,1.0,0.49
18457,4397400,500,0,16877,281,219,2.272727272727273,0.0
18458,12864,238,0,3517,145,93,100.0,0.0
18459,86076,78,0,3449,64,14,100.0,0.0
18460,9504,8,9504,838,8,0,25.0,43.46
18461,335328,39,0,17251,32,7,100.0,100.0
18462,8552496,259,0,507800,131,128,3.703703703703704,0.0
18463,1200,51,1200,936,37,14,3.125,53.72
18464,3708,7,3708,584,6,1,20.0,84.1
18465,8371320,775,0,122587,422,353,1.25,0.0
18466,120,17,120,72,7,10,25.0,78.41
18467,2460,21,2460,98,19,2,5.0,70.26
18468,780,5,780,280,4,1,20.0,58.06
18469,496296,145,1140,4146,95,50,1.408450704225352,27.68
18470,686772,47,686772,10,41,6,2.5,20.89
18471,83556,146,83556,127,87,59,1.3157894736842106,5.93
18472,81228,184,81228,17299,117,67,7.142857142857143,0.0
18473,996,21,996,212,21,0,4.761904761904762,63.79
18474,223692,21,223692,36,21,0,4.545454545454546,69.22
18475,4224,23,4224,722,19,4,9.090909090909092,68.27
18476,1848,2,1848,1530,2,0,25.0,99.0
18477,36,3,0,16,2,1,20.0,1.0
18478,336,31,336,142,29,2,3.4482758620689653,46.24
18479,5145612,275,0,193714,114,161,1.4492753623188406,0.0
18480,108,2,108,30,1,1,25.0,54.66
18481,576,118,576,179,84,34,1.5873015873015872,49.63
18482,1296,142,0,634,105,37,2.0408163265306123,0.0
18483,264,65,204,94,57,8,1.818181818181818,38.63
18484,384,0,384,0,0,0,50.0,65.61
18485,12660,5,12660,103,2,3,20.0,89.6
18486,3916332,36,0,199471,15,21,4.545454545454546,0.24
18487,7650852,6,480,1275188,5,1,25.0,98.08
18488,4008,168,4008,2191,109,59,1.25,61.84
18489,4728,55,4728,30,41,14,2.702702702702702,32.21
18490,2908824,145,2908824,3630,68,77,5.0,93.52
18491,1356,113,1356,604,71,42,2.380952380952381,59.44
18492,84,1,84,0,1,0,33.333333333333336,55.62
18493,4078272,184,0,104064,97,87,2.9411764705882355,0.0
18494,7686984,192,3146328,102230,96,96,2.702702702702702,78.89
18495,91380,159,91380,609,111,48,1.0,7.58
18496,41508,30,41508,528,26,4,5.555555555555555,45.94
18497,4270476,28,4270476,74119,14,14,12.5,72.79
18498,884292,62,884292,3100,54,8,2.0408163265306123,79.58
18499,372,15,372,252,7,8,20.0,97.24
18500,44532,97,0,2203,70,27,100.0,0.0
18501,13068,0,13068,0,0,0,50.0,61.23
18502,5950920,448,0,97740,231,217,1.851851851851852,5.0
18503,3537240,3,47904,1179584,3,0,20.0,47.23
18504,612,28,612,300,22,6,4.761904761904762,75.59
18505,5336928,636,3788406,198459,282,354,1.25,78.53
18506,37104,103,37104,3652,86,17,1.5151515151515151,1.75
18507,2495556,263,2495556,6366,124,139,3.0303030303030303,76.97
18508,7550976,714,0,180938,402,312,1.2048192771084338,0.0
18509,864,90,864,334,60,30,1.96078431372549,41.57
18510,468,2,468,54,2,0,25.0,90.5
18511,276,29,264,41,22,7,5.555555555555555,42.48
18512,5684628,289,0,25037,143,146,4.545454545454546,0.0
18513,276,38,240,118,31,7,3.703703703703704,71.2
18514,8219880,472,0,109487,242,230,2.0,0.0
18515,3582612,545,0,16985,307,238,1.2658227848101269,0.0
18516,384,14,384,68,14,0,6.25,87.02
18517,264,18,264,103,18,0,5.0,72.64
18518,1980,56,1980,200,47,9,2.7777777777777777,27.18
18519,3266400,120,0,28152,64,56,5.555555555555555,0.0
18520,108,6,108,38,4,2,25.0,61.08
18521,768,3,768,132,2,1,25.0,53.5
18522,768,8,768,78,5,3,20.0,78.58
18523,5746128,244,2677008,51952,126,118,2.857142857142857,72.39
18524,8648736,4921,873192,1709084,2608,2313,1.0,0.0
18525,7965036,753,2409690,1550105,404,349,1.0,0.0
18526,8649792,4806,1164636,1899466,2590,2216,1.0,0.0
18527,232932,54,232932,7410,52,2,1.8867924528301887,22.45
18528,2964,54,2964,1062,54,0,1.818181818181818,42.38
18529,4740,0,4740,0,0,0,100.0,95.0
18530,6924,8,6924,61,8,0,11.11111111111111,85.9
18531,73104,6,73104,15874,4,2,20.0,66.16
18532,7844232,423,5148912,49802,205,218,1.7543859649122806,63.09
18533,7846428,426,7846428,259897,179,247,2.0,68.09
18534,62868,0,62868,0,0,0,50.0,88.0
18535,29592,77,660,590,34,43,6.666666666666667,75.38
18536,8306376,254,0,456031,142,112,2.2222222222222223,0.0
18537,792,11,792,132,10,1,10.0,60.27
18538,7334040,413,1809732,808533,189,224,2.631578947368421,2.91
18539,372,3,372,272,2,1,33.333333333333336,78.72
18540,6782256,409,0,170246,186,223,1.098901098901099,0.0
18541,14460,4,14460,336,2,2,33.333333333333336,99.5
18542,8659116,15097,5324928,2866579,5797,9300,1.0,0.0
18543,7716,94,7716,1808,54,40,3.225806451612903,51.28
18544,7754916,333,7754916,188855,174,159,3.225806451612903,79.71
18545,3360,97,3360,2587,59,38,2.702702702702702,66.11
18546,13356,10,108,1347,9,1,9.090909090909092,54.85
18547,921312,8,12144,115878,8,0,12.5,37.98
18548,9828,0,9828,0,0,0,100.0,100.0
18549,4176,19,0,516,10,9,50.0,0.0
18550,228,6,228,40,6,0,11.11111111111111,55.04
18551,7185456,12,84924,599805,12,0,10.0,17.43
18552,453324,16,453324,8066,9,7,33.333333333333336,0.0
18553,204,14,204,126,9,5,16.666666666666668,83.22
18554,2420496,460,2420496,61378,235,225,1.7857142857142858,76.56
18555,43464,1,43464,2244,1,0,50.0,98.0
18556,7725228,510,0,98714,289,221,1.694915254237288,4.75
18557,420,339,420,277,137,202,1.020408163265306,25.89
18558,364572,48,364572,235,38,10,2.857142857142857,61.15
18559,2724,196,2724,174,82,114,1.2820512820512822,8.82
18560,4692,4,192,1200,3,1,50.0,99.56
18561,900,15,900,692,15,0,5.882352941176471,88.21
18562,33768,19,33768,3648,18,1,5.555555555555555,69.21
18563,29784,10,0,6001,7,3,14.285714285714286,4.35
18564,96,24,96,23,18,6,5.882352941176471,42.43
18565,6074508,474,0,176311,309,165,1.2345679012345678,0.0
18566,8581356,2302,2418264,348789,1328,974,1.0,1.07
18567,5972244,87,0,210530,36,51,14.285714285714286,0.0
18568,468,6,468,288,6,0,12.5,88.0
18569,1882656,294,6996,8831,149,145,1.4492753623188406,34.65
18570,7388196,515,0,125176,271,244,2.0408163265306123,0.0
18571,8663604,836,384816,2993208,513,323,1.0,0.0
18572,58080,77,0,2884,31,46,16.666666666666668,0.0
18573,1566852,99,0,23427,76,23,3.225806451612903,0.0
18574,252,44,240,109,33,11,3.0303030303030303,55.95
18575,8339244,2231,1702164,545303,1196,1035,1.0,14.44
18576,504,36,504,96,26,10,5.555555555555555,45.45
18577,7312488,3445,0,464117,1904,1541,1.0,0.41
18578,7334400,965,9372,116494,438,527,1.0,0.0
18579,7133400,614,0,61083,337,277,1.3888888888888888,4.0
18580,447984,30,447984,10027,28,2,3.0303030303030303,75.02
18581,849204,15,849204,1846,7,8,20.0,91.31
18582,5714640,162,2649132,48039,78,84,5.555555555555555,0.0
18583,5763000,128,0,212920,70,58,3.571428571428572,0.0
18584,8657724,17942,0,1513783,10725,7217,1.0,0.0
18585,2257764,44,0,107878,18,26,12.5,0.0
18586,5979408,125,0,199747,58,67,7.6923076923076925,0.0
18587,288,45,288,58,33,12,6.666666666666667,34.93
18588,4695552,324,4300476,24084,181,143,1.7241379310344829,74.21
18589,7471044,285,0,110503,144,141,2.631578947368421,0.0
18590,23820,135,456,13033,99,36,100.0,0.0
18591,1432608,80,15828,33329,65,15,3.0303030303030303,50.73
18592,5982504,670,0,28908,384,286,1.5384615384615383,0.0
18593,960,14,660,103,9,5,14.285714285714286,54.69
18594,6226812,368,0,111662,193,175,2.083333333333333,0.0
18595,911604,69,10116,14180,49,20,2.5,42.11
18596,204,4,204,15,4,0,16.666666666666668,70.55
18597,66276,24,66276,4391,20,4,7.6923076923076925,92.43
18598,5812248,273,0,271565,103,170,2.3255813953488373,0.0
18599,1390812,67,1390812,15738,38,29,7.6923076923076925,0.4
18600,10680,6,0,1898,3,3,50.0,0.0
18601,8505144,266,0,391566,133,133,3.703703703703704,0.0
18602,192,25,192,14,24,1,4.0,39.3
18603,2594124,514,2594124,60347,211,303,1.2987012987012987,65.54
18604,1188,4,1188,225,3,1,33.333333333333336,98.93
18605,63876,11,63876,886,10,1,14.285714285714286,73.8
18606,1704,34,660,295,21,13,11.11111111111111,90.83
18607,48,7,48,25,4,3,20.0,0.73
18608,6485772,19,1752,341677,10,9,50.0,98.33
18609,2150532,507,0,19063,280,227,1.5151515151515151,0.0
18610,204,7,204,42,6,1,16.666666666666668,47.66
18611,8665068,7387,1822860,2574325,4160,3227,1.0,0.98
18612,6972,10,6972,591,9,1,11.11111111111111,98.51
18613,55344,24,55344,1332,23,1,7.6923076923076925,65.04
18614,41352,195,0,3927,143,52,33.333333333333336,0.0
18615,8646144,21446,1157544,1216763,11743,9703,1.0,0.0
18616,252,4,252,132,3,1,25.0,59.85
18617,64548,43,64548,111,39,4,2.4390243902439024,15.47
18618,8696496,1200,20628,420723,649,551,1.0,0.0
18619,78096,54,78096,3331,52,2,1.8867924528301887,19.36
18620,15444,25,15444,417,25,0,4.3478260869565215,68.87
18621,5508,8,5508,406,6,2,16.666666666666668,45.32
18622,8685396,1000,0,1043678,552,448,1.0,0.72
18623,78132,46,78132,1348,41,5,2.631578947368421,27.56
18624,1188,185,1188,183,126,59,1.0309278350515465,6.33
18625,4822896,203,0,257108,102,101,4.761904761904762,0.0
18626,552,15,540,43,13,2,7.142857142857143,44.91
18627,2544,98,0,1020,63,35,100.0,0.0
18628,4661940,37,11352,378668,34,3,3.225806451612903,65.17
18629,6006216,112,0,107608,48,64,6.666666666666667,5.8
18630,8582088,560,0,80328,301,259,1.7857142857142858,0.0
18631,7571700,132,0,250064,65,67,5.2631578947368425,4.76
18632,6600,0,6600,0,0,0,50.0,95.0
18633,8130072,2975,0,90342,1697,1278,1.0,2.9
18634,6069000,149,0,79587,69,80,7.142857142857143,0.0
18635,8704332,8723,296880,3169451,5934,2789,1.0,0.05
18636,96,38,96,28,30,8,3.703703703703704,36.67
18637,7689444,358,0,35074,189,169,2.0408163265306123,0.0
18638,8095188,287,0,50454,156,131,2.702702702702702,3.9
18639,6011196,105,0,82627,43,62,8.333333333333334,0.0
18640,8122680,1781,3655956,1770287,923,858,1.0,0.0
18641,18156,149,18156,3583,100,49,6.666666666666667,0.0
18642,1776,38,1224,828,30,8,3.703703703703704,90.91
18643,72,41,60,11,33,8,3.333333333333333,38.04
18644,8042580,937,0,836307,527,410,1.492537313432836,2.35
18645,6828,3,6828,6620,3,0,20.0,97.74
18646,288,50,288,182,38,12,3.4482758620689653,52.17
18647,8240592,1719,0,292251,955,764,1.0,0.0
18648,180,10,180,66,7,3,16.666666666666668,56.24
18649,408,40,408,227,28,12,5.2631578947368425,74.54
18650,35580,3,35580,144,3,0,20.0,55.53
18651,756,16,756,101,16,0,5.882352941176471,85.65
18652,7186176,233,0,93590,115,118,4.166666666666667,0.0
18653,1200,83,1200,418,54,29,100.0,99.94
18654,1056348,828,579712,368845,791,37,2.5,0.08
18655,8644644,1626,0,3874926,868,758,1.0,1.45
18656,2864676,1039,2864676,17857,598,441,1.0,0.0
18657,3473520,8,3473520,37,3,5,50.0,99.89
18658,8159592,6295,2599860,2145296,3777,2518,1.0,0.0
18659,2253912,4,97272,565581,3,1,20.0,95.53
18660,90036,133,0,1306,55,78,12.5,0.0
18661,7593216,216,7593216,100351,125,91,3.4482758620689653,81.28
18662,172572,11,0,17130,8,3,100.0,100.0
18663,286692,112,0,58494,70,42,3.4482758620689653,0.0
18664,17244,168,17244,192,108,60,1.0638297872340423,6.32
18665,69588,204,0,6248,142,62,100.0,0.0
18666,156,54,156,26,32,22,4.3478260869565215,47.88
18667,1860,17,1860,142,17,0,5.555555555555555,68.68
18668,132,59,108,29,37,22,3.703703703703704,44.35
18669,996,17,996,238,17,0,5.555555555555555,71.98
18670,7598592,231,0,117365,106,125,7.6923076923076925,0.0
18671,132,42,132,31,34,8,3.125,36.73
18672,3924,121,0,1873,73,48,100.0,0.0
18673,5532,206,5532,1204,158,48,1.0,11.73
18674,504,3,504,364,3,0,20.0,95.9
18675,2328,11,2328,699,7,4,20.0,74.88
18676,30888,50,0,898,39,11,50.0,0.0
18677,110052,57,0,10294,47,10,100.0,0.0
18678,1360440,21,1360440,997,15,6,7.142857142857143,48.2
18679,264,1,264,0,1,0,50.0,97.45
18680,7596468,318,0,183186,170,148,2.631578947368421,0.0
18681,6033828,374,0,1282177,191,183,3.225806451612903,0.0
18682,324,12,276,146,7,5,20.0,55.01
18683,8206536,398,0,688224,225,173,2.5,0.0
18684,8698128,3465,0,765369,1931,1534,1.0,0.0
18685,1452,13,1452,878,13,0,6.666666666666667,57.6
18686,2028,7,2028,396,7,0,11.11111111111111,81.09
18687,6034872,333,0,47133,185,148,1.9230769230769231,0.0
18688,1656,4,1656,1257,2,2,33.333333333333336,96.94
18689,180,10,180,81,7,3,3.703703703703704,48.71
18690,2364,17,2364,36,16,1,5.882352941176471,50.5
18691,9120,178,9120,223,108,70,1.0638297872340423,14.07
18692,1183752,25,2172,284280,16,9,7.142857142857143,42.03
18693,468,21,468,256,11,10,11.11111111111111,29.87
18694,3016164,269,3016164,718,135,134,2.857142857142857,81.98
18695,8571876,1012,359730,329622,604,408,1.0,0.0
18696,3279996,38,3279996,265125,26,12,6.666666666666667,71.65
18697,36,2,36,12,2,0,33.333333333333336,80.84
18698,2584920,487,2584920,23719,261,226,1.9230769230769231,69.96
18699,182424,118,0,19800,86,32,100.0,0.0
18700,2088,7,2088,1724,7,0,11.11111111111111,92.3
18701,41100,71,41100,282,53,18,2.3255813953488373,54.95
18702,1104,11,1104,596,9,2,10.0,85.61
18703,6636,187,0,841,139,48,100.0,0.0
18704,2874528,290,2501532,13125,132,158,2.0408163265306123,71.68
18705,2467380,24,2467380,451,17,7,8.333333333333334,33.96
18706,672,47,672,117,35,12,3.571428571428572,74.11
18707,3019560,74,3019560,423,34,40,7.6923076923076925,85.13
18708,59256,122,59256,3140,89,33,1.9230769230769231,2.56
18709,324,17,324,102,14,3,7.6923076923076925,18.27
18710,396,8,396,145,4,4,25.0,67.19
18711,44916,3,44916,148,2,1,33.333333333333336,59.5
18712,7915368,1080,948,118336,628,452,1.0,0.0
18713,336,18,336,149,11,7,14.285714285714286,74.4
18714,756,32,756,129,17,15,9.090909090909092,71.18
18715,7103388,293,0,63390,152,141,2.380952380952381,0.0
18716,5933016,459,1572,58706,279,180,1.0869565217391304,4.05
18717,7786896,166,7786896,33896,90,76,3.571428571428572,78.33
18718,49632,33,49632,655,31,2,3.125,6.96
18719,108,38,108,31,30,8,3.571428571428572,36.8
18720,490860,15,36,32733,14,1,8.333333333333334,60.29
18721,3552,90,0,1014,82,8,50.0,0.0
18722,1356,4,1356,432,4,0,20.0,93.06
18723,2496,54,0,799,36,18,100.0,0.0
18724,196668,45,0,9227,33,12,33.333333333333336,0.0
18725,10116,35,7092,699,19,16,6.25,65.09
18726,600,46,600,127,42,4,2.4390243902439024,31.4
18727,8587932,2072,0,101557,888,1184,1.0,0.0
18728,8487648,225,8487648,44138,143,82,3.0303030303030303,81.89
18729,139992,10,0,20838,6,4,50.0,0.0
18730,2006820,161,0,14713,75,86,4.761904761904762,0.0
18731,8643360,8452,834648,612703,4650,3802,1.0,0.45
18732,534600,6,534600,102976,4,2,16.666666666666668,38.32
18733,3632880,77,3632868,47295,60,17,1.8867924528301887,0.0
18734,288,14,288,31,12,2,8.333333333333334,59.49
18735,4587156,254,0,37557,130,124,3.571428571428572,5.8
18736,8522364,2627,0,191512,1421,1206,1.0,0.0
18737,54792,150,54792,106,115,35,1.0,34.1
18738,95748,38,95748,829,38,0,2.5641025641025643,54.21
18739,456,31,456,199,23,8,5.0,70.17
18740,2710404,478,2600508,17589,201,277,1.7543859649122806,0.0
18741,2988,2,2988,96,1,1,50.0,87.61
18742,4201980,1135,2722476,177360,627,508,1.3333333333333333,0.0
18743,72,14,72,14,13,1,7.6923076923076925,40.52
18744,82080,43,1356,3037,40,3,2.5,0.0
18745,1861032,558,37704,21988,269,289,2.272727272727273,0.0
18746,2676,159,0,759,93,66,100.0,0.0
18747,7787868,264,7787856,54969,153,111,2.083333333333333,0.0
18748,1585404,119,1503846,565465,64,55,14.285714285714286,0.0
18749,243576,12,0,82343,7,5,20.0,2.0
18750,17916,64,17916,600,60,4,1.639344262295082,36.59
18751,4039680,186,0,46205,86,100,5.882352941176471,0.0
18752,3264,10,3264,4,8,2,10.0,93.55
18753,8533104,4805,2577600,410256,2759,2046,1.0,0.0
18754,1871184,327,0,8152,153,174,4.545454545454546,0.0
18755,97824,42,1344,5544,41,1,2.380952380952381,65.0
18756,1740,0,1740,0,0,0,50.0,85.0
18757,7128396,468,0,74762,253,215,1.5873015873015872,0.0
18758,8360136,198,0,3746301,110,88,3.125,0.0
18759,40836,136,40836,2743,77,59,50.0,99.98
18760,272952,0,272952,0,0,0,33.333333333333336,50.0
18761,1116,29,1116,782,27,2,3.4482758620689653,61.56
18762,396,19,396,103,12,7,16.666666666666668,68.66
18763,15768,160,0,1206,103,57,100.0,0.0
18764,166656,0,166656,0,0,0,100.0,0.0
18765,155976,54,155976,5031,44,10,2.4390243902439024,7.56
18766,3021444,379,0,30222,210,169,2.0408163265306123,0.0
18767,7236,9,0,2450,5,4,25.0,10.0
18768,125364,169,0,6856,109,60,100.0,0.0
18769,612,23,612,228,16,7,7.142857142857143,86.84
18770,876,114,876,495,66,48,100.0,100.0
18771,72672,1,72672,4044,1,0,25.0,58.0
18772,504,2,504,138,2,0,25.0,96.1
18773,86184,152,0,4458,106,46,50.0,0.0
18774,47448,48,0,4575,38,10,100.0,0.0
18775,48696,152,0,2677,93,59,100.0,0.0
18776,82536,16,82536,959,15,1,7.6923076923076925,95.35
18777,1560,13,1560,1064,13,0,7.6923076923076925,43.02
18778,7980,38,7980,1207,34,4,4.545454545454546,29.16
18779,68676,65,0,4037,49,16,100.0,0.0
18780,46608,33,46608,2061,27,6,6.666666666666667,62.77
18781,96300,96,0,5025,48,48,6.666666666666667,0.0
18782,4834752,395,2941848,21731,203,192,2.5641025641025643,80.44
18783,33864,85,0,765,68,17,50.0,0.0
18784,605244,69,0,10739,55,14,50.0,0.0
18785,97296,41,97296,1314,36,5,3.703703703703704,47.74
18786,1532292,602,0,9661,400,202,50.0,0.0
18787,11580,367,11580,630,230,137,1.0,40.36
18788,29904,17,29904,2304,12,5,25.0,38.61
18789,86040,257,0,4895,200,57,33.333333333333336,0.0
18790,216,13,216,22,12,1,7.6923076923076925,38.87
18791,354864,0,354864,0,0,0,50.0,93.1
18792,8215260,111,8215260,21635,48,63,7.142857142857143,82.25
18793,7533192,2663,600648,1836281,1587,1076,1.0,0.0
18794,8631132,482,0,627803,269,213,2.0,0.37
18795,357600,44,0,13522,35,9,50.0,0.0
18796,501420,53,0,10710,41,12,50.0,0.0
18797,156,35,156,41,29,6,3.571428571428572,53.99
18798,13740,21,13740,392,21,0,5.0,76.31
18799,6332100,47,0,136993,37,10,50.0,0.0
18800,4605036,73,0,217699,62,11,50.0,0.0
18801,17100,23,17100,415,23,0,4.761904761904762,76.58
18802,3624,16,0,510,13,3,100.0,0.0
18803,363000,45,0,9494,30,15,100.0,0.0
18804,300,6,300,98,4,2,33.333333333333336,94.72
18805,7643784,1069,0,574483,556,513,1.0,0.0
18806,6322464,564,0,52965,302,262,1.96078431372549,5.8
18807,108,3,108,44,2,1,33.333333333333336,77.28
18808,420828,16,420828,555,14,2,8.333333333333334,0.66
18809,2256,17,0,1106,14,3,11.11111111111111,0.0
18810,6102780,331,0,25995,163,168,3.571428571428572,0.0
18811,108,4,108,30,2,2,50.0,78.56
18812,701112,32,701112,436,20,12,20.0,0.0
18813,7357968,1354,0,53511,764,590,1.0101010101010102,0.0
18814,20868,93,0,1521,61,32,100.0,0.0
18815,512160,67,0,9361,49,18,50.0,0.0
18816,16176,5,264,3309,4,1,16.666666666666668,56.56
18817,24156,18,24156,922,17,1,7.142857142857143,89.92
18818,660,27,660,81,27,0,3.571428571428572,69.04
18819,8208756,39,8208756,1754624,14,25,2.127659574468085,0.0
18820,64668,20,0,3746,14,6,100.0,100.0
18821,2988,21,0,937,16,5,7.142857142857143,0.0
18822,360,2,360,24,2,0,33.333333333333336,93.41
18823,2706252,65,0,43698,52,13,50.0,0.0
18824,204,3,204,64,3,0,20.0,74.0
18825,11652,63,0,2903,48,15,100.0,0.0
18826,4480560,46,0,234256,37,9,50.0,0.0
18827,480,11,480,76,11,0,8.333333333333334,84.62
18828,564,15,564,172,15,0,6.25,53.86
18829,7488408,991,0,889952,384,607,1.408450704225352,0.0
18830,36264,333,0,7196,203,130,100.0,0.0
18831,363036,46,0,12282,31,15,100.0,0.0
18832,313908,65,0,9164,49,16,50.0,0.0
18833,118536,17,118536,9425,16,1,10.0,14.27
18834,2657496,84,2657496,1465,45,39,7.142857142857143,79.82
18835,1785408,44,0,41816,35,9,100.0,0.0
18836,816,12,816,131,8,4,16.666666666666668,62.45
18837,1656,83,1656,932,59,24,2.083333333333333,68.66
18838,2304,40,0,918,33,7,50.0,92.15
18839,888,27,612,216,24,3,4.0,85.81
18840,74028,31,0,5419,19,12,100.0,100.0
18841,264,59,264,109,39,20,3.571428571428572,57.79
18842,5172,30,0,841,26,4,50.0,37.94
18843,96,4,96,30,2,2,50.0,78.56
18844,7380,38,0,1629,30,8,100.0,0.0
18845,852,16,852,319,14,2,6.666666666666667,78.02
18846,444,4,0,195,4,0,14.285714285714286,2.0
18847,60720,7,192,8693,5,2,16.666666666666668,44.63
18848,1464,32,1464,1102,21,11,7.142857142857143,51.56
18849,72,22,72,18,22,0,4.545454545454546,42.16
18850,67368,1,67368,1032,1,0,33.333333333333336,0.0
18851,168,4,168,60,2,2,50.0,71.19
18852,31416,18,31416,832,11,7,33.333333333333336,97.7
18853,34152,142,34152,183,104,38,1.1111111111111112,10.34
18854,1368,62,1368,1119,44,18,2.7777777777777777,58.01
18855,264,11,264,84,6,5,33.333333333333336,68.43
18856,1428,35,1428,201,33,2,3.0303030303030303,53.51
18857,8645652,13,2908884,665648,7,6,12.5,42.93
18858,59772,182,59772,219,119,63,1.0,19.41
18859,92580,0,92580,0,0,0,50.0,75.0
18860,444,7,444,216,7,0,12.5,89.51
18861,1992,21,0,379,18,3,100.0,100.0
18862,88188,1,88188,108,1,0,33.333333333333336,69.3
18863,8228436,1183,0,70374,683,500,1.0,0.0
18864,1796292,44,0,42389,37,7,100.0,0.0
18865,8664,16,0,867,12,4,100.0,100.0
18866,8556660,5583,1873368,904940,3166,2417,1.0,0.0
18867,384,75,384,97,63,12,1.851851851851852,50.57
18868,2892,18,2892,1102,15,3,7.6923076923076925,0.07
18869,2004,6,2004,1270,6,0,7.6923076923076925,84.17
18870,8904,61,8880,470,35,26,4.3478260869565215,74.65
18871,7939080,244,1056,83431,143,101,3.0303030303030303,1.66
18872,7310484,697,5841390,76390,322,375,1.5625,67.7
18873,168,1,168,24,1,0,33.333333333333336,62.4
18874,4037928,79,0,211871,35,44,25.0,4.0
18875,456,34,456,118,33,1,5.0,82.8
18876,108,53,96,33,37,16,3.333333333333333,36.92
18877,3725568,397,0,20404,211,186,2.5,0.0
18878,204,8,204,21,8,0,10.0,46.97
18879,14928,5,0,3208,3,2,100.0,100.0
18880,12444,23,12444,464,17,6,6.25,49.39
18881,4596,44,0,2115,29,15,100.0,0.0
18882,2376,4,2376,324,4,0,20.0,84.12
18883,108,38,60,30,34,4,2.9411764705882355,26.38
18884,8064780,3684,0,81078,2118,1566,1.0,0.0
18885,240,23,228,37,21,2,4.761904761904762,49.92
18886,22560,153,0,1524,94,59,100.0,0.0
18887,531552,30,531552,117,22,8,5.555555555555555,67.52
18888,7469568,460,0,42544,256,204,1.7857142857142858,0.0
18889,5093616,794,5093185,84249,508,286,1.0,65.68
18890,3712176,243,3712164,15686,153,90,1.3333333333333333,0.0
18891,8352,8,8352,1225,6,2,25.0,71.66
18892,216,0,216,0,0,0,100.0,100.0
18893,52176,28,52176,3618,28,0,5.555555555555555,54.21
18894,7465812,747,0,43967,365,382,1.4705882352941178,0.0
18895,1056,11,1056,338,8,3,11.11111111111111,31.88
18896,14412,217,14412,107,151,66,1.0,24.2
18897,126288,93,126288,9396,85,8,1.351351351351351,14.35
18898,44052,207,44052,4607,156,51,1.1235955056179776,5.18
18899,8095200,360,8095200,57198,204,156,2.1739130434782608,81.19
18900,5772,29,5772,2853,17,12,7.142857142857143,71.11
18901,196896,53,196896,356,31,22,4.545454545454546,86.16
18902,1032,10,1032,315,9,1,7.6923076923076925,13.97
18903,8580924,3852,911664,341528,2109,1743,1.0,0.0
18904,768,20,768,502,16,4,6.25,87.94
18905,34152,0,34152,0,0,0,100.0,100.0
18906,8738520,109,6173316,4914,77,32,1.7857142857142858,47.76
18907,336,13,336,61,13,0,6.666666666666667,88.04
18908,90252,230,0,4751,164,66,100.0,0.0
18909,33624,30,33624,1588,25,5,5.555555555555555,91.6
18910,15816,301,0,4741,185,116,100.0,0.0
18911,864,9,864,302,7,2,16.666666666666668,93.21
18912,75120,263,0,1616,125,138,3.125,0.0
18913,216,48,216,42,48,0,2.631578947368421,50.99
18914,1608,8,1608,54,6,2,14.285714285714286,79.97
18915,3972,22,3972,764,19,3,7.6923076923076925,39.74
18916,804,10,804,171,10,0,9.090909090909092,69.56
18917,300,13,300,120,11,2,10.0,91.19
18918,2076,10,2076,343,9,1,12.5,85.14
18919,8807244,1192,0,2730239,639,553,1.4285714285714286,5.8
18920,216,16,0,65,10,6,50.0,0.0
18921,84,42,84,26,34,8,3.125,34.8
18922,4020,73,4020,356,59,14,2.0,39.56
18923,80484,69,0,2212,31,38,9.090909090909092,1.0
18924,93948,401,93948,11213,309,92,1.0,0.0
18925,7932768,794,0,240213,459,335,1.0,5.14
18926,71748,11,71748,829,11,0,10.0,34.28
18927,3069936,280,0,11691,136,144,5.555555555555555,0.0
18928,2479368,95,2479368,1170,49,46,4.3478260869565215,77.02
18929,1326240,13,1307388,95844,8,5,16.666666666666668,0.0
18930,27336,149,27336,426,113,36,1.1235955056179776,20.98
18931,660,71,660,243,57,14,1.96078431372549,53.89
18932,144,41,144,79,23,18,6.666666666666667,70.29
18933,428904,76,241242,96778,61,15,2.0,47.05
18934,6149676,191,0,47922,96,95,4.0,1.93
18935,8607276,850,2661264,234598,498,352,1.0,0.0
18936,1721028,46,1720944,121640,40,6,2.7777777777777777,57.69
18937,28356,47,0,2857,38,9,100.0,0.0
18938,352560,22,19776,17832,22,0,9.090909090909092,75.64
18939,6151392,270,0,44837,137,133,6.666666666666667,0.0
18940,5865780,40,5865780,11469,24,16,9.090909090909092,81.11
18941,92100,551,0,2794,343,208,2.857142857142857,0.0
18942,768,6,768,392,6,0,14.285714285714286,86.06
18943,156,13,156,64,7,6,33.333333333333336,73.68
18944,156,60,156,8,48,12,2.272727272727273,29.6
18945,252,46,252,26,38,8,2.7777777777777777,28.9
18946,744,50,744,424,26,24,6.666666666666667,71.67
18947,70980,44,70980,23123,43,1,2.272727272727273,24.02
18948,11808,6,0,2232,4,2,100.0,100.0
18949,15804,31,15804,2849,29,2,4.3478260869565215,94.99
18950,720,78,720,19,62,16,1.694915254237288,20.83
18951,8780004,885,0,3931371,446,439,1.2658227848101269,0.0
18952,2570100,82,2570100,4192,36,46,7.142857142857143,69.13
18953,420,43,0,97,26,17,50.0,98.99
18954,78816,15,78816,7283,15,0,3.0303030303030303,62.57
18955,7152036,722,0,98423,384,338,1.851851851851852,0.0
18956,75348,123,0,3559,93,30,33.333333333333336,0.0
18957,14880,150,14880,295,82,68,2.857142857142857,71.53
18958,1468776,33,1468776,2038,28,5,3.571428571428572,48.1
18959,49500,74,0,3108,59,15,12.5,0.0
18960,281028,7,281028,57003,7,0,12.5,48.02
18961,119244,211,0,6177,129,82,100.0,0.0
18962,336,64,336,117,26,38,11.11111111111111,81.98
18963,8635980,3076,0,228942,1746,1330,1.0,0.0
18964,8857140,9235,6412884,5757279,5219,4016,1.0,0.0
18965,79380,42,79380,1115,40,2,2.5,25.34
18966,1872,56,1656,236,47,9,2.272727272727273,0.0
18967,72912,26,72912,2890,21,5,6.25,52.64
18968,84,0,84,0,0,0,50.0,64.0
18969,8861256,3312,0,542204,1870,1442,1.0,0.0
18970,66792,39,0,3439,25,14,100.0,0.0
18971,19092,51,19092,23,41,10,2.631578947368421,25.89
18972,1032,93,1032,354,77,16,1.818181818181818,0.0
18973,684,5,0,496,4,1,50.0,0.0
18974,480,16,480,114,13,3,8.333333333333334,37.26
18975,72,1,0,72,0,1,50.0,0.0
18976,52500,70,0,3463,53,17,50.0,0.0
18977,12636,9,12636,3458,8,1,12.5,89.79
18978,48660,43,0,4150,35,8,100.0,0.0
18979,84,0,84,0,0,0,50.0,59.29
18980,60,1,0,60,0,1,50.0,0.0
18981,7833708,621,0,122423,336,285,1.1494252873563218,0.0
18982,6192,8,0,964,5,3,100.0,0.0
18983,39336,21,39336,2092,18,3,9.090909090909092,22.1
18984,108,35,108,21,29,6,3.571428571428572,55.41
18985,1311048,39,0,108370,30,9,33.333333333333336,0.0
18986,13356,75,0,2420,57,18,9.090909090909092,0.0
18987,228,15,108,52,9,6,20.0,56.96
18988,13500,70,13500,982,54,16,1.9230769230769231,29.41
18989,84,2,84,0,2,0,33.333333333333336,99.19
18990,22668,61,0,2374,49,12,100.0,0.0
18991,516276,88,516276,11420,75,13,1.3888888888888888,30.37
18992,3504,18,3504,698,16,2,9.090909090909092,0.0
18993,252,9,252,92,7,2,12.5,0.0
18994,996,10,996,159,10,0,8.333333333333334,66.73
18995,2729832,108,2729832,8149,60,48,7.6923076923076925,88.34
18996,10632,23,0,1138,18,5,100.0,100.0
18997,68592,44,0,3033,29,15,100.0,0.0
18998,8295348,1059,0,53187,595,464,1.0,2.13
18999,63828,28,0,3209,22,6,50.0,0.0
19000,1236,39,1236,92,27,12,4.3478260869565215,58.34
19001,1001412,71,1001412,437777,57,14,2.631578947368421,3.39
19002,5364,18,5364,518,16,2,9.090909090909092,0.0
19003,444,19,240,87,14,5,8.333333333333334,44.05
19004,8361444,831,0,271483,457,374,1.5151515151515151,2.2
19005,8663088,341,0,151864,172,169,3.4482758620689653,0.0
19006,17856,61,0,1376,44,17,100.0,0.0
19007,5795520,304,0,53743,152,152,3.333333333333333,0.0
19008,9852,41,0,1870,34,7,100.0,0.0
19009,396,73,396,94,47,26,3.125,49.53
19010,5659512,97,0,140409,46,51,10.0,0.0
19011,74340,7,74340,896,7,0,14.285714285714286,96.46
19012,2829012,79,0,145848,61,18,20.0,0.0
19013,1908,14,1908,671,13,1,9.090909090909092,0.0
19014,4800,3,4800,1380,1,2,100.0,100.0
19015,8749572,49,0,1563514,40,9,20.0,0.0
19016,60648,266,0,1768,177,89,100.0,100.0
19017,2844,24,0,706,20,4,50.0,99.99
19018,10872,46,0,1296,31,15,100.0,0.0
19019,23352,11,0,6432,9,2,20.0,0.0
19020,2364,18,0,616,15,3,100.0,100.0
19021,4707696,233,7092,41711,120,113,3.333333333333333,0.0
19022,132,38,132,34,28,10,4.0,59.29
19023,2040,29,0,344,24,5,50.0,99.0
19024,51228,28,51228,1676,25,3,5.2631578947368425,54.82
19025,2868,14,0,547,11,3,100.0,100.0
19026,6888,46,0,1945,37,9,100.0,0.0
19027,96,0,96,0,0,0,50.0,65.8
19028,1764096,188,1764024,361886,157,31,1.0,16.43
19029,336,23,336,97,23,0,4.166666666666667,55.3
19030,80064,47,0,3563,35,12,50.0,0.0
19031,7632,64,0,2132,52,12,20.0,0.0
19032,2964,2,2964,0,2,0,20.0,47.87
19033,3720,12,3720,1206,12,0,9.090909090909092,0.0
19034,27372,17,27372,1087,16,1,6.666666666666667,85.23
19035,57516,21,57516,62,19,2,4.761904761904762,68.29
19036,8153628,51,0,289779,41,10,50.0,0.0
19037,2889120,185,2618520,54012,89,96,3.8461538461538463,82.84
19038,39948,77,39948,677,55,22,2.127659574468085,20.19
19039,2580,20,0,531,17,3,100.0,100.0
19040,8246004,497,0,3081208,257,240,1.7857142857142858,0.0
19041,744,49,744,28,36,13,3.571428571428572,43.53
19042,613776,418,613776,36787,374,44,1.0,85.26
19043,3412824,52,0,256739,39,13,33.333333333333336,0.0
19044,5601252,505,0,1884108,301,204,1.0,0.0
19045,936,29,0,239,23,6,50.0,54.21
19046,1152,30,1152,255,28,2,3.333333333333333,56.51
19047,1320,51,0,219,43,8,100.0,100.0
19048,3343188,19,528,176298,13,6,10.0,28.34
19049,864,88,0,337,81,7,100.0,0.0
19050,2724,23,0,499,21,2,50.0,32.52
19051,21240,19,21240,845,17,2,7.6923076923076925,0.53
19052,8436,35,0,1838,27,8,100.0,0.0
19053,168,32,168,52,26,6,6.666666666666667,44.5
19054,576,21,576,146,21,0,4.545454545454546,56.51
19055,46752,92,0,1007,63,29,100.0,0.0
19056,612,36,0,83,26,10,100.0,0.0
19057,336,20,336,83,12,8,10.0,57.93
19058,2568,13,0,521,11,2,100.0,100.0
19059,8516460,74,0,290170,41,33,6.666666666666667,4.95
19060,47568,70,0,2663,54,16,100.0,0.0
19061,45600,253,0,5064,146,107,100.0,0.0
19062,63240,15,0,4458,9,6,100.0,100.0
19063,576,38,0,221,35,3,50.0,0.0
19064,2543520,187,2543520,56333,82,105,3.225806451612903,70.6
19065,91080,96,0,3895,66,30,50.0,0.0
19066,1799808,23,1799808,5872,14,9,12.5,44.57
19067,8381880,1468,4615488,112890,817,651,1.0,0.0
19068,2304,19,2304,394,14,5,12.5,87.16
19069,1104,33,1104,236,29,4,3.4482758620689653,70.26
19070,2832,64,0,2140,58,6,2.2222222222222223,5.33
19071,156,10,156,66,10,0,10.0,63.55
19072,4284,6,4284,1688,3,3,20.0,0.0
19073,1212,23,1212,94,21,2,4.545454545454546,79.97
19074,3156,218,0,653,148,70,50.0,0.0
19075,3216900,13,143040,742501,11,2,10.0,55.91
19076,5340,7,4998,2532,6,1,25.0,92.77
19077,816,19,816,585,16,3,5.555555555555555,57.11
19078,300,32,300,84,30,2,4.0,73.73
19079,2531280,19,2531280,3161,11,8,7.142857142857143,71.22
19080,1368,3,1080,964,2,1,12.5,91.18
19081,396,51,396,113,38,13,3.0303030303030303,68.28
19082,70140,16,0,5052,11,5,100.0,100.0
19083,6211524,181,0,165561,100,81,3.8461538461538463,0.0
19084,17928,303,0,2346,171,132,50.0,0.0
19085,8908644,1398,0,4415212,760,638,1.0,0.0
19086,456,10,456,424,4,6,33.333333333333336,98.88
19087,37188,85,37188,909,83,2,2.272727272727273,60.48
19088,16224,47,0,1959,38,9,100.0,0.0
19089,56580,262,0,3990,185,77,50.0,0.0
19090,384,45,384,18,45,0,2.127659574468085,56.35
19091,2640,5,2640,820,5,0,25.0,88.95
19092,172440,16,172440,2596,13,3,8.333333333333334,37.05
19093,70188,3,70188,204,3,0,25.0,96.1
19094,120,20,96,21,15,5,6.666666666666667,89.08
19095,1416,8,0,507,6,2,100.0,0.0
19096,96,9,72,54,6,3,7.6923076923076925,61.25
19097,4294728,94,0,267233,41,53,4.3478260869565215,0.0
19098,504,185,504,118,113,72,2.5641025641025643,41.71
19099,8435100,321,0,39944,164,157,2.272727272727273,2.0
19100,252,26,252,123,20,6,5.2631578947368425,85.12
19101,7548,134,0,1494,78,56,50.0,0.0
19102,8879148,5329,0,752617,2910,2419,1.0,0.45
19103,422340,130,422340,150235,104,26,1.2048192771084338,0.0
19104,816,105,0,142,90,15,1.1764705882352942,0.0
19105,2988,38,2988,1260,29,9,6.666666666666667,42.39
19106,89160,343,0,4121,206,137,100.0,0.0
19107,612,80,612,176,54,26,2.4390243902439024,68.04
19108,1404,60,1404,316,50,10,2.127659574468085,42.56
19109,58752,60,58752,3746,54,6,1.8867924528301887,21.42
19110,1920,42,1866,1506,33,9,4.166666666666667,78.99
19111,8883528,691,0,564231,380,311,1.6666666666666667,0.0
19112,1782156,2,84,1782150,1,1,1.0,0.0
19113,90948,115,1056,2968,76,39,1.96078431372549,45.98
19114,2181000,253,760,34779,162,91,1.0,0.0
19115,420,2,420,30,1,1,50.0,88.0
19116,9156,69,0,721,46,23,50.0,0.0
19117,2928,128,0,680,78,50,100.0,0.0
19118,204,29,204,69,17,12,7.6923076923076925,68.53
19119,756,59,756,170,57,2,2.7777777777777777,64.36
19120,5436,4,5436,312,4,0,7.6923076923076925,31.97
19121,1080,45,1080,931,35,10,3.125,74.55
19122,2593500,63,2593500,2321,37,26,10.0,78.83
19123,192,6,192,8,6,0,12.5,61.17
19124,14760,69,14760,1199,69,0,1.851851851851852,10.57
19125,1632,39,0,644,21,18,16.666666666666668,0.0
19126,70728,5,70728,1128,5,0,16.666666666666668,40.5
19127,8925024,22945,3421184,4995933,12682,10263,1.0,0.04
19128,2469912,53,2469912,54554,23,30,9.090909090909092,81.81
19129,7650672,564,0,143052,298,266,1.492537313432836,0.0
19130,348,10,348,190,10,0,12.5,66.17
19131,18624,52,0,765,43,9,50.0,0.0
19132,8284740,184,0,147644,88,96,6.666666666666667,0.0
19133,8864988,6077,0,625956,3368,2709,1.0,0.0
19134,18384,89,0,642,57,32,100.0,0.0
19135,26940,11,26940,9002,5,6,25.0,0.0
19136,2479236,144,2479236,27447,69,75,6.25,82.91
19137,691104,5,0,187092,3,2,12.5,0.0
19138,95400,119,95400,17718,101,18,1.1494252873563218,14.91
19139,4872,221,0,3270,151,70,100.0,100.0
19140,6204,155,0,1615,97,58,50.0,0.0
19141,23448,125,0,893,78,47,33.333333333333336,0.0
19142,68244,250,0,3214,154,96,50.0,0.0
19143,3098736,126,0,26464,75,51,2.3255813953488373,0.0
19144,26100,54,0,2055,45,9,100.0,0.0
19145,45024,19,45024,2241,19,0,5.882352941176471,85.78
19146,24792,3,0,8668,2,1,100.0,0.0
19147,2940,16,2940,822,8,8,16.666666666666668,93.8
19148,1140,11,1140,346,8,3,16.666666666666668,87.12
19149,3924,83,0,953,61,22,50.0,0.0
19150,84408,284,0,5727,163,121,100.0,0.0
19151,576,10,576,22,10,0,8.333333333333334,56.36
19152,4812,20,4812,1533,19,1,8.333333333333334,0.0
19153,2016,99,0,459,80,19,100.0,0.0
19154,300,1,0,300,1,0,33.333333333333336,0.0
19155,7781544,49,0,477811,39,10,33.333333333333336,0.0
19156,7646604,417,5160630,36210,160,257,1.3333333333333333,48.23
19157,6867948,2451,728086,2037727,1418,1033,1.0,0.0
19158,4328424,293,0,27834,215,78,100.0,0.0
19159,54888,28,54888,2451,25,3,5.555555555555555,54.54
19160,7893756,65,0,1469904,54,11,25.0,0.0
19161,510324,29,510324,470226,26,3,5.2631578947368425,69.92
19162,792,11,792,290,7,4,25.0,45.82
19163,36552,17,29952,21338,15,2,7.142857142857143,85.69
19164,3106116,32,2200440,2060028,32,0,100.0,99.99
19165,2923056,73,2923056,846,27,46,14.285714285714286,0.0
19166,68448,100,68448,6115,78,22,1.4705882352941178,29.63
19167,48360,48,0,6746,38,10,100.0,0.0
19168,6234036,125,6234036,68025,69,56,3.8461538461538463,1.87
19169,4800,11,4800,973,11,0,10.0,83.5
19170,50772,71,0,8024,57,14,16.666666666666668,29.08
19171,2369220,58,2369220,46,48,10,2.2222222222222223,29.48
19172,2340,13,2340,239,8,5,20.0,87.22
19173,48252,82,0,2669,54,28,50.0,0.0
19174,204,18,204,28,17,1,5.555555555555555,40.5
19175,39912,22,13776,6709,19,3,7.6923076923076925,98.75
19176,8451516,320,0,111139,186,134,2.5,0.0
19177,4556988,263,0,320502,178,85,2.0408163265306123,0.0
19178,396,66,396,133,40,26,4.3478260869565215,64.78
19179,11532,0,11287,0,0,0,1.96078431372549,10.29
19180,12816,363,1932,1006,206,157,2.3255813953488373,70.01
19181,432,26,0,141,16,10,50.0,0.0
19182,76140,40,0,3163,25,15,100.0,0.0
19183,888,155,0,248,81,74,4.545454545454546,0.0
19184,2430552,80,2430552,511,33,47,12.5,94.08
19185,17736,138,0,818,72,66,3.225806451612903,4.76
19186,8956032,4206,0,7413261,2377,1829,1.0,0.0
19187,522720,96,0,22305,53,43,7.142857142857143,0.0
19188,28932,144,0,2384,81,63,5.0,2.66
19189,660,26,660,283,12,14,14.285714285714286,91.65
19190,600708,28,600708,17068,11,17,25.0,97.71
19191,227124,708,4128,2071,381,327,1.3888888888888888,0.0
19192,1836,21,1596,487,12,9,100.0,100.0
19193,336,6,336,158,5,1,16.666666666666668,77.32
19194,7853736,1198,0,64223,638,560,1.0309278350515465,0.0
19195,1260,10,1260,535,8,2,10.0,93.26
19196,8930052,6224,798324,80184,3456,2768,1.0,0.0
19197,2272320,70,1011504,46466,40,30,12.5,0.0
19198,7126140,73,0,441386,54,19,50.0,0.0
19199,325092,17,325092,22541,11,6,14.285714285714286,57.65
19200,8223312,972,7961952,235767,427,545,1.0,0.0
19201,80580,41,0,3045,27,14,100.0,0.0
19202,14964,52,0,1710,38,14,50.0,0.0
19203,60,4,60,0,4,0,16.666666666666668,53.13
19204,92292,30,92292,1106,26,4,5.882352941176471,53.16
19205,6336,23,6336,2409,20,3,9.090909090909092,0.0
19206,77892,6,77892,8530,6,0,16.666666666666668,87.98
19207,7770012,451,0,57600,280,171,2.2222222222222223,0.0
19208,72,12,72,14,9,3,14.285714285714286,49.4
19209,6613512,310,0,63472,170,140,2.083333333333333,0.0
19210,69144,69,0,2850,53,16,50.0,0.0
19211,10428,14,0,1464,12,2,100.0,0.0
19212,8215224,551,2055186,1031313,471,80,1.0,2.64
19213,1692,18,0,321,14,4,100.0,100.0
19214,82752,7,82752,1474,6,1,33.333333333333336,96.61
19215,22344,10,22344,519,9,1,11.11111111111111,79.11
19216,22560,64,0,4898,49,15,100.0,0.0
19217,168852,36,168852,2162,33,3,3.225806451612903,59.7
19218,16908,46,0,1372,30,16,100.0,0.0
19219,2052,18,0,607,16,2,100.0,100.0
19220,31308,51,0,2339,44,7,50.0,0.0
19221,4824,32,4824,578,32,0,5.2631578947368425,65.46
19222,3000,21,0,456,16,5,100.0,100.0
19223,1134348,53,1134348,6249,48,5,2.127659574468085,23.42
19224,946368,97,517062,65223,78,19,1.2987012987012987,0.0
19225,8442720,2561,0,51245,1460,1101,1.0,1.85
19226,336,11,336,142,5,6,25.0,82.05
19227,8858016,562,3231975,4271300,304,258,1.0,0.0
19228,359304,37,4728,12509,28,9,4.0,61.27
19229,2699664,243,2699664,12768,119,124,4.3478260869565215,71.28
19230,97596,0,97596,0,0,0,100.0,100.0
19231,1176,6,1176,102,2,4,50.0,80.56
19232,16416,54,0,1391,40,14,50.0,0.0
19233,2400,35,0,732,30,5,50.0,98.0
19234,43224,52,0,6899,43,9,100.0,0.0
19235,1404,1,1404,564,1,0,33.333333333333336,74.44
19236,588,15,588,365,15,0,5.882352941176471,88.92
19237,1128,25,1128,258,25,0,4.166666666666667,80.81
19238,18948,42,0,1428,27,15,100.0,0.0
19239,2683776,16,2177898,8476,8,8,25.0,94.6
19240,1836,155,1836,162,123,32,1.0,51.45
19241,3840,6,3840,144,4,2,25.0,62.44
19242,216,33,216,45,19,14,5.882352941176471,59.34
19243,156,10,156,28,8,2,12.5,64.03
19244,564,24,564,77,22,2,4.3478260869565215,63.86
19245,8888268,28,8888268,40185,24,4,5.2631578947368425,57.23
19246,3696,41,3696,321,35,6,2.857142857142857,50.81
19247,13044,31,0,1671,25,6,100.0,0.0
19248,53916,126,0,2541,81,45,50.0,0.0
19249,180,10,180,32,8,2,12.5,64.33
19250,46416,131,0,1330,88,43,100.0,0.0
19251,8053776,749,8053776,233339,373,376,1.408450704225352,69.23
19252,912,2,240,456,2,0,50.0,91.76
19253,2251416,163,1739586,293194,133,30,1.0,6.87
19254,1284,50,1284,102,40,10,2.702702702702702,40.71
19255,89820,35,89820,830,35,0,3.333333333333333,44.26
19256,32736,110,0,2373,67,43,50.0,0.0
19257,468,46,228,154,35,11,3.225806451612903,89.45
19258,1392,5,1392,180,5,0,16.666666666666668,89.92
19259,816,75,816,309,68,7,1.5151515151515151,44.61
19260,163068,69,163068,63669,56,13,2.127659574468085,4.35
19261,1997160,19,94188,105696,17,2,9.090909090909092,34.94
19262,3936,5,0,811,3,2,33.333333333333336,0.0
19263,50124,2,50124,1008,2,0,33.333333333333336,99.71
19264,216,2,216,102,1,1,50.0,63.86
19265,516,12,516,304,8,4,12.5,77.55
19266,252,21,252,69,15,6,9.090909090909092,88.9
19267,8966364,4070,1506972,1760080,2370,1700,1.0,6.8
19268,528,23,528,64,19,4,5.882352941176471,39.55
19269,82212,8,36,20553,7,1,14.285714285714286,66.15
19270,215316,353,0,8229,227,126,100.0,0.0
19271,20568,18,0,1530,12,6,100.0,100.0
19272,62508,55,0,1479,38,17,50.0,0.0
19273,96,11,96,27,9,2,11.11111111111111,46.32
19274,9348,8,9348,55,6,2,14.285714285714286,68.53
19275,1236,28,0,264,20,8,5.0,1.5
19276,5888436,66,0,360792,33,33,11.11111111111111,5.0
19277,36072,209,0,639,94,115,7.142857142857143,0.0
19278,11964,45,0,1925,38,7,100.0,0.0
19279,61788,53,0,2038,40,13,100.0,0.0
19280,10332,255,0,3550,147,108,50.0,0.0
19281,24612,17,24612,1020,17,0,7.142857142857143,81.44
19282,3168,64,0,1183,44,20,50.0,0.0
19283,8584764,392,0,538212,235,157,1.96078431372549,1.1
19284,7084452,447,0,48146,211,236,2.1739130434782608,0.0
19285,324,33,324,108,33,0,2.857142857142857,68.1
19286,1128,113,888,660,88,25,1.3157894736842106,0.0
19287,276,2,276,72,2,0,25.0,86.17
19288,6302664,149,0,232840,73,76,5.2631578947368425,0.0
19289,7998576,311,0,94955,154,157,3.571428571428572,1.53
19290,8975160,720,2733984,1135488,352,368,1.0,0.0
19291,8966388,5630,0,1132563,3533,2097,1.0,0.0
19292,27072,15,27072,19600,13,2,7.6923076923076925,0.0
19293,15780,133,0,1852,105,28,1.408450704225352,2.88
19294,6981264,706,0,36744,397,309,1.2820512820512822,0.0
19295,1476,61,156,112,42,19,3.0303030303030303,43.29
19296,225324,11,225324,411,6,5,50.0,57.61
19297,3264984,74,3264984,37302,29,45,14.285714285714286,84.48
19298,3408,6,0,930,4,2,100.0,0.0
19299,168,8,0,49,7,1,100.0,0.0
19300,6503760,554,0,34681,318,236,1.351351351351351,0.0
19301,55200,50,55200,6020,46,4,2.272727272727273,25.0
19302,1476,116,0,302,70,46,100.0,0.0
19303,4848,53,0,848,36,17,50.0,0.0
19304,8580528,4151,1463520,299127,2316,1835,1.0,0.0
19305,1644,17,0,739,11,6,50.0,0.0
19306,648,100,612,315,64,36,2.4390243902439024,60.21
19307,84,6,84,0,6,0,12.5,59.2
19308,732,20,720,594,16,4,6.666666666666667,67.24
19309,468,19,408,110,14,5,9.090909090909092,86.01
19310,2628,2,2628,1500,1,1,50.0,68.37
19311,372,2,372,54,2,0,33.333333333333336,99.48
19312,900,2,900,0,2,0,33.333333333333336,98.29
19313,8811396,147,0,3419388,84,63,6.25,0.97
19314,77736,239,0,2975,143,96,100.0,0.0
19315,216,21,216,37,16,5,7.6923076923076925,40.37
19316,672,30,672,243,20,10,3.703703703703704,74.27
19317,1764,155,0,337,122,33,100.0,0.0
19318,8533512,177,3853728,910882,74,103,1.3157894736842106,43.91
19319,2480712,182,2480712,19362,95,87,2.7777777777777777,71.73
19320,7464396,1672,0,1133920,863,809,1.0,0.0
19321,4284,14,4284,324,12,2,8.333333333333334,49.63
19322,4562304,51,0,93801,28,23,10.0,0.0
19323,1392,41,1392,1120,28,13,5.882352941176471,78.51
19324,7775940,287,0,60149,141,146,1.851851851851852,0.0
19325,2683272,210,2651892,47737,97,113,2.857142857142857,0.0
19326,6864,19,6864,2300,15,4,9.090909090909092,71.11
19327,588,30,588,266,26,4,4.166666666666667,69.58
19328,1920,30,1920,1025,20,10,5.882352941176471,82.27
19329,1032,85,1032,554,55,30,2.4390243902439024,62.08
19330,8848092,4547,1510740,1068517,2284,2263,1.0,0.43
19331,1848,103,0,734,70,33,50.0,0.0
19332,283524,19,3696,27299,15,4,7.142857142857143,71.42
19333,5880,202,5880,450,122,80,1.2658227848101269,27.17
19334,5335320,102,5335320,37264,49,53,5.555555555555555,78.72
19335,3295224,1247,0,139618,678,569,4.166666666666667,0.0
19336,4008,44,0,639,33,11,50.0,0.0
19337,2400,136,0,695,119,17,50.0,0.0
19338,8950476,1731,0,255210,951,780,1.0,0.0
19339,1728,63,1728,566,63,0,1.5384615384615383,26.55
19340,355464,3,0,125476,1,2,33.333333333333336,0.0
19341,156,5,156,24,4,1,20.0,56.95
19342,7816512,1137,0,95910,644,493,1.0,1.0
19343,65520,2,65520,180,2,0,33.333333333333336,92.61
19344,25176,7,0,3790,5,2,100.0,100.0
19345,504,11,504,282,8,3,25.0,73.39
19346,564,7,564,70,6,1,14.285714285714286,81.78
19347,6455928,92,0,70895,54,38,5.2631578947368425,0.0
19348,2496384,83,2496384,1667,34,49,11.11111111111111,93.27
19349,2198040,552,1181034,48323,407,145,1.0,31.7
19350,27264,53,0,970,38,15,50.0,0.0
19351,8318424,375,0,144692,202,173,2.127659574468085,0.0
19352,3853476,57,3853476,10390,39,18,2.9411764705882355,5.0
19353,13248,131,0,1036,78,53,100.0,0.0
19354,32700,19,32700,349,19,0,5.555555555555555,73.63
19355,396,29,0,67,28,1,50.0,0.0
19356,45048,22,0,2978,18,4,50.0,0.0
19357,239040,3,0,79748,1,2,100.0,0.0
19358,4995780,136,4995780,383252,55,81,5.882352941176471,80.25
19359,8452572,1674,7823676,133244,937,737,1.0,59.22
19360,3960,38,0,360,36,2,100.0,0.0
19361,3891132,116,0,35621,49,67,7.6923076923076925,0.0
19362,1188,25,1188,651,25,0,16.666666666666668,94.78
19363,9032328,3320,206664,548918,1878,1442,1.0,0.0
19364,23664,5,23664,4744,5,0,25.0,99.84
19365,156,7,156,20,7,0,11.11111111111111,72.26
19366,3180,87,0,716,57,30,50.0,0.0
19367,5652,3,5652,1820,2,1,33.333333333333336,75.22
19368,8982792,2513,0,870633,1492,1021,1.0,3.7
19369,756804,3,756804,153416,3,0,33.333333333333336,93.85
19370,2532,87,0,315,39,48,5.882352941176471,0.0
19371,35100,143,0,1985,94,49,25.0,0.0
19372,5388,44,5388,106,28,16,4.545454545454546,39.11
19373,71172,46,0,7350,36,10,50.0,0.0
19374,1342068,179,0,10120,87,92,5.882352941176471,1.0
19375,363036,6,363036,24886,6,0,14.285714285714286,76.86
19376,84732,23,84732,9525,22,1,6.25,13.37
19377,40104,144,0,3171,96,48,100.0,100.0
19378,8492244,905,8353980,140683,462,443,1.0101010101010102,0.0
19379,1440,59,1440,537,37,22,3.333333333333333,22.59
19380,156,51,156,5,47,4,2.127659574468085,27.64
19381,8356404,2353,1116804,702591,1302,1051,1.0,0.0
19382,520656,7,520656,142210,7,0,20.0,27.29
19383,68832,0,68760,0,0,0,1.96078431372549,10.29
19384,1548,1,1548,648,1,0,50.0,99.97
19385,12348,3,12348,1724,3,0,16.666666666666668,39.92
19386,41568,74,41568,4308,67,7,1.5625,13.3
19387,27564,62,0,845,62,0,1.6129032258064515,0.0
19388,24012,31,24012,1807,31,0,3.225806451612903,29.78
19389,11508,6,11508,360,5,1,25.0,23.43
19390,4452,18,4452,371,18,0,6.25,82.74
19391,3684,2,3684,2382,1,1,50.0,92.1
19392,8667120,179,0,165698,90,89,2.702702702702702,0.0
19393,14772,84,0,1886,60,24,33.333333333333336,0.0
19394,144,13,144,9,12,1,7.6923076923076925,47.91
19395,67836,42,0,2880,37,5,50.0,0.0
19396,6456,28,6456,647,27,1,4.166666666666667,66.01
19397,96,3,96,0,3,0,20.0,79.0
19398,936,3,936,688,1,2,50.0,99.34
19399,15276,37,0,1752,31,6,100.0,0.0
19400,8800368,122,1332544,2204759,78,44,3.8461538461538463,0.0
19401,204,6,204,62,5,1,16.666666666666668,39.53
19402,228,6,216,74,6,0,14.285714285714286,53.64
19403,23328,52,0,2205,42,10,50.0,0.0
19404,8117652,813,0,1301475,322,491,1.2345679012345678,0.0
19405,6336,41,0,1365,33,8,100.0,0.0
19406,168,14,168,108,8,6,33.333333333333336,95.6
19407,1200,10,0,511,9,1,100.0,0.0
19408,245376,339,245376,656,217,122,1.0,19.9
19409,1860,35,0,673,29,6,50.0,97.46
19410,11196,45,0,2066,36,9,100.0,0.0
19411,4634376,1247,3203448,614460,968,279,1.0,1.3
19412,672,4,672,102,2,2,33.333333333333336,69.36
19413,9031380,10767,137176,1022761,6229,4538,1.0,0.0
19414,2678904,212,0,22960,109,103,8.333333333333334,5.0
19415,6368940,164,0,55771,74,90,6.25,0.0
19416,2208,6,2208,42,3,3,50.0,57.41
19417,14424,65,0,605,52,13,50.0,0.0
19418,70272,31,0,3888,20,11,100.0,100.0
19419,252,13,84,30,11,2,9.090909090909092,49.31
19420,6369408,94,0,139135,44,50,5.0,0.0
19421,6792888,434,0,47889,223,211,3.225806451612903,0.0
19422,6806400,1200,0,26831,655,545,1.0,0.0
19423,408,15,408,152,9,6,12.5,95.08
19424,180,0,180,0,0,0,100.0,0.0
19425,221220,524,96452,11785,402,122,1.0,0.0
19426,7257480,295,3619812,242347,158,137,2.631578947368421,0.0
19427,1716,4,1716,315,4,0,25.0,67.62
19428,2172,12,0,457,9,3,100.0,100.0
19429,4536,15,60,319,14,1,6.666666666666667,72.56
19430,2076,18,2076,666,12,6,11.11111111111111,28.0
19431,144,28,144,33,24,4,4.761904761904762,63.95
19432,216,10,216,50,7,3,16.666666666666668,55.87
19433,6500352,89,0,90049,57,32,3.333333333333333,5.5
19434,2496,32,2496,58,32,0,2.9411764705882355,65.05
19435,300,2,300,96,2,0,25.0,97.0
19436,16788,62,0,628,45,17,20.0,0.0
19437,7864692,357,0,43348,192,165,2.0408163265306123,2.5
19438,65100,169,0,5809,119,50,100.0,0.0
19439,6834288,681,0,234114,368,313,2.0,0.0
19440,708960,7,708960,3430,5,2,20.0,66.08
19441,588,101,588,141,56,45,3.703703703703704,68.55
19442,1140,5,1140,50,5,0,16.666666666666668,95.01
19443,2599080,106,0,47420,44,62,12.5,0.0
19444,8899848,881,0,255755,501,380,1.3333333333333333,0.0
19445,132,11,132,36,8,3,12.5,54.67
19446,1248,21,0,993,19,2,50.0,0.0
19447,2052,57,816,256,36,21,4.0,80.93
19448,4821000,2,0,4663128,2,0,1.0,8.64
19449,5100,55,0,980,39,16,50.0,0.0
19450,1068,71,372,160,45,26,2.857142857142857,43.1
19451,48,0,48,0,0,0,100.0,100.0
19452,8232,0,8232,0,0,0,50.0,63.16
19453,9073716,288,553140,1944957,160,128,1.0,0.0
19454,588,49,588,214,41,8,2.5641025641025643,66.87
19455,288,92,288,91,74,18,1.5873015873015872,49.0
19456,6374364,351,0,91832,159,192,1.3333333333333333,0.0
19457,8618040,2309,46476,736806,1345,964,1.0,0.0
19458,1080,102,0,75,91,11,1.1904761904761905,0.0
19459,2724,240,0,333,168,72,100.0,0.0
19460,5274264,115,0,62827,58,57,5.555555555555555,5.0
19461,7020,14,0,692,9,5,100.0,100.0
19462,276,26,276,119,24,2,4.166666666666667,55.96
19463,2316,17,0,684,16,1,100.0,100.0
19464,19860,142,0,2512,90,52,100.0,0.0
19465,25320,4,25320,69,3,1,33.333333333333336,74.12
19466,40392,26,168,1624,14,12,14.285714285714286,44.81
19467,7840260,293,0,34014,140,153,3.225806451612903,0.0
19468,4140660,195,4140660,65898,92,103,4.0,86.25
19469,840,62,840,122,58,4,1.96078431372549,50.13
19470,11724,25,0,889,19,6,100.0,100.0
19471,1836,13,1836,1045,13,0,9.090909090909092,33.1
19472,2124,94,912,527,91,3,1.694915254237288,81.6
19473,2774244,159,2774244,577,69,90,4.545454545454546,76.58
19474,412836,162,0,52417,74,88,3.125,0.0
19475,108,13,108,23,10,3,12.5,67.47
19476,63768,331,372,511,135,196,1.0,37.0
19477,2640,13,2640,846,13,0,7.6923076923076925,13.36
19478,4520448,299,0,19179,163,136,2.1739130434782608,0.0
19479,60,6,60,10,6,0,14.285714285714286,35.96
19480,88944,13,88944,85,7,6,25.0,71.38
19481,5285340,56,0,108956,23,33,20.0,0.0
19482,3852,12,60,649,10,2,9.090909090909092,45.53
19483,125628,90,125628,2656,73,17,1.7857142857142858,5.82
19484,372,4,372,114,3,1,25.0,62.02
19485,984,74,984,165,47,27,3.703703703703704,48.46
19486,240876,45,240876,2913,45,0,2.127659574468085,34.55
19487,264,39,96,33,35,4,3.0303030303030303,29.55
19488,696,57,0,105,36,21,100.0,0.0
19489,8467560,275,0,85859,154,121,2.272727272727273,0.0
19490,7867416,4196,7867416,798726,2413,1783,1.0,0.0
19491,96,6,96,42,4,2,50.0,99.55
19492,348,5,348,57,5,0,14.285714285714286,59.61
19493,240,13,240,79,11,2,8.333333333333334,83.8
19494,3540,18,3540,716,18,0,5.882352941176471,9.64
19495,1008,7,0,797,3,4,50.0,0.0
19496,324,109,324,105,99,10,1.36986301369863,34.26
19497,780,31,780,310,31,0,3.0303030303030303,46.58
19498,9075900,2035,679920,2130734,1152,883,1.0,1.79
19499,228,5,228,112,5,0,14.285714285714286,92.2
19500,5176500,98,5176500,28562,39,59,4.545454545454546,81.14
19501,9000228,179,0,55435,106,73,5.2631578947368425,4.0
19502,2940,152,2940,819,110,42,1.0526315789473684,22.7
19503,780,15,780,360,15,0,9.090909090909092,62.21
19504,2052,0,2052,0,0,0,100.0,100.0
19505,27288,346,0,12257,158,188,1.5873015873015872,0.0
19506,9017940,2923,3939168,1150967,1648,1275,1.0,0.47
19507,27384,3,0,9512,1,2,50.0,0.0
19508,6471396,258,0,33703,134,124,2.0,0.0
19509,54288,3,54288,18184,2,1,50.0,99.89
19510,1212,31,0,134,18,13,50.0,0.0
19511,183876,137,0,1905,67,70,4.166666666666667,0.0
19512,588,11,588,121,11,0,7.6923076923076925,89.85
19513,8779692,2384,57348,261543,1273,1111,1.0,0.0
19514,372,15,372,102,15,0,5.882352941176471,74.14
19515,49224,5,49224,220,4,1,6.666666666666667,31.18
19516,6423048,399,0,58261,225,174,1.7543859649122806,0.0
19517,7010388,394,7010388,170973,159,235,2.083333333333333,63.72
19518,27312,33,27312,774,33,0,2.857142857142857,51.45
19519,8750952,373,0,264819,188,185,3.225806451612903,0.0
19520,2136,4,2136,990,4,0,12.5,7.12
19521,7729536,1549,0,115760,826,723,1.0,0.0
19522,2100,303,2100,1548,234,69,1.0,63.13
19523,540,28,540,181,17,11,14.285714285714286,54.32
19524,6804,8,6804,2118,8,0,10.0,8.51
19525,103152,0,103152,0,0,0,100.0,100.0
19526,8906784,238,0,260544,130,108,2.0,6.5
19527,6403584,158,0,76908,77,81,5.555555555555555,0.0
19528,63936,122,0,2676,75,47,2.3255813953488373,0.0
19529,240,5,0,100,4,1,33.333333333333336,0.0
19530,216,12,216,22,12,0,7.142857142857143,52.66
19531,22164,10,0,2408,7,3,100.0,100.0
19532,8512464,275,0,114759,142,133,2.380952380952381,0.0
19533,1608,4,1608,672,4,0,25.0,36.17
19534,171696,9,0,39949,4,5,33.333333333333336,0.0
19535,5502912,319,5502732,38412,164,155,2.5,0.0
19536,1982904,32,1982904,672010,31,1,3.333333333333333,47.15
19537,6408540,193,0,70303,84,109,3.703703703703704,0.0
19538,2976,3,2976,100,3,0,20.0,74.0
19539,420,10,420,7,9,1,9.090909090909092,62.09
19540,9072900,1623,0,150776,878,745,1.0,3.45
19541,204,22,0,43,11,11,50.0,0.0
19542,228,0,228,0,0,0,50.0,59.29
19543,22056,72,0,2045,33,39,10.0,4.0
19544,25548,29,0,1174,23,6,100.0,100.0
19545,168,30,168,42,21,9,7.142857142857143,38.09
19546,168,7,168,44,5,2,20.0,61.91
19547,1032,35,0,212,30,5,33.333333333333336,0.0
19548,12708,6,0,2684,5,1,100.0,0.0
19549,84,0,84,0,0,0,50.0,64.0
19550,144,5,144,0,5,0,14.285714285714286,53.82
19551,156,8,156,21,6,2,14.285714285714286,58.11
19552,1771716,247,0,18240,144,103,1.0,0.0
19553,6414708,594,0,36033,318,276,1.9230769230769231,4.09
19554,8466012,247,0,36257,124,123,2.4390243902439024,0.0
19555,9031404,1832,0,68638,1055,777,1.0,2.59
19556,45612,56,45612,1163,35,21,2.4390243902439024,79.16
19557,57804,0,57804,0,0,0,50.0,57.18
19558,56460,3,56460,0,3,0,25.0,73.0
19559,120,0,120,0,0,0,50.0,78.0
19560,3924,98,0,509,63,35,50.0,0.0
19561,264,17,264,73,11,6,14.285714285714286,65.02
19562,74664,11,74664,1454,11,0,10.0,87.4
19563,252,4,252,12,3,1,25.0,62.02
19564,13824,169,0,448,82,87,3.0303030303030303,0.0
19565,276,2,276,96,1,1,50.0,60.77
19566,840,7,0,480,6,1,100.0,0.0
19567,115272,9,115272,1080,9,0,10.0,76.35
19568,12660,92,0,5678,60,32,100.0,0.0
19569,8463480,346,4566864,388394,180,166,1.8867924528301887,4.52
19570,56376,79,0,14742,63,16,100.0,0.0
19571,7910436,532,0,58053,293,239,1.5873015873015872,0.0
19572,360,27,360,44,21,6,5.0,56.46
19573,5243508,237,0,32183,130,107,3.333333333333333,0.0
19574,3369816,5,3369816,1065,3,2,33.333333333333336,78.6
19575,2784,20,2784,854,13,7,14.285714285714286,84.63
19576,4574112,52,4574112,126165,22,30,20.0,5.0
19577,13452,78,0,1703,32,46,9.090909090909092,0.0
19578,7512000,477,0,60062,248,229,2.2222222222222223,1.11
19579,7843236,163,7843236,103731,91,72,3.4482758620689653,74.51
19580,92376,171,0,2693,115,56,100.0,0.0
19581,2330304,200,0,31099,104,96,5.882352941176471,0.0
19582,828,25,828,281,19,6,6.666666666666667,0.0
19583,25692,18,6072,748,17,1,6.666666666666667,79.35
19584,3293136,374,0,18127,197,177,2.2222222222222223,4.98
19585,637416,54,288,26521,33,21,8.333333333333334,5.13
19586,264,7,264,80,6,1,14.285714285714286,61.1
19587,4272,2,0,2274,1,1,50.0,0.0
19588,2004,2,666,1002,2,0,100.0,100.0
19589,35316,37,35316,537,20,17,20.0,52.95
19590,3012,1,120,3012,1,0,50.0,70.0
19591,8563836,1645,0,74601,936,709,1.0,0.0
19592,2820,14,0,969,13,1,100.0,0.0
19593,504,19,504,194,17,2,5.555555555555555,80.91
19594,220224,20,220224,554,16,4,8.333333333333334,85.63
19595,240,3,240,0,3,0,20.0,66.04
19596,576,0,576,0,0,0,50.0,64.0
19597,60816,35,0,4381,28,7,100.0,0.0
19598,846384,209,0,10827,113,96,5.2631578947368425,0.0
19599,2496,9,2496,289,5,4,50.0,3.0
19600,696,116,696,435,96,20,1.1494252873563218,17.2
19601,2484,3,0,1876,3,0,100.0,100.0
19602,4342860,74,0,176749,37,37,6.25,0.0
19603,29688,14,29688,4096,11,3,16.666666666666668,82.85
19604,1368312,26,10152,53502,22,4,5.555555555555555,71.94
19605,2184,9,780,489,6,3,14.285714285714286,67.85
19606,264,33,180,58,28,5,3.8461538461538463,37.01
19607,27924,37,27924,17658,37,0,3.4482758620689653,20.92
19608,5376,0,5376,0,0,0,100.0,100.0
19609,316068,323,316068,239,209,114,1.0,9.9
19610,8847384,417,97380,94238,224,193,2.3255813953488373,0.0
19611,527556,287,0,5192,148,139,4.0,0.0
19612,1260,8,1260,82,8,0,10.0,81.53
19613,4350144,216,0,85840,106,110,5.0,0.0
19614,132,7,132,37,5,2,20.0,58.05
19615,696,12,696,61,12,0,7.142857142857143,47.15
19616,216,48,192,86,32,16,4.0,60.28
19617,276,16,276,45,14,2,11.11111111111111,55.25
19618,420,13,420,144,7,6,33.333333333333336,63.93
19619,348,1,348,132,1,0,33.333333333333336,98.0
19620,7464,23,7464,388,21,2,5.555555555555555,72.14
19621,780,5,780,136,5,0,16.666666666666668,89.13
19622,7389540,85,0,87767,34,51,14.285714285714286,0.0
19623,70680,80,0,2360,32,48,14.285714285714286,2.0
19624,395472,617,0,9427,375,242,1.4492753623188406,0.0
19625,7484736,2570,0,94646,1393,1177,1.0,0.0
19626,86508,53,86508,2866,51,2,1.96078431372549,20.79
19627,864,12,0,312,10,2,50.0,99.0
19628,1056,20,792,198,15,5,7.6923076923076925,55.81
19629,5582112,69,0,245739,50,19,50.0,0.0
19630,9396,21,9396,376,21,0,5.2631578947368425,75.49
19631,7464372,1077,0,77193,607,470,1.0309278350515465,0.0
19632,3564,16,0,411,14,2,50.0,95.0
19633,24300,45,0,3014,36,9,100.0,0.0
19634,8880612,170,0,490902,69,101,4.166666666666667,0.0
19635,276,16,276,21,14,2,7.142857142857143,39.71
19636,6828,7,0,1868,5,2,100.0,0.0
19637,12384,13,12384,1006,13,0,6.666666666666667,69.49
19638,756,16,756,146,10,6,16.666666666666668,64.69
19639,171216,8,171216,771,7,1,12.5,87.4
19640,300,0,300,0,0,0,50.0,59.29
19641,2530284,74,2530284,506,30,44,16.666666666666668,85.3
19642,1204992,0,1204992,0,0,0,100.0,100.0
19643,252,11,192,77,8,3,14.285714285714286,57.63
19644,528,10,252,97,8,2,14.285714285714286,51.01
19645,612,27,0,84,20,7,100.0,0.0
19646,26184,143,0,7532,96,47,50.0,0.0
19647,8294736,631,0,172059,345,286,1.492537313432836,0.0
19648,7329204,149,0,115904,67,82,6.666666666666667,4.0
19649,2520,2,2520,378,1,1,50.0,58.66
19650,2040,32,0,789,28,4,50.0,97.46
19651,2602728,253,0,23450,128,125,2.9411764705882355,0.0
19652,7668,32,0,2125,26,6,100.0,0.0
19653,1992,0,1992,0,0,0,50.0,96.19
19654,1320,14,1320,214,14,0,6.25,86.61
19655,7967580,142,0,118776,83,59,4.3478260869565215,0.0
19656,196524,65,0,5124,52,13,12.5,8.13
19657,6749952,356,0,694226,166,190,2.702702702702702,0.0
19658,4464,23,4464,70,14,9,14.285714285714286,62.49
19659,2527404,221,2527404,36763,121,100,4.166666666666667,0.0
19660,8899284,2657,19392,181281,1617,1040,1.0,0.0
19661,2499216,135,2499216,898,68,67,5.0,88.15
19662,240,2,240,96,1,1,50.0,79.28
19663,88296,30,0,84941,25,5,50.0,0.0
19664,564,9,0,378,8,1,50.0,0.0
19665,669360,40,0,69098,22,18,12.5,0.0
19666,372,1,372,228,1,0,50.0,86.99
19667,3648492,235,0,34958,125,110,4.0,2.96
19668,71736,15,0,4967,10,5,100.0,100.0
19669,120,6,120,58,6,0,12.5,51.7
19670,164592,72,164592,4401,66,6,1.5384615384615383,42.53
19671,1476,13,1476,129,13,0,8.333333333333334,81.17
19672,8155548,91,0,120275,43,48,7.6923076923076925,0.0
19673,158808,32,158808,1420,28,4,3.571428571428572,17.53
19674,336744,312,336744,234,206,106,1.0,5.09
19675,864,128,432,138,99,29,1.2820512820512822,0.0
19676,8199168,382,0,69811,200,182,2.380952380952381,0.0
19677,108,3,108,36,2,1,33.333333333333336,70.08
19678,8190372,303,8190360,27190,124,179,4.761904761904762,0.0
19679,504,62,0,203,32,30,50.0,0.0
19680,588,42,588,280,28,14,4.3478260869565215,58.82
19681,89652,87,89652,5738,55,32,16.666666666666668,99.94
19682,276,12,276,81,8,4,20.0,92.16
19683,1272,4,1272,411,4,0,16.666666666666668,60.47
19684,336,15,336,68,15,0,5.882352941176471,51.79
19685,432,74,432,106,40,34,5.555555555555555,92.55
19686,59064,0,59064,0,0,0,100.0,100.0
19687,6460932,425,0,35513,248,177,1.5625,0.0
19688,295644,146,295644,439,119,27,1.0,33.93
19689,2760,90,0,972,59,31,50.0,0.0
19690,1862040,313,0,20568,167,146,3.703703703703704,0.0
19691,1056,7,1056,378,3,4,50.0,87.58
19692,27792,49,27792,57,49,0,1.96078431372549,54.86
19693,8835504,109,0,777940,61,48,11.11111111111111,0.0
19694,4063488,663,1390204,12429,495,168,1.0,34.04
19695,360,6,300,84,4,2,20.0,59.34
19696,144,1,144,0,1,0,33.333333333333336,79.22
19697,528,10,0,373,8,2,50.0,0.0
19698,720,10,720,8,9,1,10.0,61.81
19699,84,16,84,6,16,0,5.555555555555555,48.01
19700,72,6,72,40,5,1,20.0,90.55
19701,7056,24,7056,230,14,10,16.666666666666668,58.16
19702,9160476,15264,0,2960814,9593,5671,1.0,0.0
19703,1464,1,1464,384,1,0,33.333333333333336,79.92
19704,399348,3,300,133276,3,0,25.0,78.48
19705,228,87,228,33,61,26,2.0,25.95
19706,240,0,240,0,0,0,50.0,72.25
19707,7488,36,96,548,28,8,3.571428571428572,48.54
19708,6165864,298,0,98147,141,157,2.5641025641025643,0.0
19709,312,18,0,66,12,6,50.0,0.0
19710,2448,10,2448,44,8,2,12.5,65.53
19711,8940,55,0,1346,36,19,50.0,0.0
19712,14388,60,0,2752,49,11,50.0,0.0
19713,120,0,120,0,0,0,50.0,65.8
19714,216,0,216,0,0,0,50.0,61.62
19715,66252,204,40176,540,122,82,1.0638297872340423,17.76
19716,72,0,72,0,0,0,50.0,80.0
19717,112956,122,0,6794,81,41,100.0,0.0
19718,3444,1,3444,852,1,0,33.333333333333336,88.74
19719,34272,19,34272,1519,19,0,5.0,41.22
19720,7657596,424,7657596,45361,207,217,2.272727272727273,78.16
19721,660,6,660,300,4,2,25.0,67.37
19722,342876,0,342876,0,0,0,50.0,80.0
19723,3261564,32,0,852485,18,14,25.0,0.0
19724,180,24,180,64,20,4,5.555555555555555,26.38
19725,56856,98,0,1717,63,35,100.0,0.0
19726,924,25,924,440,25,0,5.0,77.75
19727,396,3,0,208,1,2,50.0,0.0
19728,588,15,588,315,11,4,9.090909090909092,92.12
19729,9168276,10474,0,2043733,6076,4398,1.0,0.0
19730,744,11,48,147,9,2,12.5,78.6
19731,1068,7,384,360,4,3,33.333333333333336,59.44
19732,6253056,320,0,63579,177,143,2.9411764705882355,0.0
19733,8580,4,8580,807,3,1,50.0,88.32
19734,888,5,888,0,5,0,14.285714285714286,69.19
19735,12588,9,108,2213,5,4,20.0,61.67
19736,9167592,5395,0,1616249,3189,2206,1.0,0.0
19737,3228,290,1284,719,158,132,2.9411764705882355,44.1
19738,264,21,264,30,15,6,10.0,82.45
19739,2484612,99,2484612,2504,47,52,4.166666666666667,70.85
19740,1248,275,1248,172,151,124,1.0,36.53
19741,1812,12,1812,427,8,4,12.5,71.36
19742,30792,31,30792,1213,17,14,25.0,83.23
19743,20064,119,19764,512,62,57,3.333333333333333,79.14
19744,372,1,372,0,1,0,33.333333333333336,70.55
19745,168,2,168,54,1,1,50.0,79.28
19746,8031108,582,0,162251,326,256,1.0638297872340423,0.0
19747,3432,3,3432,160,2,1,33.333333333333336,57.17
19748,11532,2,11532,1854,2,0,100.0,100.0
19749,250032,36,250032,4044,32,4,3.125,34.65
19750,3600,71,0,409,62,9,100.0,0.0
19751,720,2,720,312,2,0,50.0,66.84
19752,1752,55,1752,272,51,4,2.3255813953488373,68.13
19753,576,90,576,172,44,46,4.545454545454546,68.47
19754,7944,29,7944,232,21,8,5.882352941176471,48.84
19755,984,13,984,86,9,4,12.5,78.17
19756,228,26,228,110,15,11,12.5,62.35
19757,64488,109,0,1054,77,32,50.0,0.0
19758,53928,189,0,1752,131,58,100.0,0.0
19759,2467536,60,2467536,6767,14,46,2.5,57.53
19760,8435160,30,0,307288,14,16,4.761904761904762,2.5
19761,9061692,1104,1166784,4161983,513,591,1.0,0.2
19762,14136,51,0,1479,35,16,100.0,0.0
19763,9792,29,9792,4322,21,8,5.882352941176471,72.15
19764,72228,5,192,14541,4,1,20.0,72.84
19765,3048,29,0,543,15,14,33.333333333333336,0.0
19766,9055896,344,0,2277350,185,159,4.166666666666667,0.0
19767,6656424,412,6656424,42387,204,208,1.851851851851852,75.24
19768,91428,21,0,6037,15,6,100.0,100.0
19769,3432,154,0,1365,88,66,50.0,0.0
19770,8113356,215,0,72681,87,128,3.225806451612903,0.0
19771,6129384,722,4726368,81664,278,444,1.851851851851852,9.9
19772,2660148,241,2660148,8122,115,126,4.166666666666667,87.84
19773,15588,4,15588,255,3,1,25.0,58.33
19774,660,110,660,131,104,6,1.4285714285714286,77.83
19775,7900044,37,7900044,5956,21,16,16.666666666666668,31.64
19776,1245948,206,0,26460,126,80,2.272727272727273,0.0
19777,2604,2,2604,0,2,0,20.0,75.16
19778,9072,4,9072,3618,4,0,3.8461538461538463,47.51
19779,8119584,65,0,452909,32,33,6.666666666666667,0.0
19780,156,1,156,36,1,0,50.0,97.57
19781,504,15,504,132,8,7,25.0,92.03
19782,9143412,4437,4207122,1999899,2479,1958,1.0,0.0
19783,6482964,237,0,151572,115,122,3.225806451612903,0.0
19784,1560,1,1560,336,1,0,50.0,95.0
19785,1068,6,1068,366,6,0,14.285714285714286,64.07
19786,8335668,410,0,58923,218,192,2.272727272727273,3.5
19787,7210380,644,0,30307,310,334,1.5151515151515151,0.0
19788,1020,37,1020,146,31,6,3.333333333333333,51.82
19789,2280,55,0,945,52,3,100.0,0.0
19790,8330496,1099,0,88409,569,530,1.3333333333333333,5.83
19791,516,27,516,438,17,10,7.142857142857143,81.26
19792,214812,308,0,3855,194,114,1.098901098901099,0.0
19793,240,19,240,48,12,7,14.285714285714286,50.76
19794,300,4,300,21,4,0,20.0,59.96
19795,1692,72,1692,1462,61,11,1.7543859649122806,65.85
19796,216,60,216,53,52,8,3.225806451612903,38.94
19797,7760604,133,7760604,127078,56,77,6.25,81.91
19798,8218464,183,6429456,2876,137,46,1.0,24.8
19799,6548616,91,0,89005,38,53,5.882352941176471,0.0
19800,84,10,84,18,8,2,11.11111111111111,79.52
19801,888,3,888,88,3,0,25.0,99.6
19802,144,1,144,0,1,0,33.333333333333336,67.17
19803,3436080,110,3436080,271,47,63,8.333333333333334,83.14
19804,252,2,252,60,1,1,50.0,58.66
19805,6489492,128,0,101759,57,71,5.2631578947368425,0.0
19806,276,24,276,57,23,1,4.166666666666667,50.44
19807,408,5,408,84,3,2,50.0,99.51
19808,7692,28,7692,1179,28,0,4.166666666666667,12.97
19809,1019628,13,1019628,506170,13,0,7.142857142857143,71.85
19810,8713764,178,0,153948,93,85,5.0,0.0
19811,191352,193,0,6200,124,69,100.0,0.0
19812,1380,16,1380,1104,16,0,5.882352941176471,85.54
19813,6492156,134,0,49266,57,77,12.5,5.0
19814,456,42,156,70,25,17,9.090909090909092,54.16
19815,432,93,0,71,51,42,3.225806451612903,0.0
19816,756,99,0,115,53,46,100.0,0.0
19817,252,5,252,50,3,2,100.0,100.0
19818,9097860,5890,2140260,803048,3370,2520,1.0,0.0
19819,6494520,187,0,35885,88,99,5.882352941176471,0.0
19820,10140,70,0,1472,47,23,100.0,100.0
19821,194568,14,0,14389,8,6,100.0,0.0
19822,312,57,312,68,33,24,4.761904761904762,77.01
19823,6468,7,6468,169,6,1,14.285714285714286,64.94
19824,1524,20,1524,525,20,0,4.545454545454546,67.02
19825,6553908,236,0,62837,114,122,10.0,0.0
19826,215568,104,0,5710,40,64,11.11111111111111,0.0
19827,20376,26,20376,14479,22,4,5.0,59.34
19828,9087096,13755,191323,477914,7717,6038,1.0,0.0
19829,6896256,509,0,64772,280,229,1.639344262295082,5.0
19830,468,82,468,183,43,39,4.3478260869565215,57.83
19831,15288,3778,15288,3230,2304,1474,1.0,0.0
19832,120,21,120,14,16,5,7.6923076923076925,41.43
19833,1080,24,192,115,17,7,7.6923076923076925,43.84
19834,804,0,804,0,0,0,100.0,100.0
19835,6503460,126,0,54054,53,73,9.090909090909092,0.0
19836,6546240,202,0,106426,98,104,3.8461538461538463,6.31
19837,518088,108,0,5450,76,32,50.0,0.0
19838,600,63,0,167,31,32,33.333333333333336,0.0
19839,84,7,84,37,5,2,20.0,52.27
19840,168,7,168,22,4,3,33.333333333333336,75.88
19841,7751400,1688,831816,45862,966,722,1.0,0.0
19842,6924480,234,0,33829,117,117,3.333333333333333,0.0
19843,4724076,49,1749938,1291308,8,41,12.5,0.0
19844,17400,62,17400,6171,62,0,1.2195121951219512,30.71
19845,375516,8,375516,85963,8,0,100.0,100.0
19846,1608,4,1608,453,4,0,25.0,85.82
19847,348,49,348,95,30,19,5.0,57.02
19848,7855596,331,7855596,166929,145,186,4.761904761904762,90.24
19849,9204060,35954,6639558,6396590,23224,12730,1.0,0.0
19850,6508164,444,0,64325,236,208,1.8867924528301887,0.0
19851,7008,10,7008,548,10,0,10.0,20.53
19852,30876,117,0,1256,75,42,100.0,0.0
19853,30504,138,0,1549,97,41,100.0,0.0
19854,255936,5,146358,24828,5,0,14.285714285714286,32.3
19855,2088,0,2088,0,0,0,100.0,100.0
19856,15624,22,15624,656,21,1,5.2631578947368425,66.82
19857,10524,4,10524,2340,4,0,33.333333333333336,99.63
19858,28476,86,0,3552,51,35,100.0,0.0
19859,91068,20,91068,234,19,1,5.2631578947368425,64.66
19860,9816,16,9816,1656,15,1,7.6923076923076925,59.44
19861,8796,74,0,4422,49,25,50.0,0.0
19862,92556,16,92556,16460,16,0,6.666666666666667,83.13
19863,9128292,9124,993708,2249016,4802,4322,1.0,0.0
19864,492,3,492,112,3,0,20.0,59.32
19865,68748,52,0,4171,43,9,100.0,0.0
19866,13140,20,13140,403,20,0,5.2631578947368425,77.65
19867,9185400,384,0,532164,216,168,2.0408163265306123,0.0
19868,52332,117,21628,2166,69,48,100.0,100.0
19869,83172,10,0,9478,8,2,50.0,0.0
19870,2664,7,2664,618,2,5,20.0,71.21
19871,1090392,82,4524,13837,69,13,1.5873015873015872,30.8
19872,2696988,15,2696988,15800,7,8,16.666666666666668,0.0
19873,304680,11,0,28659,7,4,16.666666666666668,0.0
19874,540,25,540,166,21,4,5.2631578947368425,53.14
19875,254796,46,254796,47737,43,3,3.125,30.38
19876,8148,20,8148,870,17,3,50.0,0.0
19877,8592,14,8220,2304,8,6,33.333333333333336,0.0
19878,5677236,80,0,72824,43,37,12.5,0.0
19879,280728,9,280728,413,8,1,14.285714285714286,67.64
19880,5940,4,0,2541,3,1,50.0,0.0
19881,5912316,112,0,66650,50,62,8.333333333333334,0.0
19882,7423296,24,7092,310333,21,3,5.555555555555555,75.44
19883,3769020,6,0,770392,1,5,1.2658227848101269,10.85
19884,732,7,468,216,5,2,33.333333333333336,98.34
19885,536796,11,536796,49171,7,4,20.0,92.85
19886,62532,71,1500,4022,57,14,7.142857142857143,1.54
19887,2220,8,2220,366,8,0,16.666666666666668,58.78
19888,13608,23,11220,1127,22,1,4.761904761904762,74.48
19889,52944,235,52944,246,145,90,1.0,13.87
19890,43104,5,43104,8976,3,2,33.333333333333336,97.8
19891,312,0,312,0,0,0,100.0,100.0
19892,187140,27,187140,22186,27,0,4.166666666666667,59.29
19893,6744,41,0,2022,34,7,100.0,0.0
19894,21912,23,8616,2298,21,2,5.555555555555555,81.1
19895,8449104,2044,0,103858,1226,818,1.0,0.0
19896,82560,62,82560,3659,59,3,1.7241379310344829,17.61
19897,2709096,36,2709096,615,14,22,12.5,0.0
19898,23736,114,0,1271,52,62,7.142857142857143,0.0
19899,3263220,25,8124,140028,22,3,5.555555555555555,73.87
19900,696,34,696,132,26,8,5.0,44.3
19901,6552,137,0,224,89,48,1.9230769230769231,6.89
19902,2856348,87,2856348,29441,49,38,1.1235955056179776,0.0
19903,5184,24,5184,315,22,2,5.2631578947368425,77.17
19904,528,15,480,112,13,2,7.6923076923076925,52.91
19905,1980,2,1980,1356,2,0,25.0,62.44
19906,63216,231,0,4522,158,73,100.0,0.0
19907,396,3,396,68,2,1,33.333333333333336,71.58
19908,55728,15,55728,1517,10,5,14.285714285714286,96.24
19909,204,37,204,66,19,18,8.333333333333334,93.92
19910,2662584,34,2662584,5076,24,10,4.545454545454546,70.4
19911,6924,44,0,1856,36,8,100.0,0.0
19912,7696056,383,0,92773,194,189,3.225806451612903,4.5
19913,2615676,131,2615676,949,64,67,3.333333333333333,62.7
19914,8715348,104,0,1603454,33,71,1.5384615384615383,0.0
19915,189384,178,0,10198,95,83,7.142857142857143,0.0
19916,2430840,73,2430840,716,29,44,12.5,93.74
19917,8578836,839,0,361045,473,366,1.8867924528301887,0.0
19918,2244,41,0,906,36,5,50.0,99.98
19919,6324,5,6324,1500,3,2,12.5,85.53
19920,7374528,114,7374528,11300,50,64,12.5,88.48
19921,46884,13,46884,18299,8,5,14.285714285714286,94.69
19922,3060,151,3060,660,82,69,50.0,99.94
19923,7644,82,2964,3643,72,10,2.0408163265306123,0.0
19924,2433312,58,2433312,26963,32,26,5.0,80.73
19925,2616,81,432,173,39,42,5.555555555555555,74.14
19926,240,1,240,36,1,0,50.0,98.34
19927,9864,172,0,4594,105,67,50.0,0.0
19928,13872,84,0,2236,65,19,7.142857142857143,0.0
19929,72684,184,72684,204,120,64,1.0,21.84
19930,929820,66,72,83765,46,20,2.4390243902439024,32.26
19931,216,12,216,50,12,0,7.142857142857143,70.56
19932,192,23,192,62,16,7,9.090909090909092,42.91
19933,636,20,252,69,14,6,9.090909090909092,72.82
19934,30768,82,0,821,50,32,33.333333333333336,0.0
19935,4884,50,0,766,38,12,50.0,0.0
19936,6668316,228,0,59953,113,115,4.761904761904762,4.0
19937,6540024,107,0,91860,41,66,14.285714285714286,0.0
19938,168,14,168,24,10,4,11.11111111111111,40.0
19939,72,0,72,0,0,0,100.0,100.0
19940,31824,113,0,1328,85,28,100.0,0.0
19941,7248,208,7248,982,116,92,4.761904761904762,99.1
19942,8982996,2126,0,56236,1178,948,1.0,0.0
19943,6408,232,0,191,136,96,50.0,0.0
19944,7896,50,0,2016,39,11,100.0,0.0
19945,132,62,132,45,31,31,6.25,81.14
19946,6493788,354,0,39532,205,149,2.3255813953488373,0.0
19947,8651592,1538,0,153150,864,674,1.0,0.0
19948,84012,8,84012,159,6,2,14.285714285714286,85.3
19949,1116,81,1116,730,71,10,1.492537313432836,28.33
19950,1140,61,1140,92,32,29,5.555555555555555,79.53
19951,2724,11,0,512,8,3,12.5,0.0
19952,96156,379,0,4599,194,185,2.9411764705882355,1.2
19953,3696,70,0,929,57,13,100.0,0.0
19954,228,48,228,9,40,8,2.631578947368421,38.15
19955,76020,88,76020,2852,70,18,1.5873015873015872,46.59
19956,77640,70,77640,70,62,8,1.639344262295082,36.57
19957,958764,24,958764,81,20,4,5.555555555555555,53.88
19958,37212,127,0,1393,79,48,50.0,0.0
19959,720,30,0,534,26,4,100.0,0.0
19960,116112,176,116112,106,100,76,1.3333333333333333,34.02
19961,396,34,396,49,26,8,4.166666666666667,56.61
19962,1476,2,1476,912,2,0,25.0,79.84
19963,252,0,252,0,0,0,100.0,100.0
19964,9161868,8236,0,1936362,4939,3297,1.0,0.0
19965,864,74,864,202,70,4,1.818181818181818,64.77
19966,83916,264,83916,668,166,98,1.0,10.15
19967,3911376,85,0,52968,41,44,8.333333333333334,4.0
19968,156,29,156,40,20,9,6.25,50.95
19969,8748,18,8748,728,18,0,5.555555555555555,49.66
19970,2632680,70,1984320,10946,36,34,16.666666666666668,98.61
19971,396,13,396,63,13,0,6.666666666666667,87.23
19972,156,4,156,45,2,2,50.0,59.68
19973,9206700,5412,2279676,689898,3177,2235,1.0,0.0
19974,180,22,180,52,15,7,11.11111111111111,92.52
19975,504,45,504,94,40,5,3.8461538461538463,82.54
19976,60,13,60,24,9,4,11.11111111111111,64.81
19977,2628,29,0,133,17,12,100.0,0.0
19978,9218952,550,0,74981,291,259,1.7543859649122806,0.5
19979,71508,88,71508,2670,69,19,1.9230769230769231,5.88
19980,72,12,72,14,7,5,20.0,99.05
19981,1596,8,1596,61,8,0,11.11111111111111,99.44
19982,144,0,144,0,0,0,100.0,100.0
19983,1260,10,0,536,9,1,100.0,0.0
19984,12816,137,648,219,106,31,1.2820512820512822,31.23
19985,6684924,364,0,69813,164,200,2.857142857142857,0.0
19986,132,30,132,50,23,7,5.555555555555555,48.78
19987,468,107,144,58,76,31,1.96078431372549,59.31
19988,804,1,804,540,1,0,50.0,99.47
19989,4848,9,4848,1026,7,2,20.0,97.14
19990,444,6,336,114,5,1,25.0,94.23
19991,5463264,594,4782108,21354,331,263,2.0,90.27
19992,1164,22,1164,67,16,6,9.090909090909092,71.94
19993,300,14,0,180,9,5,16.666666666666668,0.0
19994,6559920,75,0,94371,31,44,9.090909090909092,0.0
19995,7570152,1475,660,65145,966,509,1.0,17.51
19996,288,24,84,62,17,7,7.6923076923076925,65.09
19997,8002224,564,0,61245,297,267,1.6666666666666667,2.5
19998,252,17,0,68,11,6,50.0,0.0
19999,720,97,720,171,88,9,1.6129032258064515,64.03
20000,432,0,432,0,0,0,50.0,70.13
20001,968208,103,0,77363,27,76,3.333333333333333,0.0
20002,4212,9,4212,1066,6,3,50.0,99.78
20003,360,183,324,193,145,38,1.0,35.57
20004,6565452,178,0,71699,85,93,5.0,0.0
20005,3514668,32,3514668,8190,12,20,16.666666666666668,85.49
20006,9264300,6790,9250560,2726077,4283,2507,1.0,0.0
20007,1740,7,720,759,6,1,20.0,79.77
20008,7966716,358,2293092,164641,194,164,4.545454545454546,5.0
20009,2532,65,1308,1040,58,7,1.7543859649122806,0.0
20010,138960,67,138960,7970,61,6,1.6666666666666667,23.64
20011,2482872,19,2482872,87851,13,6,11.11111111111111,72.4
20012,102720,156,102720,328,124,32,1.0,13.45
20013,55500,3,55500,0,3,0,25.0,94.0
20014,714576,12,714576,1375,5,7,25.0,96.62
20015,3734484,197,0,606031,100,97,3.8461538461538463,0.0
20016,792,26,792,168,24,2,4.0,79.48
20017,468,2,468,270,2,0,50.0,99.33
20018,8978304,33,0,274001,28,5,25.0,0.0
20019,47496,30,0,2000,17,13,50.0,0.0
20020,8790372,2250,155664,362680,1300,950,1.0,0.0
20021,132,10,132,2,10,0,8.333333333333334,48.67
20022,252,11,252,113,7,4,20.0,58.28
20023,492,4,492,264,3,1,25.0,96.66
20024,132,26,132,27,20,6,6.25,67.66
20025,8303304,167,3813360,244345,89,78,3.571428571428572,73.27
20026,192,24,192,99,15,9,14.285714285714286,90.11
20027,4332,14,4332,4153,12,2,8.333333333333334,73.21
20028,10140,14,10140,4176,14,0,8.333333333333334,7.22
20029,59136,5,59136,400,4,1,25.0,98.36
20030,732,122,732,232,73,49,2.702702702702702,62.34
20031,53880,195,53880,343,152,43,1.0,24.31
20032,1752,55,1752,1289,35,20,4.0,58.38
20033,9223152,650,0,183127,327,323,1.25,0.0
20034,6847512,51,39468,134450,37,14,3.125,12.81
20035,3828,106,3828,3176,64,42,4.761904761904762,66.0
20036,2692332,193,2556132,5086,142,51,1.0,35.47
20037,216,52,216,107,26,26,7.142857142857143,68.23
20038,1752,6,0,352,3,3,100.0,0.0
20039,6573204,168,0,81024,73,95,9.090909090909092,4.0
20040,624,16,624,465,6,10,33.333333333333336,83.08
20041,348,90,120,74,86,4,1.2195121951219512,28.43
20042,192,20,192,9,18,2,5.555555555555555,54.81
20043,3888,108,3888,2383,74,34,1.9230769230769231,65.94
20044,142416,54,142416,14823,27,27,7.6923076923076925,84.61
20045,6131880,744,6131880,15785,415,329,1.0,66.88
20046,99528,43,99528,2402,39,4,2.5641025641025643,28.66
20047,12216,96,12216,96,56,40,2.380952380952381,37.3
20048,67464,1,67464,108,1,0,12.5,49.9
20049,15336,1,15336,744,1,0,50.0,99.92
20050,1572,38,1572,59,34,4,2.9411764705882355,45.6
20051,1756116,4,1756116,1638,3,1,1.0,13.26
20052,6748032,127,0,62215,60,67,4.761904761904762,0.0
20053,6579660,791,0,137116,357,434,1.4492753623188406,0.0
20054,540,47,528,500,41,6,2.5641025641025643,43.38
20055,1464,14,1464,791,12,2,11.11111111111111,0.0
20056,5227344,124,0,90653,60,64,10.0,0.0
20057,396,21,396,79,15,6,6.666666666666667,51.57
20058,9082200,9272,2121924,764086,5145,4127,1.0,0.4
20059,204,8,204,27,8,0,10.0,53.3
20060,9042216,1090,6566904,53470,620,470,1.0,0.0
20061,2184,0,2184,0,0,0,100.0,100.0
20062,8792940,1024,0,120191,637,387,1.0,0.0
20063,2515032,502,2515032,32458,247,255,1.7241379310344829,60.31
20064,8642496,212,0,142034,108,104,3.703703703703704,0.0
20065,39396,344,19944,2049,194,150,100.0,0.0
20066,362640,556,362640,323112,489,67,1.0,39.53
20067,3948,28,2478,1438,16,12,25.0,0.0
20068,5940,2,0,3246,1,1,100.0,0.0
20069,7413132,341,0,112638,176,165,3.125,0.0
20070,50508,41,0,2101,33,8,6.25,7.16
20071,6712092,548,0,114019,304,244,1.7241379310344829,0.0
20072,10524,15,10524,1904,15,0,3.8461538461538463,0.85
20073,3276,99,0,635,49,50,11.11111111111111,0.0
20074,6111732,413,30864,53464,226,187,3.125,0.0
20075,507588,92,507558,15756,70,22,100.0,0.0
20076,19824,61,0,952,45,16,100.0,0.0
20077,45936,307,45936,411,190,117,1.0,19.94
20078,83064,17,83064,1160,16,1,10.0,86.65
20079,31668,23,31668,1717,22,1,5.2631578947368425,64.9
20080,164112,0,164112,0,0,0,100.0,100.0
20081,5256,76,0,640,54,22,50.0,0.0
20082,498540,48,498540,7558,37,11,2.631578947368421,8.37
20083,3696,7,3696,1959,2,5,100.0,0.0
20084,528,9,528,129,5,4,20.0,90.68
20085,2074896,29,1716,71827,26,3,3.8461538461538463,60.0
20086,68688,67,68688,7495,60,7,1.6666666666666667,18.5
20087,288,31,264,58,23,8,5.0,55.76
20088,12228,25,12228,311,15,10,11.11111111111111,0.45
20089,5797596,51,0,115791,41,10,50.0,0.0
20090,101484,837,0,6796,532,305,100.0,0.0
20091,2225628,126,0,149144,60,66,9.090909090909092,0.0
20092,108,36,108,31,25,11,5.882352941176471,45.01
20093,14136,44,14136,3648,36,8,20.0,67.32
20094,5617944,86,5617944,387,49,37,3.703703703703704,64.09
20095,4649208,802,0,32060,494,308,1.0,0.0
20096,2532,3,2532,312,1,2,50.0,93.43
20097,360,29,360,57,18,11,11.11111111111111,42.61
20098,264,8,264,108,6,2,20.0,94.01
20099,29424,60,29424,3174,50,10,2.4390243902439024,27.06
20100,741672,110,591060,158951,71,39,4.166666666666667,94.69
20101,5526276,349,0,154261,198,151,1.96078431372549,0.0
20102,864,26,864,73,19,7,7.142857142857143,41.65
20103,8050260,246,0,1106301,139,107,2.272727272727273,0.0
20104,456,14,456,106,10,4,10.0,90.18
20105,6764988,230,0,60053,109,121,6.666666666666667,0.0
20106,6837852,317,81912,55442,160,157,2.702702702702702,0.0
20107,324,20,324,82,11,9,100.0,0.0
20108,84,53,72,26,43,10,2.5641025641025643,26.37
20109,816,107,0,227,65,42,100.0,0.0
20110,7961112,443,0,298278,226,217,2.7777777777777777,2.55
20111,504,78,504,154,42,36,4.3478260869565215,68.85
20112,352464,148,0,15149,68,80,3.225806451612903,0.0
20113,1260768,139,0,9327,64,75,5.0,0.0
20114,144,17,144,29,12,5,11.11111111111111,51.7
20115,8280780,358,0,154100,197,161,3.571428571428572,0.0
20116,338148,48,338148,497,42,6,3.125,36.61
20117,4716,8,4716,3099,8,0,14.285714285714286,96.0
20118,6817920,990,0,44511,583,407,1.0,0.0
20119,3093780,1,3093780,2892,1,0,14.285714285714286,0.0
20120,1248,0,1248,0,0,0,100.0,100.0
20121,2712,17,0,518,15,2,50.0,0.0
20122,612,21,612,330,14,7,10.0,84.59
20123,144,48,144,12,41,7,2.5641025641025643,32.14
20124,170292,49,0,4909,40,9,50.0,0.0
20125,4570416,432,0,43392,203,229,1.9230769230769231,0.08
20126,2940,14,2940,220,12,2,9.090909090909092,55.14
20127,13188,26,13188,1994,26,0,3.703703703703704,0.67
20128,79080,45,0,4031,36,9,100.0,0.0
20129,2100,76,0,979,54,22,50.0,0.0
20130,20172,52,0,2044,43,9,16.666666666666668,12.92
20131,531276,278,531276,144,199,79,1.0,19.6
20132,228,35,228,31,25,10,4.545454545454546,61.34
20133,5544,15,0,788,12,3,100.0,100.0
20134,4394904,296,0,91250,144,152,5.0,0.0
20135,384,2,384,114,1,1,50.0,63.42
20136,5607156,298,0,21691,150,148,4.545454545454546,5.0
20137,60,6,60,24,4,2,20.0,59.16
20138,72,15,72,29,9,6,20.0,52.03
20139,396,1,396,240,1,0,50.0,96.0
20140,336096,54,0,49026,40,14,100.0,0.0
20141,106140,116,0,3938,54,62,4.166666666666667,0.0
20142,8310852,580,0,287067,321,259,1.851851851851852,0.0
20143,96864,7,96864,1861,6,1,25.0,68.18
20144,96,8,96,33,8,0,10.0,46.79
20145,422100,86,421836,120812,73,13,1.5873015873015872,36.74
20146,8574948,52,0,203511,40,12,50.0,0.0
20147,2772,21,0,514,18,3,50.0,99.9
20148,6600,146,6600,706,90,56,3.4482758620689653,81.73
20149,629904,289,629904,351,205,84,1.0,16.68
20150,8113608,169,0,393349,75,94,10.0,4.75
20151,25128,4,25128,393,4,0,20.0,93.89
20152,255360,7,255360,33714,4,3,6.25,4.45
20153,1068,0,1068,0,0,0,50.0,62.19
20154,3564,10,3564,531,9,1,14.285714285714286,62.02
20155,331104,39,0,9488,25,14,100.0,0.0
20156,9104892,3579,0,535868,1938,1641,1.0,0.0
20157,96,24,96,32,20,4,5.2631578947368425,51.06
20158,468,39,468,173,37,2,3.571428571428572,67.1
20159,7254744,9,0,1611881,6,3,25.0,0.0
20160,7960224,792,0,104891,434,358,2.272727272727273,5.0
20161,7461264,124,7461264,223806,53,71,9.090909090909092,87.11
20162,8367948,380,0,72914,226,154,1.5384615384615383,0.0
20163,3684,21,0,609,17,4,50.0,99.0
20164,288,26,72,63,17,9,6.25,53.81
20165,6876,52,0,1721,41,11,100.0,0.0
20166,523740,71,0,46085,57,14,50.0,0.0
20167,4512,15,0,1043,12,3,100.0,100.0
20168,7104348,493,0,1287190,245,248,5.2631578947368425,4.75
20169,64608,145,0,5760,83,62,7.142857142857143,0.0
20170,9273660,9778,1182720,1651129,4523,5255,1.0,0.0
20171,117432,47,0,3535,40,7,50.0,0.0
20172,200100,116,96708,17923,92,24,1.5151515151515151,25.11
20173,1332,65,1332,154,59,6,1.818181818181818,74.83
20174,9504,24,9504,119,20,4,5.0,84.06
20175,10092,4,10092,438,2,2,50.0,61.88
20176,9087744,1489,0,86010,804,685,1.0416666666666667,3.67
20177,1176,81,0,321,60,21,50.0,0.0
20178,312,1,312,108,1,0,50.0,98.6
20179,1404,13,1404,671,13,0,6.666666666666667,61.0
20180,2256,18,0,618,16,2,100.0,100.0
20181,336,6,0,96,3,3,50.0,0.0
20182,324,34,0,91,26,8,100.0,0.0
20183,878088,5,878088,17109,4,1,25.0,99.84
20184,109980,11,109980,220,9,2,10.0,96.36
20185,708,150,0,369,134,16,100.0,0.0
20186,672,13,672,85,13,0,6.666666666666667,88.52
20187,2172,51,0,847,43,8,50.0,98.0
20188,262320,14,262320,589,13,1,8.333333333333334,0.0
20189,4008,230,1524,282,221,9,1.0,40.02
20190,1008,7,1008,360,4,3,33.333333333333336,93.05
20191,10596,47,0,1717,40,7,100.0,0.0
20192,228,10,0,85,6,4,50.0,0.0
20193,2688,14,0,461,9,5,100.0,100.0
20194,1392,108,1392,144,72,36,2.083333333333333,53.46
20195,33720,139,0,1648,84,55,50.0,0.0
20196,336,106,336,191,90,16,1.1904761904761905,50.11
20197,2928,136,0,827,102,34,100.0,0.0
20198,1740,22,0,315,22,0,4.3478260869565215,0.0
20199,9327840,593,0,5173344,290,303,1.0,0.0
20200,36828,1,36828,372,1,0,33.333333333333336,99.6
20201,384,9,384,204,9,0,9.090909090909092,98.65
20202,15372,64,408,536,40,24,3.703703703703704,72.77
20203,36720,94,36720,2372,71,23,2.1739130434782608,3.72
20204,8597388,42,0,210739,33,9,50.0,0.0
20205,2593248,26,2593248,488,12,14,33.333333333333336,50.25
20206,9013692,1228,0,1295687,619,609,1.0,0.0
20207,8606580,367,0,236042,195,172,2.702702702702702,0.0
20208,61236,60,0,1590,37,23,50.0,0.0
20209,300,0,300,0,0,0,50.0,64.0
20210,2004,171,1512,368,117,54,1.0638297872340423,25.48
20211,28716,17,0,1740,15,2,50.0,0.0
20212,2376,111,0,818,100,11,50.0,0.0
20213,9333840,3099,2993076,3709423,1715,1384,1.0,2.47
20214,16584,164,16584,413,118,46,1.0416666666666667,27.57
20215,792,55,792,216,55,0,2.7777777777777777,71.17
20216,192,1,192,0,1,0,33.333333333333336,79.0
20217,8959104,1202,2111910,377328,578,624,1.0,0.0
20218,672,152,672,140,96,56,2.127659574468085,58.69
20219,2628132,118,0,41213,53,65,11.11111111111111,0.0
20220,11208,20,0,1263,14,6,100.0,100.0
20221,912,0,912,0,0,0,50.0,60.84
20222,384,11,0,178,6,5,50.0,0.0
20223,912,15,0,580,13,2,50.0,0.0
20224,10092,15,10092,696,14,1,8.333333333333334,0.0
20225,492,113,348,183,85,28,1.36986301369863,46.95
20226,1188,126,1188,251,87,39,1.639344262295082,33.53
20227,54912,290,0,2648,162,128,50.0,0.0
20228,8791824,217,8791824,90488,90,127,7.142857142857143,89.44
20229,756,13,756,454,13,0,7.142857142857143,74.99
20230,8292,14,8292,610,7,7,50.0,58.69
20231,69888,4,0,17472,3,1,20.0,0.0
20232,1092,148,0,99,117,31,1.0,0.0
20233,336,134,336,124,88,46,1.492537313432836,54.3
20234,14652,16,0,1407,11,5,100.0,100.0
20235,34512,144,864,391,138,6,1.0,62.03
20236,10608,106,10608,90,62,44,2.5,35.94
20237,1464,83,1464,800,47,36,3.571428571428572,45.51
20238,6649644,360,0,59456,196,164,3.4482758620689653,0.0
20239,300,63,300,72,49,14,2.380952380952381,0.49
20240,116976,184,0,4422,128,56,100.0,0.0
20241,5545068,309,0,105747,177,132,3.125,0.0
20242,648,6,648,10,5,1,16.666666666666668,55.39
20243,9329832,7156,0,2052969,4222,2934,1.0,0.0
20244,816,14,0,132,11,3,100.0,0.0
20245,588,37,588,408,28,9,5.0,50.81
20246,1668,102,0,543,77,25,100.0,0.0
20247,4256472,3,6012,1489820,2,1,33.333333333333336,88.0
20248,636,43,636,496,35,8,2.857142857142857,48.32
20249,5184,19,0,658,15,4,50.0,0.0
20250,8427648,1961,0,49986,1062,899,1.0,0.0
20251,156,3,156,56,2,1,33.333333333333336,48.78
20252,468,100,468,115,90,10,1.1764705882352942,30.32
20253,9312456,6598,1169892,999497,3897,2701,1.0,0.0
20254,7819500,356,7819500,19734,148,208,2.272727272727273,76.37
20255,76164,5,0,15729,4,1,100.0,0.0
20256,552,28,552,237,25,3,5.0,40.79
20257,88560,33,0,3209,19,14,2.702702702702702,0.0
20258,9032424,2209,0,133735,980,1229,1.0,0.17
20259,504,42,504,176,21,21,7.6923076923076925,79.78
20260,936,72,936,238,61,11,1.7543859649122806,38.69
20261,3288,3,3288,200,2,1,33.333333333333336,89.11
20262,416664,437,0,11197,163,274,2.1739130434782608,0.0
20263,1704,146,0,482,83,63,100.0,0.0
20264,264,15,264,114,15,0,5.882352941176471,43.46
20265,600,45,0,300,28,17,33.333333333333336,50.0
20266,17712,8,17712,462,8,0,10.0,56.0
20267,624,3,624,136,1,2,50.0,89.54
20268,603636,6,603636,331182,6,0,14.285714285714286,84.07
20269,8058120,6014,646992,425520,3573,2441,1.0,0.0
20270,3460752,567,1609998,25785,484,83,1.7241379310344829,90.77
20271,106488,236,106488,151,160,76,1.0,19.62
20272,4248,21,4248,2257,21,0,4.761904761904762,43.68
20273,66132,149,252,649,74,75,3.333333333333333,44.85
20274,4247520,10,37464,426097,10,0,20.0,98.59
20275,142788,68,142788,57,45,23,3.4482758620689653,47.58
20276,1068,17,0,752,15,2,50.0,0.0
20277,7989228,453,0,48910,207,246,1.5625,0.0
20278,3852,8,3852,1135,8,0,14.285714285714286,67.4
20279,480,94,348,122,60,34,2.5641025641025643,39.51
20280,552,34,552,105,27,7,4.545454545454546,38.37
20281,516,11,516,140,9,2,12.5,87.76
20282,9323760,2097,0,126893,1092,1005,1.0,0.01
20283,324,38,120,32,29,9,3.8461538461538463,0.0
20284,7936092,703,0,217909,359,344,1.8867924528301887,1.2
20285,7775412,112,7775412,41231,27,85,16.666666666666668,82.98
20286,7960164,468,0,388924,144,324,1.0526315789473684,0.0
20287,7428,181,0,737,114,67,50.0,0.0
20288,756,1,756,660,1,0,50.0,99.8
20289,4416,7,4416,474,6,1,16.666666666666668,0.84
20290,2184,84,2184,247,62,22,1.851851851851852,69.92
20291,82656,263,0,4285,146,117,3.225806451612903,0.0
20292,5112,12,5112,981,12,0,7.6923076923076925,24.95
20293,744,339,732,261,289,50,1.0,52.77
20294,528,144,528,169,93,51,2.5641025641025643,60.04
20295,2652,20,2652,1222,15,5,16.666666666666668,63.91
20296,6666024,212,0,43494,110,102,2.9411764705882355,0.0
20297,2928,132,84,101,102,30,1.0416666666666667,0.0
20298,96,36,48,34,25,11,6.666666666666667,86.38
20299,6880044,133,0,52829,61,72,9.090909090909092,0.0
20300,432,18,432,8,18,0,5.0,35.27
20301,312,73,240,100,63,10,1.7543859649122806,19.55
20302,336,50,336,41,33,17,5.555555555555555,42.09
20303,8454420,161,8454348,228405,63,98,2.380952380952381,0.0
20304,7508484,749,0,157260,388,361,1.408450704225352,0.0
20305,371688,125,0,42247,78,47,100.0,0.0
20306,7950348,4389,7950348,109104,2483,1906,1.0,60.32
20307,6670860,109,0,246322,42,67,12.5,0.0
20308,2905824,259,0,13388,135,124,2.4390243902439024,2.38
20309,79116,40,79116,12712,36,4,2.7777777777777777,28.31
20310,15672,16,15672,1234,16,0,7.142857142857143,74.1
20311,84,21,84,16,18,3,5.882352941176471,39.81
20312,2787744,303,2787744,6832,162,141,2.272727272727273,68.0
20313,209676,220,209676,228,152,68,1.0,16.81
20314,6804108,333,0,41359,167,166,3.225806451612903,0.0
20315,852,96,852,206,54,42,2.857142857142857,49.19
20316,576,48,576,179,26,22,5.555555555555555,68.93
20317,95472,75,95472,7723,41,34,4.545454545454546,65.69
20318,3124584,540,0,31890,292,248,2.380952380952381,0.0
20319,2486964,52,2486964,740,22,30,7.6923076923076925,68.04
20320,8418036,1761,2414528,563202,904,857,1.0,0.35
20321,213312,230,213312,151,158,72,1.0,16.29
20322,71532,19,71532,617,17,2,6.666666666666667,79.29
20323,5576664,269,0,43329,124,145,2.5,0.0
20324,264,77,228,113,55,22,2.1739130434782608,31.69
20325,3288,79,3288,750,45,34,3.333333333333333,63.77
20326,15252,5,15252,609,3,2,12.5,58.13
20327,17928,140,0,4022,76,64,50.0,0.0
20328,24036,28,24036,1599,26,2,5.2631578947368425,83.57
20329,636,1,636,0,1,0,33.333333333333336,33.32
20330,69384,206,0,4055,141,65,100.0,0.0
20331,1464,19,0,491,18,1,50.0,0.0
20332,372,6,372,138,3,3,50.0,57.41
20333,4768008,241,0,20993,119,122,4.166666666666667,0.0
20334,34068,180,0,2410,109,71,33.333333333333336,0.0
20335,8477460,3296,0,73510,1922,1374,1.0,0.0
20336,8356212,361,0,24412,160,201,2.9411764705882355,0.0
20337,2253516,32,2253516,5904,12,20,25.0,97.68
20338,1140456,48,0,31591,39,9,50.0,0.0
20339,65832,26,0,4627,22,4,100.0,0.0
20340,91656,176,0,1943,108,68,50.0,0.0
20341,71208,23,71208,553,16,7,6.666666666666667,63.67
20342,74496,66,74496,4654,60,6,1.7543859649122806,19.7
20343,2820,17,2820,130,16,1,6.666666666666667,67.21
20344,61296,66,0,4135,54,12,7.6923076923076925,0.0
20345,6668616,374,6668616,441,222,152,1.0,0.0
20346,9360,20,9360,1182,20,0,5.2631578947368425,75.9
20347,108,1,108,0,1,0,33.333333333333336,47.6
20348,1817412,56,1817412,106,44,12,2.9411764705882355,48.5
20349,1452,6,1452,406,5,1,20.0,46.72
20350,4412172,339,0,22251,177,162,2.631578947368421,0.0
20351,6690660,173,0,66283,76,97,4.545454545454546,0.0
20352,17964,18,17964,968,16,2,7.142857142857143,71.44
20353,2064,280,0,457,135,145,4.166666666666667,0.0
20354,6168,159,6168,349,121,38,1.0,21.87
20355,4149240,685,1420860,16159,523,162,1.0,4.89
20356,7262760,794,0,65410,425,369,1.5384615384615383,0.0
20357,7113900,550,0,19224,291,259,1.96078431372549,0.0
20358,2748612,136,2748612,62880,51,85,5.555555555555555,0.0
20359,4380,23,4380,829,22,1,5.0,75.48
20360,72564,13,72564,5778,10,3,20.0,77.1
20361,8556,220,8556,187,156,64,1.0,9.11
20362,2505324,120,2505324,1569,53,67,10.0,93.88
20363,9330996,235,0,1256835,159,76,7.6923076923076925,0.0
20364,179232,460,179232,128236,379,81,1.0,40.51
20365,76524,50,0,3003,35,15,100.0,0.0
20366,6816,7,6816,3937,3,4,25.0,73.75
20367,82320,55,0,15643,45,10,100.0,0.0
20368,192,10,192,88,10,0,9.090909090909092,82.72
20369,6420,27,6420,914,24,3,5.555555555555555,66.72
20370,7412328,1326,0,31059,717,609,1.0,0.0
20371,156,23,156,19,22,1,4.3478260869565215,44.82
20372,588,108,552,175,52,56,5.555555555555555,87.02
20373,6699828,154,0,116016,67,87,6.25,0.0
20374,15420,61,0,2055,48,13,100.0,0.0
20375,1236,7,1236,620,4,3,50.0,94.66
20376,1440,4,1440,174,3,1,25.0,62.29
20377,4908756,228,0,25558,117,111,3.225806451612903,0.0
20378,22440,26,7380,1728,24,2,5.0,64.91
20379,5712,19,0,640,15,4,50.0,99.0
20380,57300,23,57300,7440,22,1,6.666666666666667,0.0
20381,1020,91,516,208,52,39,3.125,58.32
20382,4039644,50,0,159347,42,8,50.0,0.0
20383,142428,0,142428,0,0,0,50.0,81.0
20384,1452,60,0,527,42,18,50.0,0.0
20385,8382348,1332,0,54646,710,622,1.098901098901099,3.39
20386,31176,13,31176,34,9,4,14.285714285714286,65.3
20387,7657128,494,0,61852,248,246,2.7777777777777777,0.0
20388,9359148,1419,3242804,1887920,811,608,1.0,0.0
20389,24840,29,24840,2529,25,4,5.882352941176471,76.67
20390,23904,66,0,5694,44,22,100.0,0.0
20391,312,18,312,103,13,5,10.0,64.07
20392,2292,17,0,438,13,4,100.0,100.0
20393,1212,70,0,336,30,40,50.0,1.96
20394,19164,8,19164,5235,6,2,33.333333333333336,74.79
20395,492,11,492,154,7,4,20.0,52.71
20396,804,24,804,561,20,4,11.11111111111111,71.2
20397,1560,7,0,332,6,1,100.0,0.0
20398,17136,60,0,2086,47,13,14.285714285714286,13.87
20399,6324,37,0,1156,29,8,100.0,0.0
20400,1980,108,0,668,63,45,50.0,0.0
20401,2340984,694,1194408,10641,587,107,1.020408163265306,74.64
20402,9038892,635,192,56633,341,294,1.639344262295082,0.0
20403,5856624,747,0,293465,426,321,1.8867924528301887,0.0
20404,6850740,109,2868,63226,83,26,1.5384615384615383,27.09
20405,195228,15,195228,880,15,0,7.142857142857143,77.94
20406,82704,51,0,3893,44,7,50.0,0.0
20407,5860332,1896,0,27608,1044,852,1.0,1.33
20408,732,39,732,260,37,2,5.2631578947368425,80.68
20409,23676,290,23676,243,181,109,1.0,22.04
20410,3948,34,0,1136,27,7,100.0,0.0
20411,94764,40,0,3336,26,14,100.0,0.0
20412,7004304,563,0,37099,292,271,2.0,0.0
20413,288,5,288,60,4,1,20.0,67.32
20414,108,9,108,32,5,4,33.333333333333336,75.26
20415,57900,14,0,4365,9,5,100.0,100.0
20416,3096,43,3096,202,41,2,3.703703703703704,63.69
20417,732,72,0,592,54,18,50.0,0.0
20418,9187812,3840,875208,549855,2200,1640,1.0,5.0
20419,87960,54,0,5144,45,9,50.0,0.0
20420,705780,12,0,100496,7,5,25.0,0.0
20421,504,23,504,212,23,0,4.0,59.79
20422,1848,7,1848,749,6,1,16.666666666666668,94.18
20423,3420,18,0,626,15,3,100.0,100.0
20424,8160,0,8160,0,0,0,50.0,75.0
20425,768,113,768,189,93,20,1.5873015873015872,26.69
20426,1236,22,1236,606,16,6,11.11111111111111,97.96
20427,600,1,600,24,1,0,33.333333333333336,66.58
20428,852,98,852,30,92,6,1.96078431372549,55.23
20429,2052,51,2052,900,19,32,16.666666666666668,37.91
20430,22464,49,0,2272,34,15,100.0,0.0
20431,8496,6,8496,22,6,0,12.5,68.19
20432,62676,17,0,4012,12,5,100.0,100.0
20433,41460,324,3372,594,204,120,1.5625,44.45
20434,727464,31,727464,11778,20,11,10.0,0.0
20435,564,19,0,254,15,4,50.0,0.0
20436,960,147,0,256,89,58,100.0,0.0
20437,1560,46,0,728,40,6,50.0,99.9
20438,51276,5,51276,139,5,0,16.666666666666668,95.61
20439,5738148,29,0,1363710,11,18,8.333333333333334,0.0
20440,8422560,455,0,49196,231,224,2.3255813953488373,0.0
20441,32652,0,32652,0,0,0,50.0,49.0
20442,216,13,216,34,11,2,8.333333333333334,48.1
20443,228,6,228,70,4,2,25.0,54.93
20444,4368,42,276,162,30,12,5.2631578947368425,42.7
20445,288,8,288,121,6,2,14.285714285714286,87.6
20446,3984,16,0,419,11,5,100.0,100.0
20447,180,63,108,43,53,10,1.96078431372549,22.94
20448,4694232,14,144,335344,12,2,7.6923076923076925,47.17
20449,264,5,264,81,4,1,20.0,83.08
20450,228,1,228,48,1,0,33.333333333333336,62.4
20451,336,26,336,24,24,2,4.166666666666667,37.42
20452,9132,22,0,723,16,6,100.0,100.0
20453,312,7,0,87,5,2,50.0,0.0
20454,7659768,309,0,104383,157,152,2.1739130434782608,0.0
20455,1320,22,1320,94,17,5,7.142857142857143,56.13
20456,8601708,2296,0,133598,1286,1010,1.0,1.06
20457,696,45,696,28,43,2,2.272727272727273,58.86
20458,51948,19,27126,1532,19,0,5.555555555555555,29.32
20459,7857624,2560,4428714,1707169,1409,1151,1.0,0.0
20460,924,3,924,0,3,0,20.0,0.72
20461,31908,15,31908,829,13,2,11.11111111111111,57.06
20462,9424284,4569,886008,3501625,2682,1887,1.0,0.0
20463,900,15,0,591,13,2,50.0,0.0
20464,23904,24,23904,1445,20,4,8.333333333333334,1.47
20465,6660,27,6660,1845,27,0,1.4492753623188406,20.21
20466,431280,138,0,9393,76,62,5.0,0.0
20467,5746056,579,5746056,3276,308,271,3.0303030303030303,80.95
20468,852,33,768,460,26,7,4.3478260869565215,11.06
20469,252,3,252,20,3,0,20.0,54.05
20470,3678444,94,3678444,41720,45,49,7.6923076923076925,95.48
20471,57036,56,22136,2900,56,0,2.1739130434782608,14.3
20472,207936,17,207936,486,15,2,7.142857142857143,81.78
20473,720,25,0,499,17,8,100.0,0.0
20474,1836,0,1836,0,0,0,100.0,100.0
20475,1992,58,0,520,43,15,50.0,0.0
20476,2808,8,2808,2211,6,2,8.333333333333334,82.68
20477,108,11,108,26,7,4,14.285714285714286,93.19
20478,564,94,564,26,92,2,1.8867924528301887,55.26
20479,468,118,360,189,54,64,3.8461538461538463,58.63
20480,8879916,148,8879916,40075,56,92,7.6923076923076925,91.81
20481,900,80,900,281,39,41,10.0,90.75
20482,7792716,225,7792716,36592,124,101,2.5641025641025643,80.62
20483,36,3,36,12,2,1,50.0,83.96
20484,555708,6,0,128336,4,2,100.0,0.0
20485,876,85,876,441,75,10,1.408450704225352,38.09
20486,3324,24,3324,270,22,2,5.0,67.26
20487,240,197,240,96,118,79,1.0869565217391304,45.73
20488,336,11,336,53,9,2,11.11111111111111,51.83
20489,696,30,696,397,26,4,4.166666666666667,62.62
20490,312,6,312,160,4,2,20.0,95.39
20491,5556,14,5556,2414,14,0,6.666666666666667,8.64
20492,312,24,228,26,20,4,5.2631578947368425,57.31
20493,9105192,136,0,1765478,91,45,1.25,0.0
20494,2004,9,0,904,7,2,50.0,0.0
20495,261336,206,0,2852,104,102,3.333333333333333,0.0
20496,132,37,132,17,23,14,5.555555555555555,57.76
20497,2729448,244,2729448,10323,131,113,3.125,73.34
20498,28932,54,0,3088,45,9,100.0,0.0
20499,440340,27,440340,56,25,2,3.8461538461538463,58.54
20500,18108,40,0,1233,20,20,25.0,0.0
20501,3120,12,300,320,9,3,14.285714285714286,60.81
20502,7782264,112,0,130434,55,57,7.6923076923076925,0.0
20503,132,16,108,47,8,8,33.333333333333336,99.25
20504,86868,128,86868,2764,94,34,1.7857142857142858,11.25
20505,5148,33,5148,300,24,9,6.666666666666667,98.88
20506,288,105,288,105,71,34,1.7857142857142858,60.87
20507,8287212,271,0,57038,133,138,4.166666666666667,0.0
20508,16608,40,0,1027,33,7,100.0,100.0
20509,6704088,1064,6681232,490372,518,546,1.0309278350515465,0.0
20510,180,8,168,81,6,2,14.285714285714286,53.49
20511,192,86,180,75,42,44,4.3478260869565215,65.56
20512,8035704,106,0,463112,58,48,5.555555555555555,0.0
20513,8419356,471,0,64449,259,212,1.7857142857142858,0.0
20514,16752,13,0,1487,9,4,100.0,100.0
20515,8346408,74,0,225723,30,44,10.0,0.0
20516,384,13,384,125,8,5,20.0,59.84
20517,2552892,133,2552892,4789,63,70,5.2631578947368425,0.0
20518,11244,24,0,939,14,10,11.11111111111111,2.0
20519,29808,8,29808,631,8,0,11.11111111111111,93.09
20520,13728,17,13728,576,15,2,7.6923076923076925,0.43
20521,8996724,4587,4895052,58116,2630,1957,1.0,0.0
20522,35436,19,35436,1445,18,1,6.666666666666667,78.67
20523,2554872,54,2554872,850,26,28,6.666666666666667,0.0
20524,1104,9,0,798,6,3,100.0,0.0
20525,744,26,744,451,16,10,16.666666666666668,98.57
20526,2555700,34,2555700,220,22,12,5.555555555555555,0.0
20527,1668,40,1668,1231,30,10,3.8461538461538463,74.89
20528,491868,156,491868,114758,116,40,2.380952380952381,47.95
20529,9439152,1239,2503116,3095655,681,558,1.1235955056179776,0.0
20530,5266548,462,5266416,14806,200,262,2.5,0.0
20531,6326676,263,6326676,2634,133,130,4.3478260869565215,0.0
20532,17676,18,3468,3113,15,3,7.142857142857143,88.78
20533,9255564,1057,4992576,514723,467,590,1.0,0.0
20534,7268136,230,0,117350,126,104,1.818181818181818,0.0
20535,384,7,384,85,5,2,25.0,88.04
20536,9070476,332,0,1465144,199,133,2.380952380952381,0.0
20537,2559276,379,2559276,5144,207,172,2.380952380952381,0.0
20538,924,63,924,184,35,28,8.333333333333334,76.11
20539,93672,85,55452,10252,75,10,1.4285714285714286,17.7
20540,9342240,4962,2035512,2728776,2777,2185,1.0,3.23
20541,396,26,396,82,20,6,5.2631578947368425,58.19
20542,26664,9,0,5996,4,5,100.0,0.0
20543,55272,38,55272,3169,35,3,2.857142857142857,33.5
20544,4902336,232,4902336,146,161,71,1.0,0.0
20545,40608,1,40608,40320,1,0,33.333333333333336,57.85
20546,65412,317,65412,215,214,103,1.0,16.73
20547,2112,22,2112,148,15,7,10.0,48.48
20548,123888,43,0,4809,35,8,50.0,0.0
20549,2563968,90,2563968,30297,41,49,10.0,0.0
20550,66432,231,66432,77,118,113,1.075268817204301,26.17
20551,96336,15,1752,6688,12,3,9.090909090909092,98.81
20552,264,3,264,60,2,1,33.333333333333336,80.58
20553,3936,147,2838,619,90,57,8.333333333333334,99.72
20554,2977260,6,2977260,424,2,4,25.0,0.0
20555,2564028,55,2564028,1840,21,34,9.090909090909092,79.01
20556,8702688,2332,0,32797,1331,1001,1.0,0.0
20557,68460,204,68460,142,141,63,1.0,13.5
20558,2566596,115,2566596,5416,58,57,6.25,0.0
20559,69108,280,69108,253,180,100,1.0,13.1
20560,8676,104,0,500,98,6,100.0,0.0
20561,2280,57,0,800,50,7,50.0,0.0
20562,240,57,240,90,25,32,10.0,83.9
20563,30432,10,30432,464,10,0,12.5,73.12
20564,2172,2,0,1212,1,1,50.0,90.0
20565,15180,18,15180,946,18,0,5.882352941176471,71.27
20566,16968,26,16968,761,23,3,7.142857142857143,0.19
20567,149148,54,149148,704,44,10,2.9411764705882355,35.9
20568,348,26,348,54,24,2,4.166666666666667,32.19
20569,8022792,469,0,119384,260,209,1.8867924528301887,0.0
20570,1903476,20,1903476,446,17,3,6.25,69.88
20571,420,19,420,59,18,1,5.2631578947368425,43.47
20572,1092,37,1092,392,33,4,3.703703703703704,42.56
20573,3636,14,3636,375,11,3,10.0,87.26
20574,14004,26,14004,1339,24,2,5.2631578947368425,80.92
20575,5712,13,0,883,10,3,100.0,0.0
20576,6923940,287,0,93619,149,138,3.333333333333333,0.0
20577,7980,15,7980,658,8,7,20.0,96.0
20578,3744,11,3744,305,7,4,20.0,93.57
20579,3362652,25,3362544,134697,18,7,7.6923076923076925,0.0
20580,6768,23,2760,1174,20,3,7.6923076923076925,0.58
20581,42552,45,0,1849,32,13,100.0,0.0
20582,252,16,252,55,10,6,12.5,46.01
20583,29796,24,29796,821,21,3,5.882352941176471,67.81
20584,396,86,372,127,59,27,2.0,29.67
20585,51576,84,0,4682,70,14,16.666666666666668,0.0
20586,4740,26,4740,1295,26,0,5.2631578947368425,68.73
20587,2772,18,2772,859,16,2,8.333333333333334,90.88
20588,5496,23,5496,768,20,3,7.142857142857143,25.54
20589,432,0,432,0,0,0,100.0,100.0
20590,95124,522,47682,6580,440,82,1.0869565217391304,67.92
20591,9085428,363,4920072,30425,189,174,2.9411764705882355,77.27
20592,48720,77,0,2253,61,16,50.0,0.0
20593,1272,123,1272,356,75,48,1.9230769230769231,32.05
20594,3072,15,3072,548,13,2,8.333333333333334,0.58
20595,9458292,935,0,2477675,516,419,1.0,0.0
20596,2808,11,2808,542,7,4,25.0,33.74
20597,672,9,0,464,7,2,50.0,0.0
20598,600,85,600,242,49,36,3.4482758620689653,60.65
20599,134316,52,13008,4528,47,5,2.2222222222222223,28.56
20600,3537288,33,3537288,10827,22,11,6.25,49.85
20601,13680,18,0,1171,16,2,100.0,0.0
20602,353100,20,93132,3610,10,10,16.666666666666668,0.42
20603,336132,10,336132,727,10,0,1.639344262295082,68.85
20604,9407808,1497,0,176517,798,699,1.0,0.0
20605,5808,15,5808,807,14,1,11.11111111111111,21.5
20606,5388,25,5388,1355,24,1,5.0,67.26
20607,5688,7,0,2590,5,2,50.0,0.0
20608,941424,28,941424,150415,14,14,1.0,0.0
20609,59772,43,0,2333,28,15,100.0,0.0
20610,683808,13,0,59393,8,5,16.666666666666668,0.0
20611,13176,24,13176,784,22,2,5.882352941176471,63.36
20612,8448,28,8448,1562,25,3,5.555555555555555,76.54
20613,66828,114,66828,5847,94,20,2.127659574468085,29.63
20614,207240,52,207240,8576,21,31,3.571428571428572,39.47
20615,144,55,144,53,34,21,4.545454545454546,55.41
20616,2412,28,0,1029,22,6,100.0,0.0
20617,7764,15,7764,651,14,1,7.6923076923076925,5.0
20618,5004,17,5004,582,16,1,9.090909090909092,15.16
20619,1428,11,1140,681,9,2,100.0,0.0
20620,2256,49,2256,561,39,10,4.0,0.0
20621,4956,14,4956,998,12,2,10.0,75.61
20622,6645708,96,2484756,1073739,52,44,3.8461538461538463,0.0
20623,8960136,479,0,396327,280,199,2.083333333333333,1.75
20624,780,21,780,277,20,1,5.2631578947368425,0.0
20625,23664,67,23664,1438,60,7,1.7857142857142858,19.9
20626,2712,28,2712,28,27,1,3.703703703703704,34.58
20627,96,0,96,0,0,0,50.0,0.0
20628,696,8,312,235,5,3,5.882352941176471,23.81
20629,14832,56,14832,1094,44,12,3.0303030303030303,34.87
20630,480,3,480,132,2,1,50.0,0.0
20631,972,30,780,263,18,12,11.11111111111111,50.0
20632,144,1,144,12,1,0,33.333333333333336,55.5
20633,17424,50,0,1365,34,16,100.0,0.0
20634,314892,13,0,28683,9,4,33.333333333333336,0.0
20635,9398628,10658,1704852,371472,5962,4696,1.0,0.0
20636,108,25,108,34,20,5,5.882352941176471,38.82
20637,346488,13,346488,946,10,3,11.11111111111111,50.83
20638,72924,55,0,4688,44,11,50.0,0.0
20639,1608,3,1608,572,2,1,33.333333333333336,62.95
20640,9217536,1500,0,34952,824,676,1.0,0.0
20641,120,15,120,21,15,0,6.25,42.3
20642,11652,21,11652,982,20,1,5.882352941176471,71.28
20643,28572,50,0,2002,41,9,50.0,0.0
20644,79656,27,16980,6868,26,1,4.761904761904762,72.66
20645,13080,22,13080,831,20,2,7.142857142857143,17.26
20646,9060,50,0,1330,34,16,100.0,0.0
20647,168,8,168,54,5,3,25.0,73.84
20648,8893500,604,0,924289,330,274,2.0,0.0
20649,72900,56,0,2727,49,7,50.0,0.0
20650,351864,327,158556,34259,264,63,1.0,4.08
20651,17832,21,17832,1602,18,3,9.090909090909092,87.6
20652,216,18,216,60,17,1,5.555555555555555,47.35
20653,4332,9,4332,420,9,0,11.11111111111111,56.86
20654,5784,33,1908,888,27,6,4.3478260869565215,0.0
20655,19176,15,19176,647,13,2,8.333333333333334,0.0
20656,120,0,120,0,0,0,50.0,80.0
20657,168,2,168,36,1,1,50.0,66.7
20658,444,4,444,66,2,2,50.0,61.88
20659,10464,255,10464,2004,145,110,5.882352941176471,95.56
20660,497544,60,0,10790,47,13,100.0,0.0
20661,1236,8,1236,423,7,1,11.11111111111111,88.93
20662,3396,4,3396,102,2,2,50.0,58.01
20663,34968,23,23484,9476,16,7,33.333333333333336,0.09
20664,624,43,624,286,37,6,5.0,68.15
20665,180,5,180,72,3,2,33.333333333333336,77.85
20666,4200,5,4200,112,5,0,14.285714285714286,66.51
20667,3612,15,0,633,12,3,100.0,100.0
20668,240,35,240,69,26,9,5.882352941176471,78.44
20669,384,10,384,292,8,2,11.11111111111111,88.77
20670,22944,16,22944,763,16,0,6.666666666666667,72.15
20671,376920,9,376920,4858,9,0,12.5,86.48
20672,26796,43,0,1668,27,16,100.0,0.0
20673,6012,21,6012,1122,17,4,6.666666666666667,0.0
20674,4800,17,4800,544,15,2,7.142857142857143,4.09
20675,456,54,456,244,44,10,4.761904761904762,66.4
20676,22920,54,0,1939,43,11,16.666666666666668,0.0
20677,8477208,3534,47484,58510,1939,1595,1.0,2.21
20678,42912,24,0,2014,17,7,100.0,100.0
20679,4479672,671,0,34015,331,340,3.333333333333333,0.0
20680,35856,51,0,2142,41,10,50.0,0.0
20681,4709232,235,0,141421,110,125,5.0,0.0
20682,1884,20,0,427,16,4,100.0,100.0
20683,17052,10,0,4782,8,2,20.0,0.42
20684,3804,6,0,1468,4,2,33.333333333333336,0.41
20685,3144,15,3144,646,13,2,9.090909090909092,69.3
20686,10524,2,10524,10284,2,0,25.0,67.93
20687,492,25,492,162,23,2,5.555555555555555,78.34
20688,1272,24,0,490,21,3,50.0,79.99
20689,47784,27,0,2163,20,7,100.0,100.0
20690,1716,231,0,441,155,76,14.285714285714286,0.0
20691,528876,15,528876,2697,14,1,9.090909090909092,56.4
20692,32052,38,0,2635,32,6,100.0,0.0
20693,41640,76,0,2403,52,24,50.0,0.0
20694,2544,42,0,633,35,7,50.0,99.8
20695,10284,46,0,2506,37,9,100.0,0.0
20696,18504,45,0,1224,33,12,50.0,0.0
20697,1428,34,1428,307,32,2,3.0303030303030303,57.89
20698,20412,62,0,1579,46,16,100.0,0.0
20699,2184,44,2184,245,32,12,5.555555555555555,83.19
20700,804,20,804,198,18,2,5.555555555555555,84.01
20701,384,41,384,21,41,0,2.380952380952381,60.42
20702,8016912,786,8016912,180943,469,317,1.351351351351351,78.15
20703,1848,128,0,458,108,20,100.0,0.0
20704,44748,69,44748,1729,63,6,1.6666666666666667,6.6
20705,852,81,852,18,81,0,2.3255813953488373,59.52
20706,17880,5,17880,777,3,2,50.0,96.33
20707,23760,25,23760,1619,22,3,5.2631578947368425,74.15
20708,9204,84,9204,559,70,14,1.5625,37.31
20709,8759472,549,0,64822,294,255,2.0408163265306123,0.0
20710,59148,27,0,2452,21,6,100.0,100.0
20711,8640,26,108,360,21,5,5.2631578947368425,45.51
20712,216,5,216,57,3,2,33.333333333333336,61.61
20713,252,114,252,80,66,48,2.2222222222222223,44.29
20714,129120,142,0,2508,91,51,25.0,0.0
20715,46368,103,46368,370,85,18,1.3157894736842106,43.29
20716,2880,17,2880,678,15,2,8.333333333333334,84.09
20717,228,31,228,99,25,6,4.166666666666667,82.32
20718,1116,17,0,791,15,2,50.0,0.0
20719,614268,21,0,58366,15,6,14.285714285714286,0.0
20720,1968,78,0,980,55,23,50.0,0.0
20721,2645064,24,2645064,63952,14,10,16.666666666666668,94.15
20722,540,97,540,42,89,8,2.083333333333333,60.12
20723,7213620,727,0,29632,424,303,1.25,0.0
20724,47004,3,47004,2268,2,1,50.0,97.25
20725,20532,186,0,790,120,66,100.0,0.0
20726,2760240,75,2760240,5466,43,32,5.882352941176471,0.0
20727,2256,16,2256,674,15,1,9.090909090909092,92.95
20728,42216,67,42216,1644,58,9,2.0,21.08
20729,648,113,648,55,103,10,1.7241379310344829,50.91
20730,4349424,210,0,23656,128,82,25.0,0.0
20731,1224,3,0,988,2,1,50.0,99.0
20732,720,9,0,484,8,1,50.0,0.0
20733,3708,98,0,777,68,30,100.0,0.0
20734,624,10,624,108,6,4,100.0,100.0
20735,19764,36,0,2846,30,6,100.0,0.0
20736,0,0,0,0,0,0,100.0,0.0
20737,7086168,936,4979112,173216,435,501,1.2820512820512822,0.0
20738,2580,148,0,863,96,52,50.0,0.0
20739,47256,73,47256,1539,58,15,2.272727272727273,31.87
20740,8295948,797,6809604,168038,462,335,1.5625,0.0
20741,111108,0,111108,0,0,0,50.0,80.0
20742,4380,40,1668,909,36,4,4.0,84.73
20743,108,21,108,18,15,6,7.142857142857143,47.2
20744,37920,0,37920,0,0,0,50.0,63.16
20745,6072,109,0,1929,70,39,100.0,0.0
20746,9342720,1250,47942,87627,753,497,1.1764705882352942,0.0
20747,70896,26,70896,512,21,5,5.555555555555555,63.93
20748,3468,95,0,897,68,27,100.0,0.0
20749,32568,35,32568,2907,29,6,5.555555555555555,0.0
20750,4416,35,0,1382,29,6,100.0,0.0
20751,492,40,492,282,31,9,3.571428571428572,58.1
20752,34416,60,1188,2323,50,10,5.882352941176471,0.0
20753,183384,362,0,3661,248,114,100.0,0.0
20754,2784,350,2784,41,118,232,1.0,22.4
20755,32004,44,32004,1906,39,5,3.703703703703704,66.71
20756,1140,3,0,1068,2,1,50.0,0.0
20757,13068,104,0,1134,80,24,100.0,0.0
20758,3192,44,0,1241,35,9,100.0,0.0
20759,649380,7,649380,78946,7,0,14.285714285714286,75.73
20760,12540,212,0,2950,135,77,50.0,0.0
20761,7884888,1292,0,93951,700,592,1.4705882352941178,0.0
20762,30840,34,4536,3038,28,6,4.3478260869565215,0.0
20763,432,13,432,120,12,1,8.333333333333334,0.0
20764,1998048,4,2088,500079,2,2,16.666666666666668,0.0
20765,8297112,2380,0,142758,1323,1057,1.0,0.0
20766,9278076,2033,0,196023,1158,875,1.0,0.0
20767,656880,143,0,21146,58,85,10.0,1.2
20768,38112,1,38112,312,1,0,50.0,96.06
20769,96,20,84,25,15,5,7.6923076923076925,49.75
20770,15612,157,0,2809,96,61,100.0,0.0
20771,9060,27,0,1448,16,11,14.285714285714286,0.0
20772,3036,28,3036,831,23,5,5.555555555555555,0.0
20773,11796,246,0,1051,132,114,50.0,0.0
20774,16284,101,16284,1577,83,18,1.9230769230769231,23.54
20775,24936,21,24936,1576,20,1,5.2631578947368425,75.03
20776,98136,23,23628,5717,21,2,5.555555555555555,74.8
20777,108132,51,108132,4192,41,10,2.857142857142857,73.99
20778,549252,48,0,15710,39,9,100.0,0.0
20779,120,5,120,4,5,0,16.666666666666668,0.0
20780,2628,101,0,899,65,36,50.0,0.0
20781,9960,26,9960,1602,24,2,6.666666666666667,73.66
20782,1428,1,528,1428,1,0,50.0,0.9
20783,636,2,636,306,2,0,16.666666666666668,98.74
20784,816,2,0,606,1,1,50.0,0.0
20785,17052,44,17052,42,44,0,2.1739130434782608,58.75
20786,9494820,2244,2208902,1416930,1112,1132,1.0,60.16
20787,420,0,420,0,0,0,100.0,100.0
20788,4692,167,0,607,110,57,100.0,0.0
20789,26352,3,26352,552,3,0,25.0,0.0
20790,8484,31,8484,867,24,7,5.2631578947368425,67.46
20791,52668,50,0,2076,35,15,100.0,0.0
20792,30288,67,30288,2041,58,9,1.851851851851852,23.78
20793,5748,2,5748,3480,2,0,33.333333333333336,99.92
20794,36984,24,36984,694,19,5,7.6923076923076925,69.79
20795,9357264,89,0,5144787,36,53,1.0,0.04
20796,7356,19,7356,1354,18,1,6.666666666666667,84.08
20797,15840,22,15840,811,21,1,5.2631578947368425,72.5
20798,1560,81,1560,501,47,34,3.4482758620689653,63.26
20799,2663400,310,2663400,4335,159,151,2.2222222222222223,69.02
20800,2208,6,2208,118,6,0,14.285714285714286,98.67
20801,3792,2,3792,234,2,0,33.333333333333336,99.05
20802,8736,66,8736,1493,47,19,4.3478260869565215,66.59
20803,73068,99,73068,3078,81,18,2.4390243902439024,29.61
20804,32340,15,32340,3208,8,7,100.0,100.0
20805,87492,69,0,5192,57,12,16.666666666666668,0.0
20806,23856,50,0,2315,42,8,100.0,0.0
20807,52752,47,0,3056,39,8,50.0,0.0
20808,5673012,29,7824,1122101,25,4,5.882352941176471,74.68
20809,113988,29,113988,68312,25,4,5.2631578947368425,87.65
20810,21540,28,21540,13931,24,4,6.25,73.89
20811,6900,17,6900,999,16,1,7.142857142857143,72.57
20812,1788,17,1788,257,11,6,10.0,81.94
20813,468,26,468,142,24,2,4.0,59.88
20814,15048,41,0,3410,33,8,100.0,0.0
20815,2496,10,2496,410,6,4,25.0,97.65
20816,119820,1,119820,312,1,0,50.0,99.11
20817,11616,23,11616,1088,21,2,5.555555555555555,73.55
20818,245424,41,0,24782,35,6,100.0,0.0
20819,682716,1768,682716,32059,1101,667,1.0,73.93
20820,0,0,0,0,0,0,50.0,66.4
20821,25860,19,25860,674,17,2,7.6923076923076925,0.0
20822,420,15,420,284,10,5,11.11111111111111,0.0
20823,83976,1,83976,300,1,0,33.333333333333336,99.0
20824,2170848,38,2170848,752,31,7,3.8461538461538463,35.16
20825,5987724,60,0,294258,49,11,33.333333333333336,0.0
20826,9228,22,9228,825,21,1,5.2631578947368425,75.38
20827,2784,15,0,556,13,2,50.0,99.99
20828,2575020,3,2575020,2220,2,1,50.0,95.68
20829,7295520,607,0,45514,332,275,2.272727272727273,0.0
20830,1776,38,1776,5,38,0,2.5,30.02
20831,9484788,269,0,3843833,129,140,1.6666666666666667,0.0
20832,8148,23,8148,705,22,1,5.2631578947368425,74.18
20833,3602220,69,0,66754,55,14,11.11111111111111,0.0
20834,47064,66,0,3477,51,15,50.0,0.0
20835,3012,20,0,946,15,5,100.0,100.0
20836,312,53,312,104,41,12,2.702702702702702,70.49
20837,81240,6,81240,340,6,0,14.285714285714286,73.76
20838,11616,11,11616,723,10,1,14.285714285714286,73.13
20839,67272,41,0,3962,26,15,100.0,0.0
20840,2616,16,0,608,13,3,50.0,99.9
20841,2508,24,0,465,20,4,100.0,100.0
20842,71904,193,71904,3495,115,78,1.639344262295082,76.25
20843,21708,15,21708,1072,14,1,7.6923076923076925,79.39
20844,70668,13,70668,462,12,1,12.5,60.27
20845,9182664,2342,0,55515,1315,1027,1.0,5.5
20846,1932,8,1932,297,7,1,100.0,0.0
20847,72252,97,0,2736,73,24,50.0,0.0
20848,2244,22,0,599,18,4,50.0,99.0
20849,13428,34,0,614,28,6,50.0,0.0
20850,2892,19,0,560,16,3,100.0,100.0
20851,4321020,710,1488416,19043,532,178,1.0,0.0
20852,276,14,180,73,10,4,9.090909090909092,64.48
20853,33456,59,0,1420,43,16,100.0,0.0
20854,432,12,432,114,8,4,16.666666666666668,52.81
20855,1728,17,0,405,14,3,100.0,100.0
20856,30444,4,0,7947,2,2,100.0,0.0
20857,19332,61,0,2949,50,11,100.0,0.0
20858,8136,26,8136,1872,23,3,6.25,72.48
20859,2388,26,0,424,20,6,100.0,100.0
20860,7160748,197,0,833895,130,67,1.36986301369863,0.0
20861,228,33,228,92,21,12,6.25,88.77
20862,6403620,551,0,191328,319,232,1.639344262295082,0.0
20863,1440,53,936,232,35,18,4.3478260869565215,0.0
20864,6730800,104,0,217898,64,40,33.333333333333336,0.0
20865,1896,49,0,628,37,12,50.0,98.0
20866,22692,18,22692,694,17,1,6.666666666666667,0.0
20867,288,2,288,48,2,0,33.333333333333336,98.42
20868,12012,23,12012,608,21,2,12.5,52.96
20869,20172,105,0,828,65,40,50.0,0.0
20870,341112,37,341112,3209,33,4,3.225806451612903,21.39
20871,8448,270,8448,1875,151,119,4.761904761904762,85.67
20872,5509500,48,7692,114868,42,6,2.5,27.55
20873,5004,36,0,498,29,7,50.0,98.0
20874,42720,103,0,3204,59,44,100.0,0.0
20875,3828,19,3828,806,17,2,7.142857142857143,0.0
20876,984,22,0,444,15,7,100.0,0.0
20877,9455196,5705,3407028,289731,3308,2397,1.0,0.0
20878,576,15,576,218,14,1,7.142857142857143,67.55
20879,19728,74,0,2542,62,12,100.0,0.0
20880,9189564,512,2477724,468112,283,229,1.694915254237288,70.26
20881,351096,52,351096,12845,46,6,2.380952380952381,20.35
20882,6888,49,6888,310,45,4,2.272727272727273,42.15
20883,144,2,144,36,2,0,25.0,78.38
20884,40128,8,0,19452,3,5,50.0,50.0
20885,36384,33,19044,1084,28,5,4.761904761904762,0.68
20886,59040,84,0,1837,59,25,100.0,0.0
20887,564,53,564,116,34,19,4.166666666666667,81.51
20888,3120,22,3120,537,20,2,6.25,0.5
20889,984,84,504,32,84,0,2.2222222222222223,58.88
20890,7897032,535,7896804,43635,291,244,1.7241379310344829,0.0
20891,3204,20,3204,751,8,12,25.0,98.49
20892,32736,4,32736,753,4,0,25.0,84.59
20893,1668,15,1668,482,12,3,10.0,0.0
20894,492,50,492,36,49,1,1.9230769230769231,35.65
20895,648,49,540,175,42,7,3.571428571428572,68.34
20896,54240,5,0,10874,3,2,25.0,0.04
20897,2340,23,0,454,19,4,100.0,100.0
20898,432,16,432,101,16,0,5.555555555555555,85.32
20899,1344,15,0,691,12,3,50.0,0.0
20900,456,94,456,32,92,2,1.8867924528301887,50.9
20901,4956,125,0,884,85,40,100.0,0.0
20902,2232,83,852,194,73,10,1.6666666666666667,58.08
20903,6471492,332,5314600,725198,124,208,2.9411764705882355,0.0
20904,2304684,186,0,190081,94,92,2.127659574468085,7.86
20905,0,0,0,0,0,0,33.333333333333336,2.0
20906,220128,288,0,39727,199,89,100.0,0.0
20907,8044212,1023,0,57200,551,472,1.0,10.0
20908,2304,98,0,573,68,30,25.0,0.0
20909,1176,9,1104,538,6,3,50.0,99.13
20910,7671408,756,7671408,14753,356,400,1.851851851851852,66.92
20911,1152,76,1152,266,72,4,1.96078431372549,60.61
20912,35532,72,35244,35082,58,14,2.272727272727273,8.17
20913,7740,217,0,2729,124,93,50.0,0.0
20914,672,7,672,166,7,0,9.090909090909092,64.78
20915,53808,54,53808,1009,54,0,2.631578947368421,90.83
20916,64512,17,64512,4370,17,0,6.666666666666667,39.97
20917,222888,7,222888,1392,7,0,11.11111111111111,99.3
20918,2964,5,2940,1238,3,2,33.333333333333336,99.77
20919,5806800,219,0,588458,118,101,2.9411764705882355,3.0
20920,7113108,69,1616496,226728,44,25,3.125,0.0
20921,8292,127,0,301,55,72,14.285714285714286,0.0
20922,8983008,1858,1691388,141333,1096,762,1.0,8.01
20923,2607324,33,2607324,3228,20,13,6.666666666666667,82.24
20924,84936,12,84936,643,10,2,10.0,63.66
20925,576,72,576,160,66,6,1.694915254237288,47.63
20926,35124,11,35124,717,11,0,10.0,64.63
20927,17136,50,17136,85,46,4,2.380952380952381,52.46
20928,5352,95,0,1044,78,17,1.5873015873015872,0.0
20929,144,11,144,50,9,2,10.0,67.42
20930,25992,19,25992,2232,18,1,9.090909090909092,62.11
20931,60,13,36,16,10,3,10.0,45.55
20932,900,293,900,482,118,175,1.7543859649122806,61.77
20933,4978416,97,4978416,1827,53,44,6.666666666666667,69.9
20934,1272,5,1272,439,3,2,50.0,99.52
20935,4092,164,0,1689,103,61,50.0,0.0
20936,36060,25,36060,1928,23,2,5.555555555555555,90.21
20937,4152,60,1428,649,44,16,4.166666666666667,0.0
20938,4728,106,0,1040,72,34,50.0,0.0
20939,2892,75,228,138,50,25,2.5,0.0
20940,1692,7,1692,133,7,0,11.11111111111111,79.7
20941,1212,69,1056,313,58,11,1.9230769230769231,0.0
20942,7254816,237,0,33894,117,120,3.8461538461538463,0.0
20943,8917620,217,0,220089,135,82,1.5151515151515151,0.0
20944,4979244,13,0,384092,8,5,14.285714285714286,90.45
20945,60,2,60,12,2,0,33.333333333333336,90.99
20946,600,254,540,68,156,98,1.075268817204301,19.78
20947,2689428,555,2689428,13483,388,167,1.0,0.0
20948,2786184,101,2786184,4851,51,50,7.142857142857143,36.7
20949,1164,24,1164,364,24,0,4.761904761904762,67.87
20950,312,3,312,104,3,0,20.0,75.7
20951,8410464,2203,6538188,97496,1212,991,1.0,0.0
20952,2592792,625,2592792,439263,346,279,1.3157894736842106,72.17
20953,204,39,204,91,29,10,3.8461538461538463,39.95
20954,444,15,444,51,15,0,5.882352941176471,86.1
20955,156,3,156,108,2,1,33.333333333333336,63.1
20956,26256,9,26256,16848,8,1,16.666666666666668,99.54
20957,0,0,0,0,0,0,100.0,0.0
20958,25032,60,0,3065,48,12,100.0,0.0
20959,8232876,619,0,1450780,180,439,1.0,0.0
20960,1392,4,0,681,2,2,50.0,0.0
20961,1452,0,1452,0,0,0,100.0,100.0
20962,27852,116,0,2044,66,50,100.0,0.0
20963,264,34,264,106,28,6,3.703703703703704,79.01
20964,177312,86,177312,190,60,26,2.083333333333333,62.07
20965,9605988,7015,339254,834172,4036,2979,1.0,0.0
20966,8976,31,0,1956,24,7,100.0,0.0
20967,2593188,364,2593188,5004,168,196,3.571428571428572,87.4
20968,408456,283,0,133487,145,138,2.857142857142857,2.44
20969,50520,12,50520,8223,7,5,20.0,56.62
20970,7866372,128,7866372,66650,76,52,3.571428571428572,66.99
20971,56088,7,56088,1042,5,2,14.285714285714286,72.29
20972,2506404,163,2506404,68974,90,73,2.5,76.25
20973,58584,10,31194,34562,8,2,33.333333333333336,99.94
20974,9392640,778,9392640,199322,440,338,1.2195121951219512,82.24
20975,2004,5,2004,175,4,1,50.0,97.31
20976,504,7,504,101,5,2,12.5,46.07
20977,120,3,120,20,3,0,25.0,93.86
20978,8973192,496,0,60107,250,246,2.127659574468085,0.0
20979,1438464,135,1438464,18542,71,64,2.0408163265306123,0.0
20980,752112,39,0,62131,30,9,25.0,44.62
20981,243792,59,243792,24354,52,7,1.8867924528301887,21.21
20982,12372,142,0,7174,111,31,2.0408163265306123,0.0
20983,684036,17,684036,141184,15,2,7.6923076923076925,69.82
20984,492,8,492,252,5,3,25.0,84.63
20985,3019440,188,3019440,5634,87,101,3.703703703703704,81.43
20986,24492,14,24492,1484,14,0,10.0,80.91
20987,14916,152,0,1100,98,54,100.0,0.0
20988,9604296,6003,2321976,310106,3357,2646,1.0,0.0
20989,960,3,960,144,2,1,20.0,90.71
20990,2028,9,1200,597,9,0,10.0,78.78
20991,7597848,881,60,69003,503,378,1.1111111111111112,0.0
20992,1404,2,0,1284,1,1,50.0,0.0
20993,312,6,312,206,6,0,14.285714285714286,79.67
20994,3619440,10,0,728875,4,6,8.333333333333334,0.0
20995,33552,158,0,13956,98,60,100.0,0.0
20996,103284,1,103284,1116,1,0,33.333333333333336,99.0
20997,46992,347,46992,2975,200,147,2.2222222222222223,47.01
20998,12456,15,0,1248,12,3,100.0,0.0
20999,19692,63,0,1861,50,13,100.0,0.0
21000,3120,21,3120,663,18,3,9.090909090909092,65.05
21001,2856,110,0,947,75,35,50.0,0.0
21002,1500,3,1500,72,3,0,12.5,86.03
21003,18816,197,0,9984,130,67,50.0,0.0
21004,17640,24,17640,921,23,1,4.761904761904762,74.72
21005,108084,14,108084,47256,13,1,8.333333333333334,0.0
21006,348948,679,0,7107,417,262,100.0,0.0
21007,12852,23,12852,418,20,3,5.2631578947368425,48.64
21008,3348,9,3348,961,9,0,11.11111111111111,80.44
21009,4284,6,0,1558,6,0,16.666666666666668,0.0
21010,58440,38,0,4660,33,5,100.0,0.0
21011,9732,151,0,3132,119,32,50.0,0.0
21012,4488,15,0,980,13,2,100.0,0.0
21013,81948,631,45420,13504,490,141,1.96078431372549,0.0
21014,6237108,263,0,64194,150,113,4.166666666666667,0.0
21015,8088,33,8088,218,17,16,9.090909090909092,74.4
21016,82032,71,82032,1375,59,12,2.631578947368421,30.96
21017,59004,103,0,1775,66,37,50.0,0.0
21018,3591144,18,3591144,879,15,3,9.090909090909092,94.86
21019,18576,18,0,2832,16,2,50.0,0.0
21020,68208,44,0,2527,29,15,100.0,0.0
21021,4230012,85,0,99831,38,47,8.333333333333334,4.75
21022,4229964,101,0,138263,41,60,7.142857142857143,0.0
21023,53388,14,53388,546,12,2,11.11111111111111,0.0
21024,62844,49,0,3640,38,11,50.0,0.0
21025,13056,45,0,1917,36,9,100.0,0.0
21026,75840,75,0,2930,60,15,14.285714285714286,0.0
21027,56304,25,56304,910,23,2,6.25,0.0
21028,1793448,34,1793448,1697,28,6,5.2631578947368425,52.5
21029,6852,25,6852,978,23,2,5.2631578947368425,74.38
21030,94356,270,0,3267,182,88,25.0,0.0
21031,65796,42,0,2947,30,12,50.0,0.0
21032,13932,43,0,1026,35,8,50.0,50.0
21033,2628,36,0,996,29,7,100.0,0.0
21034,22884,70,22884,1491,61,9,1.818181818181818,18.63
21035,2664,25,0,386,19,6,100.0,100.0
21036,24576,24,16032,1827,22,2,5.0,76.44
21037,1368,22,72,104,12,10,12.5,57.02
21038,38016,75,0,1047,54,21,100.0,0.0
21039,9552,42,0,2339,34,8,100.0,0.0
21040,9657324,2449,0,375165,1358,1091,1.0,0.0
21041,9012,32,0,855,28,4,100.0,100.0
21042,144,12,144,99,8,4,12.5,73.32
21043,88212,45,0,4081,31,14,100.0,0.0
21044,132,0,132,0,0,0,50.0,67.24
21045,788976,97,788820,222401,80,17,1.0869565217391304,38.91
21046,84,0,84,0,0,0,50.0,64.0
21047,168,6,168,62,5,1,16.666666666666668,51.59
21048,600,1,0,600,0,1,100.0,0.0
21049,781188,8,781188,31503,6,2,14.285714285714286,47.32
21050,2208,15,0,548,12,3,100.0,100.0
21051,19728,21,19728,1736,19,2,7.6923076923076925,73.32
21052,540,35,540,105,31,4,5.882352941176471,73.76
21053,8016,93,0,300,68,25,50.0,0.0
21054,1533144,55,0,29738,43,12,50.0,0.0
21055,132,1,132,36,1,0,33.333333333333336,62.4
21056,13260,1,13260,180,1,0,33.333333333333336,99.3
21057,259992,105,259992,176,40,65,9.090909090909092,87.96
21058,7841856,1409,0,30384,796,613,1.0,4.36
21059,3264,19,0,501,16,3,100.0,100.0
21060,54384,21,54384,1370,19,2,6.666666666666667,74.25
21061,83328,27,83328,336,27,0,3.333333333333333,69.95
21062,1176,42,1176,498,42,0,3.8461538461538463,66.52
21063,3648,92,3648,291,35,57,20.0,8.71
21064,275712,258,225330,23458,161,97,1.96078431372549,94.32
21065,372,23,372,66,18,5,6.666666666666667,57.54
21066,1260,70,684,237,69,1,2.127659574468085,52.6
21067,64236,33,64236,57346,18,15,5.882352941176471,20.52
21068,492,58,492,101,40,18,3.571428571428572,33.63
21069,8535300,270,2845344,227182,195,75,25.0,1.19
21070,408,39,408,206,17,22,12.5,72.46
21071,7327284,622,0,107542,338,284,1.7543859649122806,0.0
21072,62004,47,62004,84,41,6,2.5641025641025643,52.3
21073,2940,17,0,686,14,3,100.0,0.0
21074,176772,8,176772,781,5,3,20.0,95.54
21075,9382680,19,18036,494481,17,2,8.333333333333334,55.86
21076,1416,32,0,594,28,4,50.0,87.89
21077,8737332,1223,0,149374,645,578,1.5625,0.0
21078,1452,71,1452,262,40,31,4.0,44.21
21079,1308,50,1308,248,26,24,6.25,82.71
21080,2856,41,2856,614,32,9,7.6923076923076925,55.93
21081,2480688,308,2480688,5940,159,149,2.702702702702702,82.39
21082,16488,86,0,3769,66,20,12.5,0.0
21083,20484,26,11310,910,22,4,7.6923076923076925,0.39
21084,8352,32,0,1447,27,5,100.0,0.0
21085,144,1,144,84,1,0,33.333333333333336,63.06
21086,290532,168,290532,210,138,30,1.0,14.14
21087,35760,148,35760,1631,97,51,2.3255813953488373,83.12
21088,480,3,0,276,2,1,50.0,0.0
21089,355728,152,0,4298,97,55,33.333333333333336,0.0
21090,1344,123,1176,231,85,38,1.2658227848101269,33.77
21091,6155028,876,0,110351,508,368,1.1111111111111112,7.39
21092,82584,810,38388,10699,584,226,1.0,0.0
21093,292656,104,292656,51,65,39,1.6129032258064515,22.13
21094,144,5,144,43,4,1,20.0,52.38
21095,3384,39,0,920,33,6,33.333333333333336,29.97
21096,294408,171,294408,120,116,55,1.1235955056179776,28.03
21097,3672,7,3672,440,7,0,16.666666666666668,76.88
21098,180,0,180,0,0,0,50.0,90.0
21099,2772,53,2772,193,48,5,2.9411764705882355,45.31
21100,96,5,96,12,5,0,14.285714285714286,70.0
21101,756,98,756,364,47,51,5.0,74.96
21102,3216288,130,0,28324,69,61,5.882352941176471,0.0
21103,60,0,60,0,0,0,50.0,80.0
21104,888,31,0,582,26,5,50.0,0.0
21105,2521980,19,2521980,2883,9,10,12.5,90.78
21106,175656,59,175656,4740,25,34,8.333333333333334,7.65
21107,972,6,936,388,6,0,16.666666666666668,76.04
21108,35148,49,35148,22,45,4,2.3255813953488373,66.4
21109,564,3,564,348,2,1,100.0,100.0
21110,7935960,432,0,42503,236,196,1.694915254237288,1.0
21111,24684,50,0,1950,36,14,50.0,0.0
21112,996,16,996,700,12,4,8.333333333333334,90.84
21113,0,0,0,0,0,0,50.0,0.0
21114,58080,115,58080,11301,65,50,2.702702702702702,60.94
21115,504,62,288,157,28,34,11.11111111111111,94.15
21116,2580,8,2580,423,7,1,16.666666666666668,46.13
21117,156276,60,156276,868,54,6,1.8867924528301887,43.48
21118,232560,194,232560,837,122,72,1.0309278350515465,19.44
21119,816,38,816,251,35,3,2.857142857142857,48.71
21120,5280,48,5280,94,34,14,3.571428571428572,45.65
21121,6985368,127,0,103501,64,63,11.11111111111111,0.0
21122,2498988,242,0,10433,138,104,100.0,0.0
21123,27660,47,0,2077,38,9,100.0,0.0
21124,9130812,1261,4572006,66541,518,743,1.1764705882352942,69.83
21125,468,35,468,276,20,15,8.333333333333334,91.61
21126,1308,207,0,684,155,52,50.0,0.0
21127,672,29,672,161,29,0,5.2631578947368425,77.43
21128,3372,64,0,648,44,20,50.0,0.0
21129,44364,137,0,1542,92,45,100.0,0.0
21130,6988032,519,0,45084,257,262,2.857142857142857,1.92
21131,142092,201,0,19200,131,70,10.0,5.49
21132,25404,91,0,1135,63,28,100.0,0.0
21133,5820,21,240,648,12,9,20.0,55.88
21134,161268,79,161268,515,65,14,1.694915254237288,33.28
21135,23064,4,23064,4554,3,1,50.0,98.53
21136,78828,114,78828,2370,83,31,1.818181818181818,2.27
21137,864,58,768,388,37,21,3.4482758620689653,71.29
21138,42912,435,0,5725,270,165,50.0,0.0
21139,8125428,403,0,37877,221,182,2.2222222222222223,0.0
21140,792,149,792,129,113,36,1.162790697674419,46.92
21141,61104,17,61104,60,14,3,7.6923076923076925,53.17
21142,11436,74,0,992,47,27,50.0,0.0
21143,4671060,434,0,32753,198,236,4.166666666666667,0.0
21144,1188540,71,594348,233926,71,0,2.272727272727273,24.32
21145,7485816,123,244812,61174,112,11,1.075268817204301,22.52
21146,2268,101,0,869,74,27,100.0,0.0
21147,1644,8,1644,726,6,2,16.666666666666668,93.38
21148,9539196,4670,1777032,361258,2503,2167,1.0,4.8
21149,3155388,378,2368020,16724,176,202,3.703703703703704,47.27
21150,64920,18,0,5558,15,3,100.0,0.0
21151,2868,10,2868,1033,10,0,8.333333333333334,16.52
21152,1992,100,0,604,86,14,100.0,0.0
21153,480,9,480,78,9,0,1.7857142857142858,28.9
21154,168,49,168,62,37,12,3.0303030303030303,49.17
21155,451308,119,451308,1518,55,64,7.6923076923076925,93.14
21156,30432,14,30432,465,14,0,6.666666666666667,91.52
21157,5196,1,0,5196,0,1,100.0,0.0
21158,7332168,538,0,142875,292,246,2.702702702702702,0.0
21159,276,16,276,47,14,2,7.142857142857143,53.81
21160,684,10,684,265,10,0,7.6923076923076925,55.5
21161,4548,122,4548,594,105,17,1.4285714285714286,85.13
21162,180,7,180,48,7,0,12.5,87.92
21163,2513424,72,2513424,8481,28,44,7.142857142857143,79.86
21164,132,0,132,0,0,0,100.0,100.0
21165,80772,23,1776,3697,21,2,5.0,76.88
21166,1104,139,456,120,105,34,1.1904761904761905,30.64
21167,8417856,166,8408444,72610,88,78,3.225806451612903,72.01
21168,382284,67,382284,12982,32,35,9.090909090909092,75.73
21169,72,43,72,12,33,10,3.333333333333333,46.77
21170,99432,23,0,4550,16,7,100.0,100.0
21171,276,29,0,69,20,9,50.0,0.0
21172,156,5,156,48,5,0,14.285714285714286,95.25
21173,1020,6,0,326,3,3,50.0,0.0
21174,9199956,1291,0,111368,681,610,1.3157894736842106,0.0
21175,9705504,53494,496220,866744,29808,23686,1.0,1.05
21176,240,4,240,120,2,2,100.0,100.0
21177,7496412,69,648,109116,46,23,2.631578947368421,72.39
21178,660,2,660,282,2,0,50.0,66.48
21179,154764,96,154764,26541,82,14,1.4285714285714286,20.28
21180,372,0,372,0,0,0,100.0,100.0
21181,9494244,6034,2197554,270449,3485,2549,1.0,0.0
21182,577464,16,0,42550,11,5,100.0,0.0
21183,2925384,57,2925384,4344,24,33,16.666666666666668,95.97
21184,2472,77,0,818,50,27,100.0,0.0
21185,37476,6,37476,1406,6,0,14.285714285714286,77.81
21186,7133520,47,13272,303618,35,12,3.125,36.6
21187,696,0,696,0,0,0,50.0,81.95
21188,10164,55,0,315,45,10,100.0,0.0
21189,9290724,364,0,70982,184,180,2.2222222222222223,0.0
21190,20208,20,0,2589,11,9,11.11111111111111,0.0
21191,7284432,146,972,50487,115,31,1.0,35.72
21192,9036,17,9036,2188,17,0,5.882352941176471,12.14
21193,2928,11,0,351,9,2,11.11111111111111,0.0
21194,11712,58,0,952,29,29,12.5,2.0
21195,156,1,156,24,1,0,100.0,100.0
21196,12672,11,12672,3392,5,6,50.0,99.96
21197,91068,13,408,7067,7,6,20.0,85.22
21198,68940,39,68940,1388,35,4,2.857142857142857,33.57
21199,4620,1,0,4620,0,1,50.0,0.0
21200,12120,54,1404,475,40,14,4.0,93.05
21201,696,15,696,71,13,2,9.090909090909092,91.59
21202,9565068,168,7490052,1752500,82,86,3.4482758620689653,0.0
21203,25056,99,25056,150,68,31,1.851851851851852,28.32
21204,9198228,879,0,138043,488,391,1.1111111111111112,0.0
21205,185988,61,185988,10738,29,32,7.142857142857143,47.68
21206,5261616,178,5261616,9072,111,67,1.3888888888888888,59.98
21207,2340,107,2340,812,105,2,1.0,24.59
21208,4548,7,4548,1210,7,0,14.285714285714286,23.08
21209,9062268,435,0,164144,219,216,4.761904761904762,4.75
21210,1092,4,1092,57,3,1,33.333333333333336,98.92
21211,9298908,173,0,94736,89,84,4.166666666666667,0.0
21212,108,2,108,66,2,0,25.0,97.32
21213,3120,17,0,552,13,4,100.0,0.0
21214,564,2,240,426,1,1,25.0,0.0
21215,444,72,384,250,45,27,3.125,0.0
21216,4615428,780,1713532,236107,569,211,1.0,0.0
21217,1752,322,1728,329,223,99,1.0,67.93
21218,1500,8,1500,141,8,0,11.11111111111111,98.75
21219,8645964,16,241728,1113094,8,8,1.0,0.13
21220,6116892,43,5454384,880903,17,26,3.333333333333333,0.0
21221,46248,21,46248,566,17,4,8.333333333333334,0.0
21222,159936,15,81360,36646,14,1,7.6923076923076925,54.89
21223,49560,43,0,4967,33,10,50.0,0.0
21224,64404,60,64404,1728,55,5,1.7857142857142858,19.35
21225,1896,20,1668,185,19,1,6.666666666666667,81.07
21226,452736,6,452736,87728,6,0,16.666666666666668,62.88
21227,48576,31,48576,1018,25,6,5.555555555555555,5.13
21228,4785288,175,0,30579,95,80,4.545454545454546,0.0
21229,888,22,888,536,22,0,4.166666666666667,89.02
21230,73128,43,0,3234,29,14,100.0,0.0
21231,56028,29,56028,2797,24,5,5.2631578947368425,58.01
21232,13812,21,13812,658,21,0,5.2631578947368425,72.11
21233,42264,378,0,7213,245,133,50.0,0.0
21234,51120,54,0,4299,44,10,100.0,0.0
21235,38064,114,0,1092,77,37,100.0,0.0
21236,121092,11,121092,290,9,2,12.5,82.76
21237,1176,66,1176,471,44,22,3.4482758620689653,52.1
21238,326604,34,0,11212,27,7,100.0,0.0
21239,5004,103,0,1186,68,35,50.0,0.0
21240,76284,29,76284,65624,24,5,4.545454545454546,80.22
21241,9156,137,1032,737,111,26,1.2987012987012987,36.09
21242,184728,85,184728,3242,67,18,2.272727272727273,27.52
21243,684,4,684,360,2,2,100.0,100.0
21244,5436,18,5436,821,16,2,8.333333333333334,0.0
21245,4596,18,4596,314,16,2,7.142857142857143,82.22
21246,8158332,851,0,775397,445,406,1.0,0.0
21247,60960,9,60960,1852,6,3,25.0,98.53
21248,2136,37,2136,328,29,8,4.761904761904762,65.35
21249,17376,25,0,8989,21,4,100.0,0.0
21250,264360,5,264360,23450,3,2,33.333333333333336,98.6
21251,5628,20,5628,829,18,2,7.142857142857143,22.65
21252,8916,64,0,2103,50,14,100.0,0.0
21253,9924,22,9924,809,19,3,6.666666666666667,70.71
21254,1668,5,1668,453,3,2,50.0,99.11
21255,900,15,900,280,15,0,6.25,71.45
21256,7356,14,7356,765,12,2,11.11111111111111,0.0
21257,530928,56,0,26814,46,10,50.0,0.0
21258,8160,40,0,1594,32,8,100.0,0.0
21259,53784,0,53784,0,0,0,50.0,75.0
21260,8979012,1364,0,674925,555,809,1.0,0.69
21261,46680,192,0,24973,125,67,50.0,0.0
21262,28308,2,28308,840,2,0,33.333333333333336,40.09
21263,9128052,1011,3474036,1444667,577,434,1.2658227848101269,0.0
21264,77076,45,0,2622,30,15,100.0,0.0
21265,264,9,228,73,6,3,12.5,64.43
21266,9494772,456,0,51089,244,212,2.272727272727273,0.0
21267,5268,19,5268,949,18,1,6.25,73.01
21268,82020,106,82020,1769,85,21,2.127659574468085,26.86
21269,5580,24,5580,712,20,4,7.6923076923076925,40.25
21270,6708,29,6708,677,25,4,6.666666666666667,1.66
21271,1044,28,1044,618,20,8,6.25,86.23
21272,12192,25,12192,733,23,2,5.2631578947368425,74.45
21273,68616,94,0,5768,75,19,11.11111111111111,0.0
21274,6516,9,6516,270,7,2,16.666666666666668,69.08
21275,7871592,375,7871592,4114,214,161,1.7241379310344829,74.58
21276,4500,14,0,774,12,2,50.0,99.99
21277,11184,53,0,1905,43,10,100.0,0.0
21278,23532,44,0,1536,28,16,100.0,0.0
21279,22788,80,0,910,60,20,3.225806451612903,0.0
21280,10836,36,0,3078,30,6,100.0,0.0
21281,974184,30,974184,146508,4,26,1.408450704225352,0.0
21282,900,5,900,192,5,0,16.666666666666668,84.0
21283,46464,10,46464,546,9,1,12.5,90.42
21284,8724660,262,0,118231,136,126,3.571428571428572,0.0
21285,26676,79,0,3179,49,30,50.0,0.0
21286,1766244,486,0,14220,249,237,3.4482758620689653,0.0
21287,7053576,136,0,63653,66,70,7.142857142857143,0.0
21288,61404,7,61404,58,4,3,33.333333333333336,56.04
21289,5925816,26,5925816,1861,25,1,5.0,83.41
21290,2856,11,0,613,9,2,50.0,99.99
21291,2249232,20,2249232,187312,11,9,33.333333333333336,98.56
21292,28392,20,28392,1381,19,1,6.666666666666667,82.23
21293,696,96,696,252,92,4,1.96078431372549,34.98
21294,1572,4,1572,183,4,0,16.666666666666668,93.58
21295,444948,155,444948,4130,73,82,6.25,15.76
21296,132,12,132,52,6,6,50.0,75.68
21297,2088,23,0,676,18,5,100.0,100.0
21298,2292,129,2292,250,111,18,1.1235955056179776,79.13
21299,5856,6,5268,816,3,3,12.5,9.67
21300,150480,3,150480,5072,2,1,50.0,93.63
21301,3072,22,0,668,19,3,50.0,99.99
21302,684,11,684,342,9,2,50.0,65.15
21303,11880,0,5718,0,0,0,50.0,50.0
21304,1728,15,1728,120,13,2,7.6923076923076925,58.03
21305,444,51,444,36,47,4,2.127659574468085,56.46
21306,125700,48,125700,280,36,12,2.9411764705882355,52.45
21307,1068,4,0,537,2,2,50.0,0.0
21308,37668,46,0,2041,35,11,50.0,0.0
21309,46200,141,46200,334,86,55,1.5625,25.22
21310,1404,0,1404,0,0,0,50.0,79.95
21311,1356,12,0,603,9,3,100.0,0.0
21312,23364,48,0,1688,37,11,50.0,0.0
21313,180,26,180,68,12,14,14.285714285714286,72.97
21314,5400,24,0,551,21,3,50.0,0.0
21315,20160,19,156,1114,12,7,8.333333333333334,53.54
21316,47532,160,47532,225,116,44,1.0,15.85
21317,132,40,132,31,28,12,4.3478260869565215,43.53
21318,9761760,20877,1222944,2867764,12789,8088,1.0,1.84
21319,21216,54,0,1414,39,15,100.0,0.0
21320,9639384,582,0,1238174,407,175,1.5384615384615383,0.0
21321,8972508,2113,5218356,43029,1141,972,1.0,7.0
21322,2496,45,0,933,38,7,50.0,99.8
21323,15936,214,2544,1033,177,37,1.0,26.25
21324,51468,161,51444,442,115,46,1.0,28.35
21325,624,46,192,112,38,8,2.9411764705882355,29.88
21326,82896,265,82872,12468,148,117,2.631578947368421,68.19
21327,31500,23,31500,1986,19,4,7.6923076923076925,73.62
21328,480,300,468,187,243,57,1.0,55.56
21329,108,2,108,0,2,0,25.0,62.26
21330,18120,116,0,3318,71,45,50.0,0.0
21331,53724,260,53724,48,149,111,1.0309278350515465,23.44
21332,1188,18,1188,295,17,1,50.0,99.95
21333,312,0,312,0,0,0,100.0,75.0
21334,54312,227,54312,104,150,77,1.0,28.28
21335,216,9,216,102,7,2,16.666666666666668,94.17
21336,2340,12,2340,864,8,4,16.666666666666668,46.3
21337,7869900,3662,7869900,500679,2056,1606,1.0,58.16
21338,9346248,451,0,610592,238,213,1.694915254237288,0.0
21339,1656,55,0,460,42,13,2.7777777777777777,0.0
21340,2004,22,2004,968,16,6,9.090909090909092,81.51
21341,300,13,300,57,12,1,7.6923076923076925,98.39
21342,16584,107,0,1451,58,49,50.0,0.0
21343,24156,69,0,3677,56,13,100.0,0.0
21344,312,106,312,126,74,32,1.639344262295082,0.0
21345,1836,2,1836,18,1,1,100.0,100.0
21346,1703736,34,96,598398,17,17,1.0416666666666667,0.39
21347,9366612,244,0,692402,131,113,2.5641025641025643,0.0
21348,7662504,82,4281252,811011,45,37,33.333333333333336,0.0
21349,58668,232,58668,133,145,87,1.0,23.35
21350,4368,5,4368,1008,5,0,100.0,100.0
21351,1524,9,1524,453,9,0,11.11111111111111,97.69
21352,4131888,33,0,133828,19,14,33.333333333333336,0.0
21353,636,2,636,336,2,0,25.0,68.6
21354,624,46,624,189,43,3,4.3478260869565215,58.13
21355,9696060,3543,0,1151964,1857,1686,1.0,0.0
21356,12828,42,12828,18,42,0,2.272727272727273,58.17
21357,120,5,120,33,4,1,20.0,56.93
21358,99924,1,0,99924,1,0,33.333333333333336,99.0
21359,204,5,132,55,4,1,20.0,97.2
21360,46368,110,46368,2180,91,19,1.6666666666666667,21.86
21361,20544,216,0,6753,137,79,50.0,0.0
21362,25992,155,0,1273,100,55,100.0,0.0
21363,756,121,0,59,114,7,1.0,0.0
21364,1788,83,0,631,62,21,33.333333333333336,0.0
21365,2465832,36,2465832,51651,20,16,5.882352941176471,89.07
21366,1044,31,1044,219,31,0,4.3478260869565215,80.34
21367,3024,134,0,932,97,37,100.0,0.0
21368,9614772,1110,0,99471,620,490,1.1363636363636365,0.0
21369,5268,6,5172,2648,5,1,14.285714285714286,24.46
21370,44040,45,44040,2448,39,6,2.702702702702702,32.29
21371,3324,8,3324,2512,4,4,33.333333333333336,77.7
21372,2748,67,0,496,47,20,100.0,0.0
21373,504,43,504,18,43,0,2.2222222222222223,57.73
21374,336,47,312,123,32,15,4.0,35.68
21375,960,24,960,596,20,4,5.0,83.11
21376,9744060,4849,1865316,631905,2542,2307,1.0,12.05
21377,396,50,396,94,46,4,2.1739130434782608,65.57
21378,3984,158,0,1467,86,72,50.0,0.0
21379,444,5,444,139,4,1,25.0,93.73
21380,5979972,256,0,101989,113,143,2.5641025641025643,0.0
21381,2328,96,0,559,66,30,100.0,0.0
21382,179424,13,0,14060,9,4,100.0,100.0
21383,960,22,960,151,22,0,6.25,70.85
21384,3660,110,0,1231,76,34,100.0,0.0
21385,8204952,595,0,29317,323,272,1.5384615384615383,0.0
21386,38976,234,37644,8027,135,99,1.7241379310344829,69.17
21387,11376,35,11376,759,35,0,4.545454545454546,73.51
21388,408,2,408,222,2,0,25.0,65.1
21389,49320,16,49320,479,10,6,12.5,31.0
21390,780,31,780,292,18,13,20.0,91.47
21391,3504,50,0,671,35,15,50.0,0.0
21392,7644,92,0,533,63,29,100.0,0.0
21393,30492,74,30492,2930,62,12,1.9230769230769231,27.23
21394,448584,25,32112,19977,23,2,5.2631578947368425,86.34
21395,8055924,988,0,128273,561,427,1.2345679012345678,0.0
21396,3265788,507,3265788,51604,206,301,2.1739130434782608,93.97
21397,7404,10,0,2376,6,4,100.0,0.0
21398,9775008,3245,846288,2545097,1836,1409,1.0,0.82
21399,9166524,568,0,65064,268,300,1.6666666666666667,1.0
21400,721524,9,721524,32406,6,3,25.0,98.27
21401,9791496,4206,775251,779152,2267,1939,1.0,0.0
21402,1716,38,1716,725,38,0,2.5641025641025643,57.67
21403,2328,120,0,531,109,11,100.0,0.0
21404,8928,131,0,1135,86,45,100.0,0.0
21405,828,246,564,251,221,25,1.0,54.12
21406,6864,15,6864,940,15,0,6.666666666666667,10.64
21407,65700,6,65700,1556,5,1,20.0,94.13
21408,8600928,1450,568656,136571,796,654,1.0,0.0
21409,468,2,468,246,2,0,25.0,91.56
21410,85704,5,0,18672,3,2,100.0,0.0
21411,2769288,40,2916,69950,26,14,8.333333333333334,38.62
21412,9791016,1853,636768,1218052,949,904,1.0,0.0
21413,9231660,503,0,525643,273,230,1.6666666666666667,0.0
21414,228,39,228,124,28,11,5.555555555555555,50.28
21415,564,1,564,84,1,0,50.0,0.0
21416,6564,128,0,1379,93,35,100.0,0.0
21417,1752,49,1752,84,31,18,4.166666666666667,53.77
21418,1128,4,1128,9,4,0,16.666666666666668,55.65
21419,74268,78,74268,350,53,25,2.5641025641025643,38.82
21420,780,4,780,93,3,1,25.0,0.0
21421,7090656,157,1980,1197537,89,68,1.0,6.49
21422,3072,2,3072,2016,1,1,50.0,58.69
21423,6124260,177,6124260,26197,101,76,4.0,77.16
21424,105492,15,0,18944,10,5,100.0,100.0
21425,37188,53,0,2801,39,14,50.0,0.0
21426,21084,67,0,1577,42,25,50.0,0.0
21427,129360,1,129360,36,1,0,50.0,58.83
21428,54180,155,0,2701,114,41,100.0,0.0
21429,20808,18,20808,1854,17,1,7.142857142857143,81.74
21430,9802320,5611,0,2209556,3189,2422,1.0,0.0
21431,3560844,27,4992,132947,26,1,5.0,75.91
21432,63156,33,0,3972,29,4,100.0,0.0
21433,66456,22,66456,790,19,3,7.142857142857143,2.29
21434,3288,95,0,1042,64,31,50.0,0.0
21435,78180,50,78180,1514,45,5,2.3255813953488373,24.13
21436,85632,617,0,5019,368,249,100.0,0.0
21437,3504,216,1752,1677,150,66,1.162790697674419,43.1
21438,9813516,1529,0,4969072,976,553,1.0,0.0
21439,8096136,874,8096136,119472,472,402,1.0,0.0
21440,54168,40,54168,63,38,2,2.7777777777777777,59.51
21441,9568224,264,0,3421976,136,128,1.7543859649122806,0.0
21442,5340,116,5316,3097,99,17,1.7857142857142858,68.69
21443,148872,16,0,54480,14,2,100.0,0.0
21444,7224,21,7224,787,20,1,6.25,78.15
21445,2988,17,2988,747,15,2,9.090909090909092,0.46
21446,252,22,252,71,16,6,9.090909090909092,80.1
21447,42528,56,0,3540,44,12,100.0,0.0
21448,25764,3,25764,1072,2,1,50.0,99.91
21449,504,0,504,0,0,0,100.0,100.0
21450,2676,16,588,178,15,1,5.882352941176471,63.2
21451,11472,239,0,6415,177,62,100.0,0.0
21452,672,7,672,126,5,2,10.0,7.74
21453,4680,33,4680,1354,28,5,5.2631578947368425,0.58
21454,132,25,108,82,16,9,11.11111111111111,84.15
21455,9557316,280,0,36084,148,132,5.882352941176471,0.0
21456,1536,1,1536,1536,1,0,50.0,99.67
21457,3660,9,3660,841,6,3,33.333333333333336,0.0
21458,54096,50,0,1818,32,18,50.0,0.0
21459,7789560,392,0,305430,219,173,1.1904761904761905,1.62
21460,7213992,115,1092,63326,68,47,2.1739130434782608,70.62
21461,70716,38,0,5725,33,5,100.0,0.0
21462,4560,1,4560,1032,1,0,50.0,78.22
21463,269880,9,269880,3410,7,2,12.5,94.78
21464,2716344,17,528,159991,15,2,6.25,55.25
21465,71256,52,0,2862,33,19,100.0,0.0
21466,58188,55,0,2615,50,5,50.0,0.0
21467,420,16,420,88,9,7,50.0,99.96
21468,13596,25,13596,882,25,0,4.545454545454546,80.73
21469,1992,94,1992,827,51,43,5.555555555555555,84.76
21470,8215716,0,8215716,0,0,0,33.333333333333336,68.61
21471,10596,21,10596,766,20,1,5.882352941176471,77.63
21472,73248,20,73248,442,17,3,12.5,72.96
21473,948,3,948,36,3,0,20.0,97.08
21474,13476,36,13476,2212,22,14,8.333333333333334,0.0
21475,1116,74,1116,329,36,38,5.882352941176471,89.08
21476,21432,60,21432,1603,55,5,1.851851851851852,21.84
21477,4536,17,0,542,14,3,100.0,100.0
21478,72972,52,0,2707,37,15,100.0,0.0
21479,2563116,78,2563116,8591,38,40,14.285714285714286,95.45
21480,12168,62,0,2356,48,14,100.0,0.0
21481,480,40,480,228,38,2,3.8461538461538463,64.94
21482,804,5,804,93,4,1,20.0,58.02
21483,221928,698,112852,96376,517,181,1.0,0.0
21484,2856,22,0,680,18,4,100.0,100.0
21485,2628,21,0,664,14,7,100.0,100.0
21486,144,0,144,0,0,0,50.0,80.0
21487,3864,4,3864,30,2,2,50.0,59.95
21488,126732,102,126732,115,68,34,1.9230769230769231,31.58
21489,32508,97,0,943,80,17,100.0,0.0
21490,4632,1,4632,252,1,0,33.333333333333336,58.7
21491,8908968,459,0,172632,222,237,1.7543859649122806,0.0
21492,79416,218,79416,176,150,68,1.0,20.13
21493,9828288,26964,1138556,736907,14891,12073,7.6923076923076925,0.0
21494,168,0,168,0,0,0,50.0,80.0
21495,984,144,984,196,118,26,1.2195121951219512,35.99
21496,81024,125,81024,19,85,40,1.2658227848101269,15.18
21497,20064,48,0,2345,38,10,33.333333333333336,0.0
21498,504,0,504,0,0,0,50.0,80.8
21499,7570560,572,0,40418,319,253,1.3333333333333333,0.0
21500,509652,62,0,11973,47,15,50.0,0.0
21501,3312,137,0,1136,99,38,100.0,0.0
21502,21312,43,0,1485,28,15,100.0,0.0
21503,30660,10,30660,2384,9,1,12.5,40.0
21504,340752,4,340752,28884,4,0,16.666666666666668,95.74
21505,28944,88,28944,24,86,2,2.127659574468085,58.64
21506,12588,57,12588,202,46,11,2.4390243902439024,57.91
21507,1595004,69,300,107262,31,38,2.127659574468085,0.0
21508,768,0,768,0,0,0,50.0,90.5
21509,64680,12,64680,1960,10,2,12.5,20.2
21510,42792,60,0,2679,49,11,50.0,0.0
21511,2640,65,0,1005,53,12,50.0,99.98
21512,77544,51,77544,84,45,6,2.631578947368421,37.88
21513,108,0,108,0,0,0,50.0,80.0
21514,204,37,204,6,31,6,3.333333333333333,34.59
21515,192,2,192,54,2,0,100.0,100.0
21516,9438924,56,9438924,724701,26,30,7.6923076923076925,83.67
21517,83532,49,0,3543,37,12,50.0,0.0
21518,13716,47,996,312,44,3,2.2222222222222223,63.08
21519,384,29,384,181,23,6,5.555555555555555,94.84
21520,35136,2,35136,1494,1,1,100.0,100.0
21521,1944,17,1944,604,17,0,5.555555555555555,54.85
21522,828,1,828,576,1,0,33.333333333333336,79.6
21523,336,4,336,144,4,0,16.666666666666668,69.0
21524,2596428,174,2596428,12955,100,74,3.0303030303030303,84.28
21525,47868,15,47868,1546,15,0,5.555555555555555,7.75
21526,156,11,144,66,6,5,50.0,77.2
21527,77688,25,77688,69,16,9,11.11111111111111,38.82
21528,2853864,65,0,56807,54,11,100.0,0.0
21529,9860928,12898,1318008,2883479,7966,4932,1.0,0.0
21530,144,3,144,36,2,1,50.0,98.5
21531,276,2,276,24,2,0,25.0,56.26
21532,431784,515,431784,126,437,78,1.0,19.77
21533,3720,6,3720,128,6,0,12.5,85.81
21534,168,12,168,78,6,6,25.0,0.0
21535,23880,81,0,2558,51,30,50.0,0.0
21536,288,13,288,26,10,3,12.5,84.39
21537,4776,18,4776,128,10,8,33.333333333333336,97.31
21538,480,40,192,63,30,10,3.8461538461538463,40.59
21539,45396,148,0,681,86,62,100.0,0.0
21540,8044176,153,0,106087,78,75,5.555555555555555,0.0
21541,7897716,296,7897716,90929,151,145,2.5641025641025643,80.67
21542,204,16,204,71,9,7,33.333333333333336,99.36
21543,0,1,0,0,1,0,50.0,0.0
21544,720,118,720,221,74,44,1.7857142857142858,18.92
21545,97908,53,0,5481,32,21,4.545454545454546,0.0
21546,3396,472,0,1142,353,119,100.0,0.0
21547,1284,13,1284,399,9,4,11.11111111111111,81.64
21548,1236,46,0,442,34,12,50.0,0.0
21549,79572,45,79572,15912,41,4,2.5,33.03
21550,6300312,823,0,27289,459,364,1.3888888888888888,0.0
21551,1464,27,1464,360,12,15,33.333333333333336,96.33
21552,132,3,132,0,3,0,20.0,68.29
21553,1932,4,1932,432,3,1,33.333333333333336,99.0
21554,288996,61,288996,166717,41,20,3.225806451612903,36.2
21555,660,58,660,119,55,3,2.5641025641025643,68.47
21556,2160,15,2160,583,12,3,9.090909090909092,39.32
21557,5364,18,5364,1174,18,0,5.2631578947368425,20.27
21558,516,9,516,104,8,1,20.0,99.7
21559,29244,33,10476,11194,27,6,3.4482758620689653,60.4
21560,180,47,180,57,30,17,4.545454545454546,64.06
21561,78852,112,78852,1996,86,26,1.7241379310344829,9.42
21562,708,122,708,198,109,13,1.1904761904761905,50.14
21563,1152,3,1152,164,2,1,100.0,100.0
21564,55008,9,1116,6989,6,3,20.0,99.16
21565,1248,1,1248,552,1,0,50.0,33.4
21566,1200,55,0,332,54,1,50.0,0.0
21567,8772,8,8772,829,8,0,12.5,52.02
21568,9709392,3112,1950960,1412436,1777,1335,1.0,2.32
21569,288,85,288,117,39,46,5.882352941176471,58.29
21570,1776,4,1776,1554,2,2,25.0,78.32
21571,8756484,334,7772724,44705,171,163,5.555555555555555,89.07
21572,180,5,180,43,4,1,25.0,83.04
21573,552,304,528,327,231,73,1.0,63.57
21574,1116,54,1104,225,52,2,2.5641025641025643,53.13
21575,9452856,101,9452856,1273,39,62,10.0,89.01
21576,783984,22,783984,33328,11,11,12.5,81.63
21577,9823176,8768,2165032,1702193,5257,3511,1.0,0.0
21578,6307080,106,0,117983,56,50,8.333333333333334,0.0
21579,126900,46,126900,5902,33,13,11.11111111111111,95.8
21580,564,108,0,79,101,7,1.0,0.0
21581,8976,23,8976,1009,22,1,5.0,78.29
21582,161724,96,161724,10551,86,10,1.2820512820512822,19.16
21583,732,76,732,120,67,9,1.96078431372549,60.05
21584,9473628,60,2816954,674994,40,20,5.555555555555555,1.63
21585,1872,117,0,647,104,13,100.0,0.0
21586,492,13,492,170,10,3,11.11111111111111,54.52
21587,5184,16,5184,1346,16,0,8.333333333333334,9.0
21588,89496,33,89496,78655,25,8,4.545454545454546,79.96
21589,2981640,62,2981640,273,25,37,12.5,93.63
21590,877140,848,0,8900,540,308,33.333333333333336,0.0
21591,5880,47,5880,183,43,4,5.2631578947368425,84.34
21592,3888,6,3888,538,6,0,16.666666666666668,39.46
21593,93828,69,93828,1202,57,12,2.5,31.15
21594,478524,326,0,24830,165,161,2.7777777777777777,0.0
21595,132,67,96,42,55,12,2.702702702702702,12.0
21596,960,3,960,280,3,0,25.0,96.19
21597,3792,2,3792,594,2,0,25.0,64.61
21598,80160,228,80160,2158,124,104,1.2987012987012987,56.64
21599,9459252,100,9459252,125091,40,60,8.333333333333334,89.34
21600,2688,15,2688,1176,15,0,7.142857142857143,14.01
21601,1697868,3,1697868,688704,3,0,25.0,80.7
21602,7988628,728,0,324968,453,275,1.1494252873563218,0.0
21603,3606768,167,3606768,1677,109,58,1.2048192771084338,0.0
21604,1656,4,1656,90,4,0,16.666666666666668,49.84
21605,65520,16,0,13926,7,9,100.0,0.0
21606,204,8,204,72,8,0,10.0,92.53
21607,1548,85,0,464,52,33,100.0,0.0
21608,6075528,513,0,29581,293,220,1.2987012987012987,0.0
21609,1752,139,0,505,113,26,50.0,0.0
21610,2460,13,2460,610,13,0,6.25,13.94
21611,1248,6,1248,180,6,0,12.5,0.0
21612,228,7,228,46,5,2,20.0,63.54
21613,444,3,444,56,2,1,33.333333333333336,74.78
21614,7884828,1029,5222334,791630,531,498,1.0,38.01
21615,7608,81,0,1239,57,24,100.0,0.0
21616,9704472,270,0,278394,135,135,2.857142857142857,0.0
21617,93192,44,70308,20665,40,4,4.0,61.82
21618,6861024,62,0,335208,49,13,25.0,0.0
21619,2556,5,2556,338,4,1,25.0,95.76
21620,9330348,562,0,118420,274,288,1.020408163265306,0.0
21621,9407028,645,0,186885,344,301,1.2820512820512822,0.0
21622,540,0,540,0,0,0,100.0,100.0
21623,9874296,5355,4891890,2867867,3103,2252,1.0,46.61
21624,7457508,192,0,52887,117,75,1.851851851851852,0.25
21625,828,39,828,649,35,4,3.225806451612903,62.88
21626,19764,41,19764,2272,39,2,2.5641025641025643,32.03
21627,4332,12,4332,1051,12,0,6.666666666666667,4.7
21628,2652,24,360,281,15,9,12.5,67.71
21629,5171088,974,2683938,50640,537,437,1.0,64.85
21630,5169756,257,5169756,13708,140,117,2.9411764705882355,0.0
21631,2952,11,2952,674,11,0,9.090909090909092,19.98
21632,242916,21,99276,86659,17,4,16.666666666666668,49.9
21633,593268,5,593268,166920,5,0,20.0,92.85
21634,4308024,148,0,34812,72,76,4.761904761904762,0.0
21635,9467964,1144,0,52544,645,499,1.0,0.0
21636,76488,2,76488,84,1,1,8.333333333333334,86.36
21637,796860,209,0,111583,94,115,4.3478260869565215,0.0
21638,8904,20,0,2479,18,2,100.0,0.0
21639,540,2,540,138,2,0,33.333333333333336,99.4
21640,552,28,552,85,24,4,4.545454545454546,42.73
21641,2088,14,1752,645,7,7,33.333333333333336,99.89
21642,67860,50,0,3301,40,10,50.0,0.0
21643,15372,26,15372,825,25,1,5.0,74.63
21644,542148,34,542148,21513,27,7,5.2631578947368425,5.38
21645,132,30,132,56,19,11,11.11111111111111,81.04
21646,11940,139,0,925,92,47,100.0,0.0
21647,12096,97,0,1076,69,28,2.127659574468085,0.0
21648,3048,130,0,1128,81,49,50.0,0.0
21649,7008,31,888,349,21,10,6.25,58.09
21650,9879192,3732,2581044,2958249,1569,2163,1.0,4.98
21651,77028,21,77028,804,19,2,6.666666666666667,3.01
21652,340260,14,340260,4664,10,4,16.666666666666668,75.06
21653,3312,14,3312,457,10,4,10.0,53.4
21654,7847064,110,7847064,130944,61,49,4.166666666666667,85.98
21655,4572,228,0,564,145,83,100.0,0.0
21656,174948,31,15336,6609,28,3,5.0,72.81
21657,7192800,129,4735794,2957825,60,69,1.818181818181818,0.06
21658,180,2,120,168,1,1,50.0,64.0
21659,74988,62,0,4113,49,13,33.333333333333336,77.13
21660,7609500,168,0,66240,83,85,6.25,0.0
21661,5916552,12,19332,853115,10,2,12.5,89.0
21662,29772,51,0,1622,36,15,100.0,0.0
21663,146856,3,146856,19132,2,1,25.0,0.0
21664,96,3,96,8,3,0,20.0,75.27
21665,1806564,21,0,318753,12,9,9.090909090909092,5.0
21666,9487536,398,0,101404,213,185,2.857142857142857,0.0
21667,9358908,66,21684,185286,60,6,1.7241379310344829,19.94
21668,3396,304,0,1192,143,161,50.0,0.0
21669,65652,49,0,2433,32,17,100.0,0.0
21670,564,25,564,216,21,4,5.0,1.03
21671,9408,42,0,1397,35,7,100.0,0.0
21672,65028,25,0,4439,22,3,100.0,0.0
21673,5257044,484,2966910,166775,281,203,1.3157894736842106,64.35
21674,9683256,789,432,152365,426,363,1.3888888888888888,1.11
21675,3300,153,3300,779,75,78,3.225806451612903,62.12
21676,504,85,504,22,83,2,2.272727272727273,60.24
21677,8400,23,8400,968,20,3,6.25,0.0
21678,528,47,528,19,45,2,2.1739130434782608,58.12
21679,11856,6,11856,504,4,2,33.333333333333336,90.0
21680,44832,14,44832,552,13,1,8.333333333333334,79.7
21681,12984,0,12984,0,0,0,50.0,59.29
21682,7381932,33,3718848,225573,19,14,12.5,90.56
21683,10596,26,6384,1251,23,3,5.555555555555555,2.06
21684,5628,6,5628,2142,5,1,25.0,88.1
21685,82032,96,82032,3823,77,19,2.2222222222222223,27.86
21686,69276,38,0,3549,32,6,100.0,0.0
21687,12936,25,12936,1336,23,2,5.2631578947368425,68.07
21688,66468,2,216,33240,2,0,50.0,99.97
21689,8966316,1060,6831720,535892,479,581,1.0,0.0
21690,516,21,0,259,15,6,50.0,0.0
21691,2905716,55,0,55474,44,11,50.0,0.0
21692,58092,55,0,2302,41,14,50.0,0.0
21693,4884,24,4884,584,22,2,6.25,1.97
21694,7109436,530,0,104293,292,238,2.083333333333333,0.0
21695,3108,51,3108,2944,33,18,3.8461538461538463,63.33
21696,2088,20,2088,1043,18,2,14.285714285714286,94.28
21697,53940,498,0,4215,288,210,2.272727272727273,0.0
21698,15144,22,15144,946,21,1,5.882352941176471,77.32
21699,66960,44,0,2475,28,16,100.0,0.0
21700,154896,11,154896,1204,3,8,33.333333333333336,93.55
21701,123636,14,123636,9186,12,2,10.0,33.34
21702,62316,84,0,2164,58,26,50.0,0.0
21703,293304,44,293304,1807,38,6,3.225806451612903,29.09
21704,7891908,126,7891908,77853,73,53,2.5,10.49
21705,252036,76,251964,36827,62,14,2.1739130434782608,45.47
21706,67116,18,67116,1138,16,2,11.11111111111111,13.32
21707,17676,23,17676,792,22,1,5.2631578947368425,72.0
21708,5280,57,5280,2238,41,16,4.3478260869565215,0.0
21709,1214436,45,0,82958,35,10,50.0,0.0
21710,816,75,816,318,63,12,3.0303030303030303,56.5
21711,80832,2,80808,756,1,1,100.0,0.0
21712,9336,47,0,1801,38,9,100.0,0.0
21713,3708,15,0,572,12,3,100.0,100.0
21714,4380,153,0,1182,95,58,5.555555555555555,0.0
21715,396,13,396,48,10,3,11.11111111111111,73.69
21716,732,94,360,218,67,27,2.5641025641025643,84.52
21717,9397260,72,21192,170822,63,9,1.6129032258064515,19.5
21718,22236,46,0,2325,35,11,50.0,0.0
21719,12156,362,228,307,292,70,1.0,64.72
21720,6123288,136,0,90726,68,68,3.333333333333333,0.0
21721,7225296,188,0,52944,87,101,6.25,0.0
21722,86064,4,86064,21543,2,2,50.0,58.47
21723,1032,37,1032,794,35,2,4.0,67.55
21724,2928,22,0,852,18,4,100.0,100.0
21725,1608,40,0,203,30,10,3.703703703703704,0.02
21726,3900,31,0,2015,26,5,50.0,0.0
21727,2674980,52,0,156978,42,10,50.0,0.0
21728,338832,25,338832,31160,15,10,16.666666666666668,87.74
21729,1956,37,0,750,32,5,50.0,79.99
21730,37980,35,0,2266,29,6,50.0,0.0
21731,9931500,12796,0,2628409,7433,5363,1.0,0.0
21732,408,101,324,94,67,34,2.702702702702702,50.39
21733,852,3,852,196,2,1,50.0,99.86
21734,5212392,2147,4480350,93971,960,1187,1.098901098901099,79.85
21735,8868,38,108,258,24,14,33.333333333333336,99.97
21736,415632,50,0,26783,40,10,50.0,0.0
21737,684,8,684,282,6,2,20.0,80.31
21738,5928,46,0,891,29,17,100.0,0.0
21739,816,6,816,240,5,1,25.0,98.74
21740,9941136,56724,2656964,3230635,36089,20635,1.0,0.27
21741,216,1,216,204,1,0,50.0,99.8
21742,10620,96,0,979,74,22,1.9230769230769231,0.0
21743,708,1,708,72,1,0,50.0,99.93
21744,1056,3,1056,184,3,0,33.333333333333336,88.41
21745,2220,27,0,1178,21,6,100.0,0.0
21746,12504,17,0,7384,7,10,33.333333333333336,7.69
21747,39360,42,39360,221,25,17,9.090909090909092,91.71
21748,6624,8,6624,343,7,1,14.285714285714286,79.78
21749,2304,424,756,438,334,90,1.0,46.44
21750,43596,122,43596,1611,74,48,3.333333333333333,96.1
21751,840,11,840,221,8,3,20.0,99.2
21752,1968,67,0,980,61,6,50.0,0.0
21753,228,22,204,104,13,9,16.666666666666668,82.55
21754,95280,11,0,8873,8,3,100.0,100.0
21755,636,44,636,192,32,12,3.703703703703704,74.91
21756,612,95,612,192,61,34,2.5,42.5
21757,71292,103,71292,14892,83,20,1.6666666666666667,11.31
21758,9528576,158,0,120524,72,86,4.761904761904762,0.0
21759,38472,3,38472,268,3,0,25.0,98.61
21760,157884,6,157884,3794,4,2,33.333333333333336,99.47
21761,9950988,42865,789999,1563840,23594,19271,1.0,0.0
21762,28176,48,28176,31,48,0,2.9411764705882355,67.54
21763,9730716,101,0,118942,57,44,3.703703703703704,0.0
21764,23472,25,1152,1283,22,3,5.555555555555555,98.1
21765,242496,7,18846,34662,4,3,100.0,98.82
21766,72,8,72,48,5,3,33.333333333333336,97.58
21767,504,1,504,204,1,0,50.0,99.93
21768,9915708,469,2704704,59169,286,183,1.3888888888888888,0.0
21769,888,28,0,156,17,11,100.0,0.0
21770,96,45,96,44,41,4,3.4482758620689653,34.24
21771,1392,71,1392,59,69,2,2.272727272727273,62.86
21772,1620,0,1620,0,0,0,100.0,90.0
21773,10020,77,1104,511,70,7,1.818181818181818,81.19
21774,4794168,64,3669282,2882,35,29,33.333333333333336,98.47
21775,2520,6,2520,148,6,0,14.285714285714286,91.3
21776,3804,8,3804,27,8,0,11.11111111111111,96.64
21777,1608,203,168,138,162,41,1.0,54.17
21778,1764,54,1764,63,52,2,2.7777777777777777,65.32
21779,53532,23,53532,5225,21,2,5.555555555555555,9.99
21780,192,4,192,24,4,0,16.666666666666668,53.14
21781,9535944,91,9535944,558085,41,50,5.555555555555555,76.91
21782,103512,7,0,14940,6,1,100.0,100.0
21783,753888,41,1596,18576,40,1,3.4482758620689653,53.02
21784,150840,905,13620,3858,574,331,1.0,42.08
21785,408,1,408,12,1,0,100.0,100.0
21786,2725536,34,2725536,3351,14,20,16.666666666666668,0.0
21787,21732,227,21732,1014,130,97,1.0,38.21
21788,1139088,274,0,9585,137,137,2.3255813953488373,3.0
21789,6096,12,6096,704,12,0,8.333333333333334,28.7
21790,732,1,732,84,1,0,50.0,87.53
21791,5196,4,5196,516,2,2,100.0,100.0
21792,9904080,1219,2463060,1111613,692,527,1.0,15.5
21793,3708,111,0,514,91,20,100.0,0.0
21794,15792,14,15792,360,13,1,7.6923076923076925,78.86
21795,540,19,444,162,11,8,25.0,88.19
21796,144,72,132,54,59,13,2.127659574468085,79.74
21797,288,80,288,106,42,38,4.0,48.64
21798,9956712,26465,247966,881518,15309,11156,1.0,0.0
21799,336,4,336,96,4,0,16.666666666666668,89.09
21800,408,4,408,159,4,0,33.333333333333336,98.82
21801,34284,2,34284,1206,2,0,25.0,96.14
21802,384,9,384,77,6,3,20.0,9.16
21803,3766380,45,3766380,3177,24,21,20.0,97.23
21804,1416,10,1416,868,10,0,7.142857142857143,28.32
21805,2700,8,2700,390,5,3,33.333333333333336,98.26
21806,970392,289,0,42860,172,117,2.127659574468085,0.0
21807,3870864,25,3870864,354,21,4,4.761904761904762,47.77
21808,8932704,625,0,147243,316,309,1.492537313432836,0.0
21809,3024,138,3024,2286,88,50,1.7241379310344829,37.97
21810,21192,117,0,1289,84,33,100.0,0.0
21811,468,9,84,113,6,3,100.0,100.0
21812,2556,25,2556,1495,25,0,4.166666666666667,18.46
21813,76560,66,342,1314,43,23,4.545454545454546,64.75
21814,47364,5,0,27972,3,2,50.0,99.98
21815,3996,146,0,1145,111,35,50.0,0.0
21816,456,31,456,179,23,8,5.0,83.6
21817,348,17,348,93,11,6,10.0,89.6
21818,274140,144,0,2644,72,72,2.9411764705882355,0.0
21819,95964,53,0,2743,45,8,100.0,0.0
21820,492,2,252,318,1,1,33.333333333333336,63.2
21821,7263264,146,0,114638,60,86,8.333333333333334,5.0
21822,264,12,0,66,9,3,50.0,0.0
21823,96,2,96,48,2,0,25.0,60.81
21824,1656,146,1656,470,79,67,2.7777777777777777,63.27
21825,8592,14,4008,3525,10,4,20.0,0.0
21826,7265208,257,0,114758,129,128,5.2631578947368425,0.0
21827,339972,25,0,34824,21,4,5.882352941176471,0.0
21828,72,3,72,24,2,1,33.333333333333336,57.11
21829,342516,7,342516,442,6,1,16.666666666666668,54.21
21830,8703024,645,0,37178,337,308,1.6129032258064515,1.85
21831,564,44,180,103,34,10,3.333333333333333,34.37
21832,108,25,108,39,15,10,8.333333333333334,48.52
21833,264,23,264,64,20,3,5.2631578947368425,34.88
21834,1008,58,0,156,36,22,100.0,0.0
21835,1603560,11,1603560,5328,9,2,10.0,57.08
21836,252,3,252,84,3,0,20.0,59.25
21837,9788664,264,0,71562,139,125,2.0408163265306123,0.0
21838,2724,34,216,217,26,8,5.555555555555555,44.84
21839,21012,111,0,432,44,67,12.5,0.0
21840,948,1,948,384,1,0,33.333333333333336,62.63
21841,96,14,96,1,14,0,6.666666666666667,41.6
21842,204,8,0,63,6,2,50.0,0.0
21843,144,1,0,144,1,0,25.0,9.98
21844,348,4,0,123,3,1,25.0,5.0
21845,8863956,2199,0,57036,1238,961,1.0,0.0
21846,9074712,262,0,60987,140,122,1.639344262295082,0.0
21847,738684,25,624774,14936,25,0,4.545454545454546,59.28
21848,6408,63,0,703,37,26,50.0,0.0
21849,8995236,1164,174060,153006,518,646,1.0,0.0
21850,332052,27,180000,138521,22,5,5.0,58.11
21851,192,0,192,0,0,0,50.0,74.0
21852,4764,30,4764,84,25,5,4.545454545454546,46.69
21853,420,42,408,123,27,15,7.6923076923076925,83.52
21854,13044,43,0,1323,24,19,100.0,0.0
21855,2304,62,2304,1386,44,18,3.333333333333333,21.01
21856,8410536,265,2824080,35044,150,115,1.7543859649122806,0.0
21857,3900,4,3900,1110,4,0,20.0,99.24
21858,9876,100,0,856,70,30,100.0,0.0
21859,156,2,156,36,2,0,33.333333333333336,96.0
21860,156,0,156,0,0,0,100.0,100.0
21861,264,119,240,229,113,6,1.2987012987012987,50.03
21862,4692,21,4692,994,21,0,5.0,23.52
21863,216,0,216,0,0,0,100.0,100.0
21864,1860,23,1860,515,19,4,6.25,0.0
21865,1032,3,1032,680,2,1,50.0,98.54
21866,256248,440,256248,108630,409,31,1.0,6.43
21867,8809272,152,746808,451066,53,99,1.1494252873563218,0.0
21868,8710860,890,0,205192,447,443,1.6666666666666667,0.0
21869,1956,4,1956,150,4,0,20.0,85.76
21870,7977240,793,0,85473,400,393,1.3333333333333333,2.48
21871,87552,47,87552,1400,40,7,2.9411764705882355,41.72
21872,2208,9,2208,538,9,0,11.11111111111111,18.85
21873,190752,60,0,11650,33,27,100.0,0.0
21874,63168,21,63168,1111,19,2,7.6923076923076925,0.25
21875,22788,143,0,1411,95,48,100.0,0.0
21876,626472,43,626472,129023,31,12,6.666666666666667,77.4
21877,8712,139,0,1453,96,43,100.0,0.0
21878,9252,8,9252,397,8,0,11.11111111111111,87.74
21879,516,13,516,239,11,2,9.090909090909092,0.0
21880,78120,49,0,2520,34,15,100.0,0.0
21881,3120,21,3120,906,18,3,7.142857142857143,0.45
21882,5844336,56,0,107188,47,9,50.0,0.0
21883,9787728,6131,0,5165315,3494,2637,1.0,0.0
21884,3961560,116,0,92290,62,54,2.631578947368421,0.0
21885,420,29,324,162,17,12,25.0,99.09
21886,5004,23,5004,735,21,2,6.25,76.63
21887,3636,13,3636,280,10,3,16.666666666666668,87.35
21888,70344,23,70344,1934,18,5,7.6923076923076925,52.94
21889,550116,811,289530,13870,602,209,1.0,31.58
21890,3984,0,3984,0,0,0,100.0,100.0
21891,83148,35,83148,10553,30,5,5.2631578947368425,81.98
21892,1848,11,108,362,9,2,12.5,97.41
21893,744,10,744,344,8,2,16.666666666666668,89.39
21894,7871892,1016,5888904,4575009,409,607,1.639344262295082,0.0
21895,4320,174,0,1886,105,69,50.0,0.0
21896,804,34,804,162,24,10,5.882352941176471,75.01
21897,6648,23,6648,746,20,3,7.142857142857143,1.32
21898,68808,11,68808,1150,10,1,14.285714285714286,16.86
21899,8596596,5500,5180052,31041,2388,3112,1.0,0.0
21900,21732,39,0,1881,32,7,100.0,0.0
21901,804300,386,804300,200052,242,144,1.0,33.53
21902,72636,97,0,3074,81,16,50.0,0.0
21903,8331072,24,8331072,27952,16,8,5.2631578947368425,82.92
21904,4572,92,0,2578,73,19,100.0,0.0
21905,6024,21,6024,1281,19,2,7.6923076923076925,81.72
21906,6972,26,6972,672,18,8,7.6923076923076925,0.0
21907,2580,18,2580,579,16,2,7.6923076923076925,0.0
21908,1284,44,1284,29,44,0,2.2222222222222223,57.38
21909,7567116,39,4452,194260,34,5,3.0303030303030303,38.87
21910,9995544,1807,0,3122794,1059,748,1.0,0.0
21911,2644548,189,2627994,23616,97,92,1.818181818181818,58.65
21912,948,82,912,368,50,32,7.142857142857143,91.02
21913,228,16,108,77,13,3,7.142857142857143,77.22
21914,13080,54,0,2460,44,10,100.0,0.0
21915,78756,75,0,2867,55,20,50.0,0.0
21916,73944,10,0,16693,9,1,10.0,0.0
21917,6857832,81,0,504590,39,42,4.3478260869565215,0.0
21918,9600600,2692,1302732,1328395,1147,1545,1.0,3.72
21919,18024,9,18024,650,7,2,16.666666666666668,85.1
21920,7152,28,7152,1449,20,8,7.142857142857143,0.0
21921,204,1,204,204,1,0,50.0,99.53
21922,1704,0,1704,0,0,0,50.0,75.0
21923,6307608,91,87240,105459,78,13,1.4492753623188406,19.12
21924,504,15,324,204,13,2,7.6923076923076925,0.0
21925,84180,46,0,2819,31,15,100.0,0.0
21926,17544,22,17544,632,20,2,5.882352941176471,77.77
21927,6720,78,6720,730,78,0,50.0,41.31
21928,82296,1,82296,47952,1,0,100.0,0.0
21929,41004,3,41004,588,2,1,50.0,99.51
21930,516,12,516,101,11,1,9.090909090909092,99.6
21931,15000,22,15000,998,21,1,5.555555555555555,72.95
21932,168,28,144,39,16,12,16.666666666666668,97.39
21933,29568,6,29568,522,5,1,20.0,34.68
21934,3300,28,3300,961,23,5,5.0,0.0
21935,108,16,108,6,14,2,6.666666666666667,44.58
21936,6396,14,0,888,11,3,50.0,99.0
21937,3828,10,372,573,9,1,11.11111111111111,0.0
21938,15372,25,15372,1214,21,4,6.666666666666667,0.0
21939,744,12,744,118,9,3,20.0,50.88
21940,75948,56,0,3654,46,10,50.0,0.0
21941,6539028,142,0,1665681,66,76,8.333333333333334,0.0
21942,35256,67,35256,1514,62,5,1.639344262295082,17.75
21943,7964148,180,7964148,1537,128,52,1.0309278350515465,30.29
21944,429108,43,429108,50714,37,6,2.857142857142857,0.0
21945,3204,14,3204,746,13,1,8.333333333333334,0.0
21946,8677572,147,0,129534,68,79,4.761904761904762,4.75
21947,156,40,156,7,36,4,2.7777777777777777,34.44
21948,9624,47,0,1258,29,18,100.0,0.0
21949,10012632,7379,0,4602014,4179,3200,1.0,0.0
21950,7329732,1307,0,33308,745,562,1.0,16.0
21951,180,15,180,91,12,3,8.333333333333334,49.28
21952,2232,26,2232,523,20,6,9.090909090909092,0.0
21953,168,8,168,82,3,5,50.0,75.26
21954,199596,224,0,1881,105,119,5.555555555555555,0.0
21955,3852,64,264,187,37,27,6.25,80.08
21956,9782880,706,0,741911,373,333,1.7857142857142858,0.0
21957,180,2,180,12,2,0,33.333333333333336,92.49
21958,9992796,3337,285368,956078,2059,1278,1.0,0.0
21959,27624,60,0,5472,36,24,100.0,0.0
21960,74172,8,74172,2202,6,2,12.5,82.85
21961,55428,29,0,2448,22,7,100.0,100.0
21962,9444,262,348,453,164,98,1.2195121951219512,19.02
21963,3036,25,2820,1184,21,4,7.6923076923076925,0.81
21964,93924,48,0,5863,40,8,100.0,0.0
21965,5190576,3,1260,1730716,1,2,25.0,89.28
21966,6180,6,432,1696,3,3,100.0,100.0
21967,38004,31,38004,9745,20,11,12.5,92.19
21968,1956,12,1956,171,12,0,8.333333333333334,95.75
21969,2376,65,732,307,34,31,7.142857142857143,85.25
21970,240,36,240,101,30,6,6.666666666666667,91.31
21971,132,0,132,0,0,0,50.0,80.0
21972,168,51,84,38,44,7,2.380952380952381,0.0
21973,9080520,642,0,203888,323,319,2.3255813953488373,0.0
21974,180,9,180,76,9,0,9.090909090909092,91.53
21975,59856,12,0,5198,8,4,100.0,100.0
21976,3828,27,3828,846,23,4,6.25,0.71
21977,468,68,168,120,53,15,2.5,40.75
21978,588,95,552,244,59,36,4.761904761904762,60.55
21979,96,9,60,37,6,3,100.0,100.0
21980,41088,47,0,2585,31,16,100.0,0.0
21981,96,0,96,0,0,0,50.0,80.0
21982,153492,2,153492,534,2,0,25.0,72.76
21983,180,39,168,58,25,14,5.555555555555555,81.24
21984,804,11,804,91,6,5,33.333333333333336,59.52
21985,5064,14,0,674,10,4,100.0,100.0
21986,396,197,396,132,111,86,1.4492753623188406,61.7
21987,132,50,72,26,45,5,2.272727272727273,0.0
21988,5988,11,5988,41,11,0,7.6923076923076925,53.68
21989,480,205,480,248,141,64,1.7543859649122806,72.14
21990,1560,9,1560,701,6,3,20.0,96.94
21991,942084,81,942084,11799,44,37,8.333333333333334,0.0
21992,50280,2,50280,1050,2,0,25.0,68.62
21993,131112,68,456,2221,57,11,2.380952380952381,55.02
21994,13416,79,0,975,47,32,50.0,0.0
21995,33468,70,0,3770,57,13,100.0,0.0
21996,1032,0,1032,0,0,0,100.0,100.0
21997,241092,17,241092,4905,9,8,50.0,95.51
21998,41904,2,41904,186,2,0,25.0,57.81
21999,9859824,859,0,157932,389,470,1.408450704225352,0.0
22000,528,6,528,44,3,3,100.0,100.0
22001,2832,109,0,870,68,41,50.0,0.0
22002,1056,5,1056,261,5,0,25.0,98.73
22003,6540,54,0,885,46,8,33.333333333333336,79.99
22004,157848,364,0,2718,211,153,100.0,0.0
22005,720,10,720,205,8,2,12.5,74.62
22006,288,0,288,0,0,0,100.0,100.0
22007,15072,150,1044,358,118,32,1.351351351351351,33.08
22008,372,13,372,120,10,3,12.5,93.83
22009,216,13,168,79,11,2,9.090909090909092,82.62
22010,776040,6,776040,13332,4,2,20.0,95.26
22011,2055408,41,0,69282,19,22,14.285714285714286,0.0
22012,504,97,444,164,57,40,4.3478260869565215,80.74
22013,23988,145,0,1831,101,44,1.36986301369863,0.0
22014,75600,643,69492,525,405,238,1.0,0.0
22015,3684,4,3684,105,4,0,25.0,0.15
22016,696,3,696,216,3,0,25.0,95.71
22017,51948,29,51948,1889,29,0,3.4482758620689653,10.37
22018,81576,151,81576,4223,111,40,1.5384615384615383,3.11
22019,5940,0,5940,0,0,0,100.0,100.0
22020,3624,76,0,1072,51,25,50.0,0.0
22021,552,27,552,85,21,6,5.555555555555555,69.45
22022,7630140,90,0,374972,40,50,10.0,2.0
22023,28944,112,0,1078,80,32,100.0,0.0
22024,3192,13,3192,1093,13,0,7.6923076923076925,33.36
22025,23712,87,0,1226,60,27,100.0,0.0
22026,1296,0,1296,0,0,0,100.0,100.0
22027,804,2,804,126,2,0,33.333333333333336,99.34
22028,1536,5,1536,225,5,0,20.0,82.55
22029,10260,5,10260,319,3,2,50.0,99.45
22030,33060,171,0,1232,117,54,100.0,0.0
22031,4639320,9,1332,515781,5,4,33.333333333333336,93.99
22032,10038660,3321,0,2239198,1899,1422,1.0,0.6
22033,72480,10,72480,32013,4,6,33.333333333333336,99.45
22034,1080,2,1080,30,2,0,25.0,55.64
22035,47544,3,132,15900,2,1,33.333333333333336,96.52
22036,2959512,496,0,95474,266,230,2.631578947368421,4.0
22037,3672,177,0,361,122,55,1.639344262295082,0.0
22038,9960348,11388,386196,2181558,6422,4966,1.0,0.0
22039,132,1,132,12,1,0,50.0,79.84
22040,65448,3,65448,276,3,0,33.333333333333336,98.91
22041,2652,24,2652,511,24,0,4.166666666666667,7.77
22042,3606948,16,98832,394848,11,5,9.090909090909092,0.0
22043,240,16,204,165,12,4,11.11111111111111,50.92
22044,136980,2,60328,6300,1,1,50.0,55.8
22045,1740,221,1740,174,142,79,1.0,19.79
22046,25476,27,25476,2879,24,3,6.666666666666667,0.9
22047,480,68,0,105,44,24,100.0,0.0
22048,9628092,52,9628092,1506,20,32,16.666666666666668,95.38
22049,300,28,264,75,27,1,3.8461538461538463,84.05
22050,1356,9,1356,745,9,0,9.090909090909092,12.68
22051,216,3,216,48,2,1,50.0,99.5
22052,336,34,204,108,27,7,5.882352941176471,78.03
22053,516,39,516,124,23,16,5.882352941176471,59.05
22054,348,24,324,72,20,4,7.142857142857143,45.35
22055,1170084,104,1170084,523,92,12,1.1904761904761905,9.66
22056,2558724,52,2558724,99235,20,32,20.0,85.28
22057,612,28,0,140,19,9,50.0,0.0
22058,5669412,495,0,36427,255,240,1.6666666666666667,2.0
22059,2901696,167,2901696,3833,80,87,4.545454545454546,0.0
22060,768,0,768,0,0,0,50.0,64.0
22061,216,0,216,0,0,0,50.0,59.5
22062,456,46,456,22,44,2,2.272727272727273,62.79
22063,720,126,0,108,109,17,1.0,0.0
22064,7774152,399,6637452,278500,219,180,1.0,59.8
22065,59232,2,4836,29634,1,1,33.333333333333336,95.07
22066,3816,1,3816,1044,1,0,50.0,99.61
22067,768,18,768,518,18,0,5.0,68.27
22068,26436,2,26436,528,1,1,100.0,100.0
22069,3264,22,3264,885,22,0,4.166666666666667,41.04
22070,252,7,252,27,4,3,50.0,99.93
22071,11292,123,0,1113,87,36,100.0,0.0
22072,13224,104,0,809,61,43,50.0,0.0
22073,5076,28,5076,1905,24,4,7.142857142857143,0.35
22074,2040,14,0,606,10,4,100.0,0.0
22075,6677940,67,480,199380,56,11,1.96078431372549,57.68
22076,157212,17,157212,7706,15,2,7.142857142857143,6.94
22077,516,100,516,135,82,18,1.5625,37.65
22078,372,18,372,105,16,2,6.25,39.14
22079,780,135,780,175,105,30,1.2048192771084338,29.75
22080,6180,20,4020,712,15,5,8.333333333333334,93.88
22081,18000,150,0,1062,105,45,100.0,0.0
22082,6372,9,1524,1206,5,4,25.0,86.05
22083,840,54,840,29,50,4,2.0,53.23
22084,4925892,692,1043978,45383,503,189,1.0,0.0
22085,35208,127,0,916,99,28,50.0,0.0
22086,37464,17,0,2608,12,5,100.0,100.0
22087,96432,51,888,1928,51,0,3.0303030303030303,54.33
22088,35676,12,35676,23044,9,3,14.285714285714286,89.89
22089,131580,85,131580,10028,73,12,2.857142857142857,23.55
22090,7968,162,0,594,116,46,100.0,0.0
22091,44652,71,44652,2177,64,7,1.5625,18.75
22092,309468,16,309468,59851,14,2,11.11111111111111,1.06
22093,9503136,838,9503136,62353,351,487,1.4492753623188406,71.85
22094,564,55,564,38,52,3,1.8867924528301887,58.37
22095,840,47,840,36,47,0,2.9411764705882355,64.29
22096,2664,156,0,756,95,61,50.0,0.0
22097,71724,22,2508,9471,14,8,1.0,83.78
22098,12036,86,0,2242,53,33,100.0,0.0
22099,1265724,69,132,158448,31,38,1.0,0.0
22100,5976,33,5976,288,33,0,3.225806451612903,25.76
22101,1200,329,1176,599,226,103,1.0,0.0
22102,5503956,29,0,233507,19,10,1.408450704225352,6.76
22103,2052,2,2052,132,2,0,100.0,100.0
22104,52632,18,0,3368,14,4,100.0,100.0
22105,13668,29,13668,694,25,4,7.142857142857143,5.24
22106,175188,13,0,37461,10,3,100.0,100.0
22107,55188,48,0,3354,33,15,100.0,0.0
22108,2921028,36,2921028,17083,15,21,8.333333333333334,0.0
22109,2856,22,2856,658,20,2,7.142857142857143,33.34
22110,500052,23,500052,1145,20,3,4.761904761904762,81.89
22111,948,95,900,217,89,6,2.272727272727273,34.81
22112,1344,40,0,525,35,5,50.0,0.0
22113,3864,22,3864,889,19,3,7.6923076923076925,0.4
22114,139812,66,0,7695,52,14,33.333333333333336,0.0
22115,502008,8,0,239857,2,6,100.0,0.0
22116,82044,55,82044,17890,47,8,4.761904761904762,61.82
22117,18684,23,18684,4707,15,8,14.285714285714286,20.96
22118,732,58,420,262,41,17,5.0,64.24
22119,52356,50,0,2187,35,15,100.0,0.0
22120,46068,67,0,5808,53,14,100.0,0.0
22121,83760,50,0,2973,38,12,50.0,0.0
22122,22164,1,22164,1584,1,0,100.0,100.0
22123,0,0,0,0,0,0,50.0,20.0
22124,75180,48,0,2209,40,8,50.0,50.0
22125,7248,25,7248,1275,22,3,7.142857142857143,1.76
22126,108,25,108,35,18,7,7.6923076923076925,89.12
22127,4773516,44,0,328645,35,9,33.333333333333336,0.0
22128,533172,27,533172,31232,16,11,33.333333333333336,99.01
22129,9037884,1333,0,346981,734,599,1.0416666666666667,0.0
22130,10656,25,10608,1321,22,3,5.2631578947368425,70.39
22131,29436,99,29436,4743,82,17,1.408450704225352,19.71
22132,2916,33,2916,865,26,7,7.142857142857143,0.31
22133,9624,41,9624,2886,40,1,7.142857142857143,80.03
22134,816,0,816,0,0,0,50.0,64.0
22135,4904400,14,0,593660,8,6,33.333333333333336,0.0
22136,9104964,2342,0,115349,1297,1045,1.0,0.0
22137,27552,55,27552,1582,51,4,2.0,22.3
22138,720,13,288,68,12,1,8.333333333333334,49.59
22139,8823300,35,0,253280,18,17,16.666666666666668,0.0
22140,10049964,382,0,196128,196,186,3.125,3.62
22141,288,50,288,63,36,14,3.225806451612903,37.79
22142,10091208,72696,5806036,4248355,44987,27709,1.0,0.0
22143,2784,49,0,676,27,22,100.0,0.0
22144,3048,27,3048,866,23,4,7.142857142857143,0.21
22145,108,1,108,12,1,0,33.333333333333336,78.0
22146,11484,64,1080,6328,46,18,100.0,0.0
22147,21036,43,0,2191,28,15,100.0,0.0
22148,8784,21,8784,653,20,1,5.2631578947368425,73.59
22149,492,4,492,108,2,2,100.0,100.0
22150,2676,32,2676,1026,26,6,6.666666666666667,0.46
22151,9249096,737,0,1453824,410,327,1.639344262295082,0.0
22152,281436,139,0,16574,66,73,5.555555555555555,0.0
22153,3228,32,3228,906,27,5,7.6923076923076925,0.87
22154,14904,15,0,1503,12,3,100.0,0.0
22155,1435896,99,1435896,40935,63,36,3.125,68.13
22156,7152,31,0,438,28,3,100.0,0.0
22157,26880,5,26880,948,4,1,50.0,96.98
22158,19632,55,0,1890,45,10,100.0,0.0
22159,20868,50,0,1390,35,15,100.0,0.0
22160,158292,34,0,44223,29,5,4.0,0.0
22161,756,7,756,444,7,0,50.0,58.44
22162,120,54,84,33,41,13,3.8461538461538463,61.66
22163,4380,64,0,2486,55,9,100.0,100.0
22164,9576,13,0,1288,11,2,100.0,100.0
22165,7597752,29,0,281088,21,8,10.0,0.0
22166,2628684,75,2628684,31664,38,37,11.11111111111111,86.65
22167,15876,44,0,4168,37,7,100.0,0.0
22168,48144,19,48144,222,14,5,7.6923076923076925,89.56
22169,1320,227,1296,473,138,89,1.3157894736842106,28.77
22170,3564,14,3564,1170,12,2,14.285714285714286,0.0
22171,1152,22,1152,327,22,0,5.555555555555555,74.29
22172,3360,4,3360,600,2,2,33.333333333333336,95.88
22173,8861496,247,0,41985,132,115,3.333333333333333,0.0
22174,116208,0,116208,0,0,0,100.0,100.0
22175,51624,24,0,2796,19,5,100.0,100.0
22176,22380,6,22380,790,6,0,16.666666666666668,94.21
22177,9362604,69,0,407952,57,12,33.333333333333336,0.0
22178,9398364,119,4768002,35133,49,70,9.090909090909092,55.08
22179,21144,50,0,1314,35,15,100.0,0.0
22180,1248,5,1248,278,5,0,14.285714285714286,74.97
22181,1164,65,1164,413,39,26,9.090909090909092,77.74
22182,908136,28,0,33659,23,5,50.0,0.0
22183,83988,3,83988,5032,2,1,33.333333333333336,78.17
22184,1716,48,0,739,42,6,50.0,59.99
22185,5867928,701,0,93035,404,297,1.5384615384615383,29.98
22186,35088,86,35088,71,84,2,2.2222222222222223,60.37
22187,240,10,228,96,6,4,20.0,57.21
22188,600,96,600,71,95,1,1.7857142857142858,52.49
22189,80748,123,0,2550,96,27,50.0,0.0
22190,324,32,324,20,32,0,3.125,69.74
22191,480,18,480,133,14,4,10.0,90.43
22192,88032,416,0,4354,255,161,100.0,0.0
22193,34356,9,34356,590,7,2,20.0,54.05
22194,600,25,600,212,15,10,11.11111111111111,48.47
22195,72,0,72,0,0,0,50.0,73.08
22196,51240,23,51240,2256,23,0,5.0,9.6
22197,252,121,192,82,83,38,2.2222222222222223,79.34
22198,1272,116,0,467,101,15,100.0,0.0
22199,131376,141,44976,3742,103,38,1.639344262295082,4.28
22200,62112,97,0,1942,65,32,100.0,0.0
22201,408,28,408,107,23,5,5.2631578947368425,72.08
22202,372,7,324,210,5,2,20.0,98.23
22203,480,100,0,213,76,24,25.0,0.0
22204,9561012,1777,0,67082,1066,711,1.0,0.0
22205,4644,84,4644,1034,84,0,33.333333333333336,55.83
22206,768,15,768,200,13,2,8.333333333333334,76.35
22207,296568,11,296568,1345,6,5,50.0,99.05
22208,2688,77,1596,285,47,30,5.555555555555555,72.44
22209,12072,17,0,1901,16,1,50.0,0.0
22210,2808,114,0,815,73,41,4.761904761904762,0.0
22211,15288,53,0,2092,44,9,100.0,0.0
22212,1176,119,1176,401,76,43,2.857142857142857,86.57
22213,228,2,228,36,2,0,100.0,100.0
22214,48,18,48,19,13,5,10.0,71.16
22215,504,5,504,158,3,2,25.0,0.0
22216,324,3,324,100,3,0,100.0,100.0
22217,288,4,288,93,4,0,20.0,95.92
22218,3204,108,0,849,70,38,50.0,0.0
22219,3468,187,0,827,156,31,100.0,0.0
22220,2796,36,0,797,27,9,100.0,0.0
22221,73152,119,0,1636,82,37,100.0,0.0
22222,35892,25,35892,2991,23,2,6.666666666666667,0.0
22223,2160,10,1716,288,9,1,11.11111111111111,89.27
22224,10356,14,10356,534,14,0,5.882352941176471,1.5
22225,9015288,297,0,275954,141,156,3.333333333333333,0.0
22226,2982084,96,2982084,61650,41,55,7.6923076923076925,0.0
22227,2184,92,0,676,62,30,50.0,0.0
22228,132,31,108,59,22,9,5.555555555555555,59.14
22229,456,36,420,253,25,11,7.142857142857143,83.92
22230,4812,0,4812,0,0,0,50.0,0.48
22231,360,5,360,76,4,1,50.0,96.81
22232,2151420,142,2964,29690,110,32,1.851851851851852,0.0
22233,9895488,2979,2038440,2436096,1761,1218,1.0,20.29
22234,9891624,2654,147244,85815,1557,1097,1.0,50.0
22235,7164,70,7164,610,33,37,11.11111111111111,91.03
22236,2232,16,2232,429,16,0,7.142857142857143,13.05
22237,3012,0,3012,0,0,0,100.0,75.0
22238,2616,179,0,726,138,41,50.0,0.0
22239,77508,136,0,1901,95,41,1.5151515151515151,0.0
22240,852,10,0,364,3,7,100.0,100.0
22241,9264,166,0,1519,112,54,100.0,0.0
22242,7824,22,7824,673,20,2,5.555555555555555,77.35
22243,140832,45,140832,24178,44,1,2.3255813953488373,25.4
22244,4668,85,0,1340,52,33,100.0,0.0
22245,10133964,13065,6660969,6109479,7496,5569,1.0,0.0
22246,252,61,252,120,31,30,5.555555555555555,59.6
22247,13824,235,0,1494,164,71,100.0,0.0
22248,9926400,595,4644600,118766,318,277,1.0,15.0
22249,120,1,120,36,1,0,100.0,100.0
22250,5401740,255,0,56757,156,99,2.2222222222222223,0.0
22251,792,0,792,0,0,0,100.0,0.0
22252,5088,18,5088,1496,18,0,5.882352941176471,10.68
22253,120,26,48,31,18,8,7.6923076923076925,36.23
22254,9662028,65,5942072,2036645,36,29,3.703703703703704,0.0
22255,6022548,105,6022548,108805,44,61,5.882352941176471,81.22
22256,135660,98,9828,5960,64,34,4.761904761904762,14.84
22257,6431976,4188,125603,68097,2433,1755,1.0,0.04
22258,47400,5,288,9624,3,2,50.0,99.93
22259,9115008,661,3936120,96814,351,310,2.2222222222222223,0.0
22260,59352,4,59352,438,2,2,100.0,100.0
22261,8124,24,8124,915,23,1,5.2631578947368425,69.96
22262,3360,10,3360,1610,10,0,6.25,3.92
22263,16932,127,0,1134,85,42,100.0,0.0
22264,17508,21,17508,933,20,1,9.090909090909092,22.83
22265,4308,2,4308,3132,1,1,11.11111111111111,7.0
22266,1416,11,1416,437,11,0,9.090909090909092,89.76
22267,852,29,852,308,19,10,10.0,93.22
22268,3444,19,3444,364,18,1,5.555555555555555,73.2
22269,14508,3,14508,204,2,1,50.0,99.14
22270,5801928,119,103344,60326,77,42,1.0,66.93
22271,5412,19,5412,2192,19,0,5.555555555555555,12.87
22272,28080,62,0,3622,52,10,50.0,0.0
22273,238008,16,238008,12810,14,2,8.333333333333334,68.15
22274,444,2,444,246,2,0,33.333333333333336,98.45
22275,4716,19,4716,882,16,3,10.0,2.03
22276,8615772,2375,0,189942,1310,1065,1.0,0.0
22277,15288,175,0,1281,121,54,100.0,0.0
22278,156,0,156,0,0,0,100.0,100.0
22279,25812,56,72,972,38,18,3.8461538461538463,57.38
22280,16668,3,16668,2092,3,0,25.0,89.22
22281,6288,30,0,1222,24,6,100.0,0.0
22282,3461160,57,3461160,46208,30,27,5.555555555555555,60.23
22283,177432,12,177432,11456,8,4,33.333333333333336,0.0
22284,100212,14,0,7482,10,4,100.0,100.0
22285,98292,14,5142,15072,6,8,4.166666666666667,5.98
22286,60420,77,60420,3185,71,6,1.5151515151515151,17.61
22287,4344,21,4344,957,19,2,7.6923076923076925,0.89
22288,20292,163,0,1252,122,41,1.162790697674419,0.0
22289,396,1,396,36,1,0,50.0,99.9
22290,9283968,602,0,278398,283,319,2.3255813953488373,4.76
22291,35364,86,0,1102,67,19,100.0,0.0
22292,300,26,180,56,18,8,7.142857142857143,75.48
22293,95712,22,1704,13434,18,4,7.142857142857143,0.9
22294,9718104,648,0,41574,368,280,1.3333333333333333,0.0
22295,12060,24,12060,891,23,1,4.761904761904762,70.75
22296,1212,70,972,230,69,1,3.333333333333333,65.7
22297,72756,103,72756,8358,89,14,1.3157894736842106,17.92
22298,17388,0,17388,0,0,0,100.0,0.0
22299,2088,90,0,772,65,25,100.0,0.0
22300,2352,2,2352,342,1,1,100.0,0.0
22301,2016,31,2016,661,26,5,8.333333333333334,0.0
22302,55572,10,55572,937,9,1,20.0,95.34
22303,276,32,156,84,24,8,5.0,68.43
22304,59472,26,0,5933,19,7,50.0,0.0
22305,10164168,6163,1551480,361776,3352,2811,1.0,0.0
22306,72816,2,72816,36384,1,1,50.0,68.09
22307,969996,73,37644,14647,72,1,33.333333333333336,73.55
22308,609396,65,0,189815,48,17,2.083333333333333,0.0
22309,9221544,279,5005656,48168,144,135,3.571428571428572,81.83
22310,5330940,44,3790332,36310,22,22,33.333333333333336,0.09
22311,8520732,386,0,265280,199,187,1.075268817204301,0.78
22312,8040,21,8040,684,20,1,5.555555555555555,76.47
22313,3108,75,3108,1069,72,3,5.2631578947368425,64.26
22314,780,1,780,480,1,0,33.333333333333336,0.0
22315,3902532,42,3229434,102108,34,8,3.8461538461538463,87.46
22316,65904,70,0,7927,41,29,50.0,0.0
22317,8967792,415,0,156789,173,242,3.0303030303030303,3.74
22318,2838924,48,1440102,839668,40,8,2.9411764705882355,88.22
22319,96864,4,8220,26136,3,1,16.666666666666668,81.73
22320,9665328,1610,0,600555,701,909,1.0,0.0
22321,20544,64,0,2869,55,9,100.0,0.0
22322,456,3,0,204,1,2,100.0,0.0
22323,207768,4,59442,105765,3,1,33.333333333333336,89.83
22324,12792,21,12792,1058,19,2,7.142857142857143,25.36
22325,14532,22,14532,764,22,0,5.0,69.36
22326,9533484,499,9530615,1708830,187,312,1.6129032258064515,2.71
22327,180,15,132,100,7,8,1.0,0.0
22328,156,24,156,44,22,2,4.545454545454546,42.67
22329,1236,25,1236,491,13,12,25.0,75.72
22330,36252,27,36252,4160,22,5,6.666666666666667,46.14
22331,9432,97,9432,905,97,0,25.0,40.25
22332,1128,21,1128,504,21,0,4.3478260869565215,79.76
22333,48348,190,48348,11723,110,80,4.166666666666667,0.0
22334,1572,30,1572,1180,24,6,4.545454545454546,75.17
22335,11628,43,0,2189,29,14,50.0,0.0
22336,672,28,672,21,24,4,5.0,76.17
22337,4296,92,4296,1249,92,0,33.333333333333336,46.22
22338,15492,13,216,5012,10,3,3.333333333333333,0.0
22339,58572,8,0,11074,5,3,100.0,100.0
22340,958248,656,958248,20644,331,325,2.5,1.56
22341,348,4,348,90,3,1,20.0,0.0
22342,104892,46,104892,4294,37,9,3.0303030303030303,17.81
22343,1378512,565,361066,102589,307,258,1.0,5.83
22344,83640,44,0,4700,31,13,100.0,0.0
22345,13656,4,0,5223,2,2,100.0,100.0
22346,636,6,636,140,2,4,33.333333333333336,56.6
22347,16200,46,0,2405,40,6,100.0,0.0
22348,2576268,1412,2576268,13229,796,616,1.2195121951219512,72.28
22349,492,25,492,122,23,2,5.2631578947368425,48.93
22350,5208816,342,5208600,198590,171,171,2.631578947368421,0.0
22351,828,27,828,90,20,7,6.666666666666667,55.53
22352,3108,3,3108,1800,3,0,33.333333333333336,99.19
22353,8052180,469,6103812,56545,286,183,1.0,50.71
22354,18384,24,312,920,20,4,6.25,82.61
22355,1572,36,0,521,27,9,100.0,0.0
22356,37980,164,0,1228,123,41,100.0,0.0
22357,1884,3,0,1244,2,1,100.0,0.0
22358,3756,0,3756,0,0,0,100.0,100.0
22359,31800,399,6816,2334,219,180,1.3157894736842106,26.56
22360,3936,18,3936,1772,15,3,9.090909090909092,93.34
22361,4188,232,0,850,180,52,100.0,0.0
22362,6063384,313,5903262,22935,159,154,2.380952380952381,0.0
22363,2117544,52,0,42613,46,6,50.0,0.0
22364,71448,20,71448,649,10,10,50.0,99.98
22365,4315872,79,4315872,62526,38,41,14.285714285714286,95.42
22366,5748,31,0,1613,21,10,100.0,100.0
22367,10195620,7187,409212,2094661,3909,3278,1.0,0.26
22368,696,15,696,173,11,4,11.11111111111111,35.24
22369,2566116,33,2566116,2430,19,14,25.0,77.59
22370,43020,22,0,2299,17,5,100.0,100.0
22371,1152,6,1152,0,6,0,100.0,100.0
22372,2424,135,0,525,128,7,100.0,0.0
22373,176208,134,0,19036,67,67,6.25,0.0
22374,3396,16,0,414,15,1,33.333333333333336,0.0
22375,10029156,2281,1689532,64539,1304,977,1.020408163265306,0.0
22376,1212,52,1032,240,29,23,7.6923076923076925,94.73
22377,7361520,251,0,91126,131,120,3.4482758620689653,0.0
22378,828,142,828,186,101,41,1.492537313432836,0.27
22379,9330732,178,3351624,347922,59,119,1.0,28.46
22380,95964,8,93060,45190,5,3,12.5,20.76
22381,432,6,0,126,3,3,100.0,100.0
22382,39048,152,39048,3770,124,28,1.1235955056179776,3.59
22383,3720,64,3720,800,63,1,33.333333333333336,64.87
22384,936,0,936,0,0,0,100.0,100.0
22385,4752,5,0,1965,2,3,33.333333333333336,0.0
22386,180,5,180,45,3,2,25.0,88.16
22387,4440,1,324,4440,1,0,10.0,10.32
22388,456264,23,456264,34876,15,8,12.5,88.25
22389,52284,111,0,1330,81,30,100.0,0.0
22390,1176,17,1176,292,17,0,5.555555555555555,59.91
22391,624,88,624,470,48,40,3.4482758620689653,46.34
22392,23964,98,0,1263,77,21,1.851851851851852,0.0
22393,10210668,4031,1227276,1753845,2273,1758,1.0,0.0
22394,165396,30,0,15553,24,6,100.0,0.0
22395,1152,41,1152,174,33,8,3.225806451612903,51.23
22396,2352,21,0,934,18,3,100.0,0.0
22397,307440,5,198776,61464,3,2,100.0,100.0
22398,15996,21,384,800,17,4,5.555555555555555,72.65
22399,1704,89,1704,780,78,11,1.7241379310344829,93.49
22400,4980,73,4980,855,71,2,1.5151515151515151,55.88
22401,4296,4,1416,1080,3,1,25.0,80.36
22402,4836,30,4836,2575,29,1,6.25,15.08
22403,58260,16,58260,1211,16,0,7.6923076923076925,9.8
22404,228504,124,0,60135,73,51,3.703703703703704,3.55
22405,3624,75,3624,351,57,18,1.8867924528301887,61.11
22406,10161216,739,0,3514079,416,323,1.0,0.0
22407,1452,9,756,317,8,1,11.11111111111111,55.46
22408,1548,5,0,352,2,3,100.0,0.0
22409,21468,88,0,712,66,22,2.380952380952381,0.0
22410,8894592,423,0,2837115,231,192,1.0,0.83
22411,1164,22,1164,97,22,0,4.3478260869565215,82.2
22412,93492,29,15156,4127,23,6,5.882352941176471,99.14
22413,8843124,2730,8843124,3914622,1189,1541,1.0,41.34
22414,17136,3,17136,0,3,0,100.0,100.0
22415,2604,62,0,234,43,19,100.0,0.0
22416,372,31,372,95,25,6,4.545454545454546,80.32
22417,2723808,79,0,69286,36,43,6.25,0.0
22418,96,29,96,31,27,2,3.571428571428572,33.81
22419,7515864,152,0,160124,69,83,5.882352941176471,0.0
22420,9797616,116,9797616,271089,55,61,5.882352941176471,79.54
22421,15480,4,0,8142,2,2,100.0,0.0
22422,9956616,132,0,671462,68,64,2.631578947368421,0.0
22423,132,0,132,0,0,0,100.0,100.0
22424,7517880,126,0,229786,60,66,4.3478260869565215,0.0
22425,9798336,154,0,172734,82,72,5.0,0.0
22426,552,72,0,157,32,40,100.0,0.0
22427,6960,54,0,387,43,11,100.0,0.0
22428,21108,142,0,940,112,30,100.0,0.0
22429,7498716,259,2426412,66500,146,113,1.7857142857142858,10.0
22430,300,66,300,54,59,7,1.9230769230769231,35.82
22431,600,3,600,64,3,0,50.0,94.8
22432,1788,19,0,312,10,9,100.0,0.0
22433,48024,183,552,532,112,71,1.0309278350515465,31.85
22434,10218876,1821,3855932,4955916,1018,803,1.0,0.0
22435,10536,220,0,567,164,56,1.0,0.0
22436,108,65,72,31,51,14,2.702702702702702,77.86
22437,4368,36,4368,1073,36,0,3.0303030303030303,13.35
22438,960,1,960,228,1,0,50.0,98.29
22439,9998604,3114,0,1824782,1469,1645,1.0,0.0
22440,7596,15,7596,641,15,0,6.666666666666667,12.97
22441,1260408,1273,0,25141,717,556,1.1363636363636365,0.0
22442,9805404,123,9805404,302392,55,68,4.3478260869565215,79.83
22443,6421788,152,0,157528,78,74,3.571428571428572,0.0
22444,6612,91,0,446,65,26,2.380952380952381,2.5
22445,696,40,0,212,39,1,100.0,0.0
22446,912,2,912,222,2,0,25.0,69.54
22447,168,2,168,78,1,1,100.0,100.0
22448,756,38,756,89,28,10,5.555555555555555,81.82
22449,276,86,204,117,76,10,1.851851851851852,58.82
22450,4560,49,0,256,34,15,4.166666666666667,0.0
22451,2678820,20,2678820,4198,11,9,9.090909090909092,0.0
22452,3372,19,3372,975,19,0,5.555555555555555,11.02
22453,2940,63,2808,650,42,21,3.703703703703704,0.0
22454,5736,139,0,741,113,26,100.0,0.0
22455,225744,108,594,4608,67,41,1.0,0.1
22456,3595752,49,3595752,13884,34,15,4.545454545454546,44.72
22457,2304,27,0,148,26,1,4.3478260869565215,10.0
22458,10039452,1155,0,184424,605,550,1.0,0.0
22459,5088,20,5088,1825,20,0,5.882352941176471,9.85
22460,1668,75,0,244,47,28,100.0,0.0
22461,9120,351,0,781,294,57,1.0,0.0
22462,9722952,574,0,108157,303,271,1.7241379310344829,0.0
22463,3936,11,3936,268,11,0,10.0,92.47
22464,44136,199,0,671,144,55,1.0526315789473684,3.0
22465,4128,36,4128,965,26,10,6.666666666666667,0.0
22466,9913812,123,0,667482,58,65,7.6923076923076925,0.0
22467,204,1,204,24,1,0,50.0,99.52
22468,9591744,360,0,31171,184,176,2.4390243902439024,3.8
22469,8832,246,0,615,194,52,100.0,0.0
22470,126312,49,0,3642,28,21,10.0,0.0
22471,492,4,492,234,3,1,25.0,77.15
22472,6792,3,0,2376,1,2,50.0,0.1
22473,10222896,1711,0,4406714,1213,498,1.0,0.0
22474,120,17,72,52,14,3,8.333333333333334,76.14
22475,1068,1,1068,132,1,0,100.0,100.0
22476,69804,78,69804,89,54,24,2.272727272727273,50.33
22477,9465564,1115,0,61666,645,470,1.0,0.0
22478,1565028,46,734304,156412,27,19,8.333333333333334,0.0
22479,13248,436,0,1427,327,109,100.0,0.0
22480,156,34,144,64,19,15,9.090909090909092,80.76
22481,1944,5,1944,321,5,0,11.11111111111111,0.0
22482,336,1,336,108,1,0,50.0,99.78
22483,156,19,156,70,7,12,33.333333333333336,62.78
22484,300,5,300,0,5,0,20.0,63.54
22485,2508324,72,1763808,41459,41,31,16.666666666666668,93.62
22486,384,51,384,83,41,10,3.333333333333333,20.13
22487,132,18,132,25,17,1,5.555555555555555,38.05
22488,6452040,323,0,52925,170,153,2.7777777777777777,3.62
22489,276,8,0,106,6,2,50.0,0.0
22490,1248,99,1200,240,67,32,2.631578947368421,72.84
22491,4667772,54,4667772,1840844,54,0,1.9230769230769231,60.0
22492,480,85,468,156,74,11,2.4390243902439024,39.91
22493,2611932,48,2611932,24308,25,23,11.11111111111111,0.0
22494,86232,2,86232,16932,2,0,33.333333333333336,99.28
22495,1200,11,960,318,11,0,10.0,96.97
22496,13440,9,13440,1492,6,3,33.333333333333336,65.91
22497,10142304,191,5504328,87362,102,89,4.545454545454546,91.1
22498,35244,75,35244,802,75,0,10.0,60.79
22499,29232,51,19392,1626,32,19,5.555555555555555,0.0
22500,7768956,53,7768956,712635,31,22,4.545454545454546,79.67
22501,720,6,720,514,6,0,12.5,97.26
22502,4100124,141,0,170297,72,69,4.3478260869565215,0.0
22503,144,0,144,0,0,0,50.0,65.8
22504,180,1,180,60,1,0,50.0,99.82
22505,1920,50,1920,613,34,16,4.761904761904762,0.0
22506,753324,96,753324,47111,75,21,2.083333333333333,0.0
22507,369432,3,369432,118804,2,1,50.0,99.7
22508,14292,4,0,3609,2,2,50.0,0.1
22509,420,0,420,0,0,0,100.0,100.0
22510,624,0,624,0,0,0,100.0,100.0
22511,84684,29,0,4677,26,3,100.0,0.0
22512,8964,71,1476,763,51,20,3.0303030303030303,0.0
22513,1241448,27,1241448,66122,15,12,8.333333333333334,69.92
22514,9420,63,9204,515,55,8,2.857142857142857,0.0
22515,96936,19,0,6656,12,7,9.090909090909092,99.13
22516,204,1,204,120,1,0,50.0,95.25
22517,8652,128,8652,2158,120,8,20.0,46.83
22518,1403640,31,480312,151440,23,8,25.0,99.86
22519,1243764,817,1243764,37549,449,368,1.075268817204301,45.66
22520,21468,6,0,6052,3,3,50.0,10.0
22521,1140,53,300,106,36,17,4.761904761904762,84.36
22522,3264,976,2832,1539,582,394,1.0,23.94
22523,3564,5,3564,196,3,2,33.333333333333336,87.4
22524,58932,48,58932,267,30,18,5.0,49.3
22525,1714104,152,1714104,8069,72,80,5.0,0.0
22526,360,0,360,0,0,0,100.0,100.0
22527,91596,41,91596,543,24,17,50.0,99.99
22528,1572,5,1572,753,4,1,12.5,66.77
22529,24756,23,24756,1639,22,1,5.2631578947368425,70.38
22530,5429820,66,5100162,36398,31,35,25.0,92.74
22531,4548,89,4548,1236,83,6,2.083333333333333,51.65
22532,4200,4,4200,297,4,0,25.0,92.88
22533,29040,8,0,5554,4,4,100.0,100.0
22534,816,2,816,336,2,0,50.0,98.53
22535,9528,104,0,1375,59,45,100.0,100.0
22536,9233004,2234,3660,23853,1241,993,1.0,0.0
22537,10788,7,7916,4861,7,0,25.0,0.0
22538,70620,46,0,10217,43,3,100.0,0.0
22539,2916,2,2916,318,2,0,33.333333333333336,99.8
22540,5967564,222,0,188298,121,101,3.125,0.0
22541,10050576,534,0,59622,289,245,1.36986301369863,0.0
22542,334104,93,334104,28042,60,33,6.666666666666667,92.37
22543,14784,33,14784,1461,20,13,14.285714285714286,0.0
22544,5064,85,5064,1063,80,5,50.0,54.56
22545,7768428,8,5926044,4578891,2,6,50.0,0.0
22546,792,2,792,234,1,1,50.0,99.97
22547,2457600,598,820516,5810,358,240,1.162790697674419,71.69
22548,9179568,1344,0,1852847,750,594,1.0638297872340423,0.0
22549,1068,133,834,335,106,27,1.2987012987012987,31.19
22550,40896,1,40896,12,1,0,50.0,99.59
22551,2388,54,2388,805,52,2,14.285714285714286,33.32
22552,372,14,108,68,8,6,25.0,98.89
22553,1068,38,1008,337,29,9,5.0,0.0
22554,2640504,706,2640504,8802,389,317,1.492537313432836,73.51
22555,1287816,13,0,400618,8,5,100.0,0.0
22556,2568,12,84,254,10,2,9.090909090909092,86.14
22557,1860,8,1140,333,8,0,12.5,93.62
22558,396,32,288,130,23,9,6.666666666666667,29.65
22559,4462692,62,4462692,67896,29,33,6.666666666666667,81.58
22560,312,18,312,78,10,8,25.0,97.87
22561,2671908,125,2671908,24487,73,52,4.166666666666667,85.43
22562,504,11,432,201,8,3,14.285714285714286,83.77
22563,10206012,3553,0,827943,1508,2045,1.0,0.0
22564,1650828,181,1650828,9439,85,96,2.5,41.12
22565,252,10,204,69,9,1,9.090909090909092,81.35
22566,6420,13,6420,585,13,0,7.6923076923076925,91.65
22567,174648,18,0,10848,17,1,5.0,19.95
22568,3281220,304,3281220,7589,151,153,2.0408163265306123,66.86
22569,924,19,924,366,19,0,5.555555555555555,88.13
22570,9876,76,9876,2948,57,19,2.5641025641025643,64.42
22571,50832,2,50832,2562,1,1,50.0,99.99
22572,8088,68,0,964,32,36,5.882352941176471,0.0
22573,12384,9,12384,1237,8,1,14.285714285714286,98.98
22574,228,24,204,125,21,3,6.666666666666667,76.32
22575,10052736,693,4583082,1992291,369,324,1.0,0.0
22576,11736,138,6668,6086,135,3,2.2222222222222223,53.2
22577,2794212,68,0,120017,39,29,5.555555555555555,0.0
22578,2172,50,2172,920,47,3,5.2631578947368425,29.62
22579,2040,4,2040,501,4,0,20.0,99.17
22580,56532,45,372,6144,37,8,6.25,0.0
22581,458988,1,458988,0,1,0,50.0,97.3
22582,14556,17,14556,1564,16,1,7.142857142857143,89.8
22583,396,77,360,151,55,22,2.9411764705882355,86.75
22584,49824,14,49824,2771,13,1,7.142857142857143,7.81
22585,26208,16,26208,633,10,6,20.0,96.92
22586,2460,3,2460,448,3,0,25.0,99.54
22587,348,7,348,58,6,1,16.666666666666668,95.65
22588,240,5,240,64,5,0,16.666666666666668,82.95
22589,792,4,792,384,4,0,25.0,61.35
22590,216,8,168,66,5,3,20.0,88.21
22591,15792,56,15792,1474,55,1,20.0,54.96
22592,85608,7,85608,1558,5,2,20.0,94.53
22593,132,29,108,69,25,4,4.0,16.57
22594,256008,35,0,10291,19,16,11.11111111111111,0.0
22595,35460,201,35460,3124,172,29,1.0,5.5
22596,3360,12,0,703,11,1,100.0,0.0
22597,324,2,324,144,2,0,20.0,64.0
22598,564,3,552,244,2,1,33.333333333333336,99.21
22599,132,2,120,78,1,1,50.0,99.84
22600,574884,47,574884,241,42,5,2.702702702702702,20.07
22601,3924,2,3924,132,2,0,33.333333333333336,97.91
22602,120,3,120,64,2,1,100.0,100.0
22603,1416,52,0,643,32,20,100.0,100.0
22604,660,1,660,192,1,0,50.0,98.71
22605,1176,118,1176,193,81,37,2.272727272727273,55.01
22606,448536,107,448536,2578,67,40,2.272727272727273,36.19
22607,8111136,547,8111136,3442,332,215,1.0,59.99
22608,9886920,41,9886920,208593,23,18,6.25,76.13
22609,660,12,660,120,12,0,7.142857142857143,88.82
22610,4106916,101,3294438,26036,50,51,14.285714285714286,95.81
22611,324,4,324,39,3,1,33.333333333333336,91.29
22612,552,10,0,272,5,5,20.0,90.0
22613,588,6,588,126,5,1,20.0,96.5
22614,42408,12,42408,440,9,3,16.666666666666668,90.13
22615,2465472,55,2465472,1386,32,23,7.142857142857143,87.35
22616,2695596,68,2695596,968,34,34,4.3478260869565215,0.0
22617,5748480,1595,5748480,10580,940,655,1.0,2.28
22618,9312,14,3240,1842,14,0,6.666666666666667,19.27
22619,660,112,0,150,81,31,100.0,100.0
22620,21960,9,21960,1184,5,4,33.333333333333336,60.01
22621,4107588,1133,3386358,30754,597,536,1.0,62.46
22622,288,40,288,163,34,6,3.125,55.17
22623,300,5,300,86,3,2,33.333333333333336,94.95
22624,2696628,111,2696628,3598,50,61,4.761904761904762,0.0
22625,588,17,588,124,12,5,14.285714285714286,93.34
22626,480,102,0,153,71,31,100.0,100.0
22627,4110108,753,3282588,17216,403,350,1.5384615384615383,83.55
22628,3120,169,3120,1108,146,23,1.0,60.77
22629,5832,23,5832,289,15,8,7.6923076923076925,89.95
22630,3072,45,3072,691,45,0,2.4390243902439024,5.6
22631,1044,71,552,267,51,20,3.125,67.12
22632,132,0,132,0,0,0,100.0,100.0
22633,996,2,996,276,2,0,33.333333333333336,99.68
22634,252,5,252,0,5,0,16.666666666666668,98.78
22635,10284216,250,0,1877120,135,115,1.0,0.0
22636,72,2,72,0,2,0,33.333333333333336,90.6
22637,2643912,287,2643912,4322,158,129,2.0408163265306123,83.05
22638,1752,11,1752,241,9,2,11.11111111111111,91.06
22639,756,40,756,117,26,14,7.6923076923076925,77.14
22640,5736,1,5736,1776,1,0,50.0,97.11
22641,6096,2,6096,126,2,0,33.333333333333336,96.0
22642,492,11,492,50,8,3,11.11111111111111,88.17
22643,180,9,0,80,4,5,33.333333333333336,99.5
22644,240,0,240,0,0,0,100.0,100.0
22645,9312312,932,0,119846,490,442,1.0,0.0
22646,9816996,2703,1076712,1225784,1191,1512,1.0,0.0
22647,2712,2,2016,1356,2,0,100.0,100.0
22648,9303120,716,0,50667,249,467,1.1904761904761905,1.96
22649,12180,42,12180,859,38,4,50.0,62.54
22650,120,2,120,12,1,1,100.0,100.0
22651,240,37,228,157,30,7,3.225806451612903,70.62
22652,6924,2,6924,6,2,0,33.333333333333336,98.46
22653,3792,39,2130,1086,23,16,10.0,69.93
22654,120,0,120,0,0,0,100.0,100.0
22655,72,0,72,0,0,0,100.0,100.0
22656,4332,26,4332,1837,26,0,4.3478260869565215,4.92
22657,7768092,941,7768092,256392,511,430,1.1904761904761905,50.43
22658,852,16,852,414,11,5,33.333333333333336,99.74
22659,828,57,828,105,57,0,100.0,100.0
22660,432,6,432,110,5,1,20.0,49.48
22661,264,0,264,0,0,0,50.0,99.5
22662,8193348,116,8193348,46489,63,53,3.703703703703704,77.88
22663,540,7,540,116,4,3,50.0,99.95
22664,841092,0,841092,0,0,0,50.0,95.0
22665,1680,4,1680,384,4,0,20.0,86.86
22666,144,9,144,48,5,4,100.0,100.0
22667,1476,5,1476,108,3,2,50.0,99.87
22668,2810340,570,0,118831,293,277,3.4482758620689653,0.74
22669,7451076,1888,7216308,25398,1092,796,1.0,0.0
22670,228,1,228,0,1,0,50.0,99.67
22671,276,9,276,130,5,4,20.0,87.5
22672,432,15,204,166,8,7,20.0,91.74
22673,2520,6,2520,144,3,3,100.0,100.0
22674,12336,195,0,1111,115,80,3.8461538461538463,0.88
22675,15996,7,924,2468,5,2,16.666666666666668,97.37
22676,7831560,565,7831560,121707,261,304,1.6666666666666667,56.37
22677,24024,1392,0,3047,916,476,100.0,100.0
22678,63108,8,63108,360,8,0,10.0,98.1
22679,2652036,51,2652036,52671,26,25,14.285714285714286,86.32
22680,4260,1,4260,12,1,0,100.0,100.0
22681,9904596,1518,0,54954,833,685,1.0,1.45
22682,1056,39,1056,157,32,7,3.8461538461538463,1.44
22683,9718536,1000,0,33320,555,445,1.0,0.0
22684,72048,44,72048,89,39,5,2.5641025641025643,78.88
22685,3955764,64,3955764,701152,64,0,1.7543859649122806,50.73
22686,120,18,120,59,14,4,7.6923076923076925,67.99
22687,84,4,84,27,3,1,33.333333333333336,96.68
22688,1236,19,1236,76,19,0,4.761904761904762,82.43
22689,15252,1106,2652,1285,644,462,1.0,75.48
22690,7416,41,636,403,38,3,3.125,83.58
22691,75192,59,75192,174,45,14,2.5,73.95
22692,600,69,600,120,68,1,1.9230769230769231,36.27
22693,36,4,0,18,3,1,33.333333333333336,0.0
22694,7766352,348,4214688,94162,178,170,5.882352941176471,92.52
22695,504,16,504,126,8,8,2.857142857142857,71.04
22696,41676,37,41676,1624,24,13,10.0,0.0
22697,2184,554,0,496,371,183,16.666666666666668,0.0
22698,1152,131,1044,475,127,4,1.075268817204301,0.0
22699,900,1,900,60,1,0,50.0,0.0
22700,696672,39,696672,82114,39,0,6.25,91.68
22701,420,6,420,100,4,2,25.0,69.0
22702,10312044,21160,352434,362374,10512,10648,1.0,0.0
22703,3912,49,3492,1144,34,15,6.666666666666667,0.0
22704,9908904,58,8903700,186008,34,24,6.25,0.0
22705,2561508,53,2561508,47988,31,22,8.333333333333334,5.04
22706,396,1,396,12,1,0,50.0,0.0
22707,10668,44,0,818,41,3,2.3255813953488373,40.0
22708,10066380,524,4056444,125121,285,239,1.6129032258064515,0.0
22709,3072,111,3072,678,49,62,6.25,90.26
22710,72,2,72,12,2,0,50.0,96.43
22711,9980952,1686,0,233993,915,771,1.0,0.14
22712,840,25,840,226,24,1,4.166666666666667,67.94
22713,10329864,3338,4338784,4393482,1959,1379,1.0,81.51
22714,28236,40,28236,1545,37,3,3.4482758620689653,0.79
22715,852,5,852,350,3,2,50.0,98.91
22716,9657840,205,0,206004,83,122,1.351351351351351,20.34
22717,250080,74,0,4987,31,43,11.11111111111111,0.0
22718,6526392,207,0,68231,106,101,6.666666666666667,0.0
22719,5062092,466,4204686,23837,254,212,1.5873015873015872,87.68
22720,468,7,0,183,4,3,50.0,0.0
22721,9674556,597,4143744,492812,240,357,1.0309278350515465,0.91
22722,4788,42,4788,454,39,3,2.7777777777777777,0.73
22723,5532,3,2976,36,2,1,50.0,97.37
22724,1644,20,1644,229,14,6,12.5,0.0
22725,432,6,324,170,5,1,20.0,76.62
22726,228,27,216,104,21,6,5.555555555555555,68.22
22727,583632,196,0,140319,67,129,7.142857142857143,0.0
22728,696,6,696,102,5,1,20.0,97.16
22729,252,11,252,66,6,5,50.0,0.0
22730,5698812,27,2651092,857009,16,11,9.090909090909092,0.0
22731,7300968,138,0,139954,72,66,2.9411764705882355,0.97
22732,468,7,468,135,5,2,25.0,1.85
22733,720,76,612,288,57,19,2.2222222222222223,0.0
22734,432,31,432,182,25,6,4.166666666666667,48.44
22735,540,59,516,253,42,17,3.333333333333333,88.09
22736,9105360,528,0,624510,215,313,1.2987012987012987,0.0
22737,1691136,283,0,15680,153,130,2.2222222222222223,0.0
22738,552,3,0,356,2,1,33.333333333333336,9.9
22739,564,14,564,221,13,1,9.090909090909092,0.0
22740,10342512,8423,142092,3643513,4519,3904,1.0,0.0
22741,12792,19,12792,1034,18,1,5.882352941176471,77.8
22742,587856,50,0,13527,42,8,25.0,0.0
22743,35136,9,35136,1448,9,0,7.6923076923076925,0.24
22744,1644,53,144,152,43,10,2.7777777777777777,44.68
22745,1356,0,1356,0,0,0,50.0,70.0
22746,252,2,0,210,2,0,50.0,89.99
22747,7187808,3377,209644,75829,1846,1531,1.0,37.0
22748,1788,72,1764,919,52,20,3.703703703703704,0.0
22749,7815132,733,6333342,9677,467,266,1.0,27.72
22750,1920,40,1596,487,26,14,6.666666666666667,0.0
22751,7239312,139,7239312,2115,69,70,4.3478260869565215,90.38
22752,160176,27,0,7120,23,4,100.0,0.0
22753,12132,21,12132,879,20,1,5.555555555555555,78.2
22754,683616,69,0,33122,48,21,4.0,0.07
22755,2510748,2822,1271310,36849,1555,1267,1.0,74.61
22756,10217988,913,0,1851883,513,400,1.098901098901099,0.0
22757,109644,2,0,54966,1,1,50.0,50.0
22758,12444,22,12444,1053,22,0,5.2631578947368425,74.12
22759,178284,38,0,6165,35,3,100.0,0.0
22760,4608,419,1908,1243,268,151,1.0,61.49
22761,7759416,463,7759416,171523,180,283,1.96078431372549,65.46
22762,144,14,144,87,10,4,10.0,93.6
22763,169164,48,0,6561,40,8,50.0,0.0
22764,9161124,79,0,3183615,30,49,1.0309278350515465,0.0
22765,2412,3,2412,252,3,0,20.0,97.93
22766,580440,11,290628,2611,9,2,16.666666666666668,99.7
22767,42336,6,42336,42192,6,0,14.285714285714286,96.9
22768,408,15,408,41,15,0,5.882352941176471,90.19
22769,72,14,72,36,10,4,11.11111111111111,58.75
22770,258060,48,0,6730,37,11,50.0,0.0
22771,624,89,396,174,68,21,1.7543859649122806,0.0
22772,90948,43,0,3664,32,11,100.0,0.0
22773,94308,116,0,1437,70,46,100.0,0.0
22774,22056,87,0,5508,67,20,14.285714285714286,0.0
22775,10368744,10070,8886072,9150636,5694,4376,1.0,0.0
22776,5616,26,5616,866,18,8,14.285714285714286,0.0
22777,15012,15,0,1417,12,3,50.0,99.0
22778,206832,19,0,14703,15,4,100.0,100.0
22779,96636,57,0,5158,48,9,100.0,0.0
22780,7896,38,0,1866,30,8,100.0,0.0
22781,10220124,657,0,1172999,341,316,1.4705882352941178,0.0
22782,147864,58,147864,613,31,27,25.0,98.06
22783,204,0,204,0,0,0,100.0,100.0
22784,5004,6,0,958,5,1,14.285714285714286,50.0
22785,264,13,264,12,13,0,2.857142857142857,43.04
22786,1105740,326,494457,92255,179,147,2.0,2.0
22787,444,4,444,93,3,1,33.333333333333336,98.05
22788,264,17,252,153,13,4,10.0,92.39
22789,10181268,7192,17424,579596,4093,3099,1.0,0.0
22790,8302956,28,6727926,1887,24,4,4.0,80.19
22791,1957272,10,1957272,1807,10,0,14.285714285714286,96.79
22792,6277344,239,0,39862,125,114,2.1739130434782608,0.0
22793,240,41,240,70,29,12,4.0,56.33
22794,1104,207,1104,143,122,85,1.0869565217391304,37.71
22795,636,99,612,333,62,37,3.703703703703704,99.03
22796,1788,341,1788,119,226,115,1.0,13.42
22797,7095492,68,0,105201,56,12,50.0,0.0
22798,300,0,300,0,0,0,100.0,100.0
22799,396,10,396,96,8,2,16.666666666666668,94.11
22800,7605492,744,7605492,95389,418,326,1.5384615384615383,78.11
22801,60,6,60,38,4,2,25.0,71.35
22802,35700,124,35700,2713,93,31,1.694915254237288,3.14
22803,204,38,96,53,29,9,3.703703703703704,30.91
22804,33936,0,33936,0,0,0,50.0,80.0
22805,7950468,1033,6028536,170355,547,486,1.0869565217391304,63.64
22806,1740,1,0,1740,0,1,50.0,0.0
22807,86100,273,86100,1027,141,132,1.96078431372549,76.22
22808,266760,108,266760,4152,51,57,5.2631578947368425,56.53
22809,228,6,228,62,4,2,20.0,90.08
22810,3715164,4,3715164,933,3,1,50.0,97.93
22811,744,19,744,417,18,1,9.090909090909092,90.54
22812,192,7,192,73,6,1,16.666666666666668,79.72
22813,1428,28,852,361,20,8,7.142857142857143,95.08
22814,241128,61,0,27132,38,23,50.0,0.0
22815,383748,53,383748,146,37,16,3.125,56.73
22816,516,51,0,160,31,20,100.0,100.0
22817,2584764,74,2584764,16653,43,31,8.333333333333334,79.43
22818,3012,133,0,905,111,22,100.0,0.0
22819,120,21,120,20,18,3,5.882352941176471,38.73
22820,10273104,11555,1418364,1375373,6729,4826,1.0,0.99
22821,8856,66,0,933,45,21,50.0,0.0
22822,300,23,300,124,21,2,4.545454545454546,57.08
22823,3638772,426,3638772,4002,256,170,2.1739130434782608,0.0
22824,72,2,72,42,2,0,50.0,62.8
22825,276,2,276,108,2,0,25.0,97.19
22826,2124,14,2124,50,10,4,12.5,0.0
22827,1416,2,1416,228,2,0,33.333333333333336,0.0
22828,696,138,600,222,97,41,1.818181818181818,40.76
22829,504,13,0,147,7,6,50.0,0.0
22830,4597740,15,4597404,312176,7,8,3.4482758620689653,0.0
22831,72,1,72,12,1,0,50.0,91.02
22832,564,69,564,185,63,6,1.7543859649122806,44.14
22833,492,2,492,138,2,0,25.0,88.53
22834,57936,13,31212,8333,9,4,4.3478260869565215,55.88
22835,1296,0,1296,0,0,0,100.0,100.0
22836,3017196,170,3017196,8284,77,93,3.703703703703704,59.13
22837,384,8,0,172,4,4,100.0,0.0
22838,552,3,552,136,2,1,50.0,99.9
22839,10377720,1059,0,2529012,631,428,1.0309278350515465,0.0
22840,600,4,252,234,3,1,100.0,100.0
22841,23472,14,23472,4801,11,3,10.0,38.1
22842,432,54,432,118,50,4,2.0408163265306123,37.73
22843,5148,158,0,1851,123,35,100.0,0.0
22844,432,155,0,197,98,57,100.0,100.0
22845,5590356,46,0,189151,29,17,8.333333333333334,0.0
22846,4056,131,4056,176,99,32,1.2820512820512822,30.67
22847,456,3,456,64,3,0,20.0,59.37
22848,63576,2,63576,9240,2,0,100.0,100.0
22849,8563716,419,6730476,68271,225,194,3.125,93.96
22850,10146168,6388,2209788,1203726,2659,3729,1.0,0.0
22851,357120,42,357120,43,40,2,2.4390243902439024,34.31
22852,1389240,438,0,3704,264,174,1.1904761904761905,0.0
22853,53760,29,53760,1689,29,0,3.571428571428572,10.05
22854,10596,54,10596,9550,30,24,6.25,84.24
22855,480,13,480,177,6,7,33.333333333333336,87.72
22856,1907472,287,0,19157,149,138,2.127659574468085,0.0
22857,16668,4,16668,960,2,2,33.333333333333336,99.72
22858,3480,4,3480,462,3,1,33.333333333333336,90.55
22859,10118688,2104,893142,374550,1165,939,1.0,0.0
22860,147120,3,147120,26616,2,1,33.333333333333336,80.25
22861,132,3,0,68,2,1,25.0,25.0
22862,492,0,492,0,0,0,100.0,100.0
22863,228,0,228,0,0,0,100.0,100.0
22864,9516,12,9516,1222,11,1,9.090909090909092,17.64
22865,852,61,852,286,54,7,1.8867924528301887,70.62
22866,156,6,96,84,5,1,20.0,46.62
22867,636,1,636,60,1,0,50.0,98.05
22868,9963432,497,4901712,287727,287,210,1.694915254237288,0.0
22869,372,67,372,192,45,22,4.166666666666667,90.08
22870,144,13,132,55,10,3,11.11111111111111,84.05
22871,348,93,348,172,47,46,4.166666666666667,59.99
22872,21576,78,156,425,52,26,4.3478260869565215,30.01
22873,90108,4,204,22557,2,2,33.333333333333336,99.5
22874,588,1,588,324,1,0,50.0,99.32
22875,972,19,768,361,16,3,10.0,92.63
22876,10359900,551,2481312,493150,275,276,2.5,0.0
22877,74364,8,360,9385,7,1,12.5,96.1
22878,216,1,216,96,1,0,100.0,100.0
22879,708,98,624,155,83,15,1.4492753623188406,48.43
22880,10137072,4363,0,330883,2611,1752,1.0,0.0
22881,132,44,108,57,32,12,4.166666666666667,64.3
22882,9940116,63,9940116,298416,23,40,20.0,96.02
22883,19644,18,0,2247,15,3,100.0,0.0
22884,9981156,88,9981156,2100,34,54,11.11111111111111,92.07
22885,264,37,252,152,31,6,3.571428571428572,71.1
22886,10217532,6380,0,207222,3531,2849,1.0,0.0
22887,336,14,336,79,8,6,25.0,87.75
22888,96,5,96,69,3,2,25.0,98.6
22889,240,30,216,162,23,7,5.882352941176471,80.34
22890,168,40,168,68,28,12,4.166666666666667,47.9
22891,144,1,144,12,1,0,33.333333333333336,79.02
22892,9756576,135,0,229732,65,70,4.166666666666667,5.8
22893,23208,2493,0,2569,1490,1003,100.0,100.0
22894,852,7,852,60,6,1,14.285714285714286,51.21
22895,228408,39,228408,12578,36,3,2.7777777777777777,30.08
22896,216,3,216,128,3,0,25.0,98.99
22897,935076,51,1656,30574,34,17,5.882352941176471,0.0
22898,2557896,62,2557896,45788,30,32,14.285714285714286,91.58
22899,4224,12,4224,809,8,4,16.666666666666668,78.99
22900,876,11,876,301,6,5,8.333333333333334,68.53
22901,1500,44,0,601,36,8,100.0,0.0
22902,1428,101,1368,812,75,26,1.8867924528301887,0.0
22903,222960,507,222960,5753,447,60,1.7241379310344829,75.71
22904,252,53,192,168,41,12,3.571428571428572,25.36
22905,5861664,1,5861664,5399940,1,0,50.0,0.0
22906,10407708,5442,0,2677456,3214,2228,1.0,0.0
22907,432,72,384,295,45,27,4.3478260869565215,87.0
22908,4260,38,2028,531,32,6,3.571428571428572,82.71
22909,432,1,432,120,1,0,33.333333333333336,99.55
22910,768,6,0,554,4,2,25.0,25.0
22911,516768,664,381192,422868,503,161,1.0,0.0
22912,5544,67,5544,2045,52,15,2.7777777777777777,0.0
22913,10307628,9,10307628,915957,6,3,20.0,97.36
22914,20328,17,20328,1578,17,0,6.25,69.51
22915,456,1,456,144,1,0,50.0,98.97
22916,5314608,719,1726347,546916,570,149,1.0,0.0
22917,1392,50,1368,527,35,15,4.761904761904762,0.0
22918,165768,23,165768,239,15,8,12.5,74.6
22919,42420,445,0,824,270,175,33.333333333333336,0.0
22920,10195704,171,0,175174,77,94,3.571428571428572,0.0
22921,1500,37,744,397,32,5,4.3478260869565215,0.0
22922,5844,64,3714,1578,52,12,2.0,39.97
22923,120,5,120,28,5,0,16.666666666666668,0.0
22924,828,9,828,246,7,2,16.666666666666668,93.55
22925,241824,20,241824,740,18,2,7.142857142857143,3.88
22926,2772096,13,0,239954,9,4,5.882352941176471,11.6
22927,528,8,528,103,5,3,14.285714285714286,40.0
22928,155892,10,155892,8362,9,1,50.0,95.65
22929,18024,27,18024,1470,27,0,4.545454545454546,9.92
22930,5832,4,0,1650,2,2,50.0,0.0
22931,311604,43,0,8338,29,14,100.0,0.0
22932,66876,20,66876,767,18,2,6.666666666666667,72.59
22933,420,9,420,81,5,4,33.333333333333336,99.83
22934,3516,23,3516,827,20,3,8.333333333333334,25.13
22935,6876,61,5172,998,45,16,3.333333333333333,0.0
22936,2724,17,2724,1759,15,2,7.142857142857143,81.04
22937,245436,98,0,3976,88,10,100.0,0.0
22938,2076,41,2076,586,32,9,5.555555555555555,0.0
22939,2784,28,2784,1003,24,4,6.25,32.67
22940,271032,74,996,7532,48,26,3.4482758620689653,0.0
22941,180,1,0,180,1,0,25.0,99.5
22942,227916,22,227916,2997,16,6,6.666666666666667,70.41
22943,6636,31,6636,879,24,7,6.666666666666667,56.14
22944,7788,22,7788,835,20,2,5.882352941176471,66.82
22945,608988,82,254352,26276,74,8,1.3888888888888888,18.72
22946,322260,50,0,7519,36,14,100.0,0.0
22947,950340,35,0,29882,25,10,25.0,0.0
22948,14496,24,14496,1602,22,2,5.555555555555555,71.44
22949,6756,26,6756,921,21,5,7.6923076923076925,19.13
22950,288,2,288,228,1,1,100.0,100.0
22951,48300,43,3068,7892,37,6,1.8867924528301887,0.0
22952,192,54,192,46,36,18,3.333333333333333,41.23
22953,888,3,888,152,2,1,50.0,99.95
22954,5220,16,0,919,14,2,50.0,99.9
22955,1248,15,1248,130,15,0,7.142857142857143,0.0
22956,720,5,720,93,3,2,50.0,99.95
22957,62952,97,0,3667,75,22,33.333333333333336,0.0
22958,10174632,407,1189140,228175,216,191,2.0408163265306123,0.0
22959,30120,83,0,726,60,23,50.0,0.0
22960,7890948,1163,5506848,86369,639,524,1.7241379310344829,89.89
22961,3348,50,0,1460,37,13,4.545454545454546,0.0
22962,92832,47,0,4353,40,7,50.0,0.0
22963,8743644,262,0,255779,118,144,3.703703703703704,0.0
22964,1656,68,1512,453,48,20,3.125,68.48
22965,376164,137,161262,80587,137,0,3.4482758620689653,98.68
22966,683736,127,683736,1378,93,34,1.3333333333333333,25.79
22967,8946612,1623,0,106651,932,691,1.0,4.0
22968,29928,70,0,1565,44,26,100.0,0.0
22969,3944688,125,3944688,644,67,58,2.9411764705882355,43.58
22970,723240,123,723240,382,87,36,1.4492753623188406,19.37
22971,210696,112,972,2010,95,17,1.2048192771084338,31.33
22972,4266396,200,4266396,1059,132,68,1.0,0.0
22973,2580324,291,2580324,77077,145,146,3.333333333333333,1.87
22974,828,9,828,577,6,3,12.5,69.25
22975,0,0,0,0,0,0,33.333333333333336,0.0
22976,72,13,72,17,13,0,6.666666666666667,0.0
22977,48312,84,0,903,55,29,20.0,0.0
22978,972,0,972,0,0,0,100.0,100.0
22979,156,1,156,0,1,0,33.333333333333336,65.29
22980,7044,148,0,1188,78,70,50.0,0.0
22981,263916,173,636,45100,93,80,2.702702702702702,0.0
22982,108,18,108,29,13,5,10.0,92.77
22983,264,6,264,82,5,1,20.0,63.39
22984,1356,20,0,139,19,1,20.0,0.0
22985,41088,135,0,891,77,58,100.0,0.0
22986,2556924,30,2556924,628,30,0,4.761904761904762,45.85
22987,4464,33,4464,1712,23,10,10.0,80.88
22988,2520,13,2244,1646,13,0,8.333333333333334,44.82
22989,432,0,432,0,0,0,50.0,75.75
22990,7981644,420,0,147599,226,194,1.0,0.0
22991,53616,67,0,1248,46,21,50.0,0.0
22992,8548512,974,0,28721,501,473,1.1904761904761905,0.0
22993,5844,55,0,1113,37,18,100.0,0.0
22994,14640,57,11076,4549,33,24,10.0,0.0
22995,1308,47,0,146,41,6,100.0,0.0
22996,72,5,72,7,5,0,14.285714285714286,62.21
22997,324,0,324,0,0,0,50.0,70.0
22998,45264,60,45264,2034,60,0,2.1739130434782608,9.64
22999,7855524,156,4542744,181679,84,72,5.882352941176471,0.0
23000,2592,77,0,716,66,11,2.2222222222222223,0.0
23001,2244,27,2244,756,21,6,6.666666666666667,86.12
23002,46476,102,0,1709,65,37,100.0,0.0
23003,732,23,732,354,22,1,4.545454545454546,81.11
23004,29460,3,29460,108,2,1,50.0,99.17
23005,10469904,1724,1503552,393805,871,853,1.851851851851852,0.0
23006,1296,14,1296,480,12,2,20.0,86.18
23007,324,8,324,28,8,0,10.0,55.12
23008,108,0,108,0,0,0,50.0,80.0
23009,3696,60,0,1177,37,23,100.0,0.0
23010,384,63,372,283,42,21,3.8461538461538463,3.0
23011,29856,97,0,724,68,29,50.0,0.0
23012,864,22,864,469,17,5,11.11111111111111,65.08
23013,50220,165,50220,3215,120,45,1.408450704225352,2.48
23014,309552,19,154884,56,12,7,14.285714285714286,52.02
23015,314208,15,0,21486,12,3,100.0,100.0
23016,192,2,192,48,1,1,50.0,58.69
23017,456,10,456,189,8,2,11.11111111111111,71.3
23018,1896,109,0,230,45,64,100.0,0.0
23019,2016,52,0,303,39,13,50.0,0.0
23020,744,1,744,48,1,0,33.333333333333336,64.98
23021,864,1,0,864,0,1,100.0,100.0
23022,348,11,348,117,11,0,7.6923076923076925,92.68
23023,1608,19,1608,455,15,4,7.142857142857143,66.68
23024,45744,25,45744,9972,17,8,14.285714285714286,86.89
23025,10140,31,0,2029,24,7,50.0,0.0
23026,8412,66,0,253,43,23,50.0,0.0
23027,4771428,1399,0,47108,796,603,1.0526315789473684,0.0
23028,7056,9,7056,1185,5,4,50.0,64.87
23029,1212,91,0,446,79,12,33.333333333333336,0.0
23030,901080,593,0,12657,329,264,1.7241379310344829,0.0
23031,2983524,55,0,148109,30,25,25.0,0.0
23032,10131684,989,0,353138,533,456,1.2195121951219512,0.0
23033,10130832,2254,5324754,560103,1345,909,1.0,0.0
23034,168,2,168,96,1,1,100.0,100.0
23035,132,3,132,20,3,0,20.0,56.39
23036,2243064,132,0,17602,87,45,33.333333333333336,0.0
23037,900,26,900,111,24,2,4.0,56.87
23038,10057032,131,10057032,47486,53,78,6.666666666666667,88.65
23039,75024,58,0,3264,43,15,20.0,0.0
23040,5124,24,84,450,21,3,4.761904761904762,37.73
23041,7775988,660,7775988,51378,261,399,1.1904761904761905,4.0
23042,45264,18,45264,582,17,1,8.333333333333334,76.38
23043,20280,19,1008,1848,14,5,10.0,87.64
23044,5184,19,0,793,13,6,20.0,0.0
23045,37584,6,132,6304,4,2,25.0,60.72
23046,405972,63,405972,31000,48,15,2.9411764705882355,4.55
23047,2940,8,0,705,6,2,100.0,100.0
23048,2712,118,0,695,102,16,100.0,0.0
23049,1572,78,1572,626,47,31,3.571428571428572,58.52
23050,156,0,156,0,0,0,50.0,60.84
23051,84,5,84,36,3,2,33.333333333333336,56.61
23052,8712264,64,8712264,55853,28,36,8.333333333333334,41.62
23053,312,2,312,84,2,0,33.333333333333336,99.36
23054,6060,2,6060,1392,2,0,25.0,57.87
23055,1596,16,1596,403,16,0,5.882352941176471,93.25
23056,5580,0,5580,0,0,0,50.0,99.97
23057,684,302,684,181,150,152,1.1363636363636365,50.27
23058,999096,18,999096,166732,13,5,10.0,65.9
23059,10050372,192,0,182127,95,97,4.761904761904762,3.62
23060,732,3,732,116,2,1,33.333333333333336,59.13
23061,336,56,336,107,32,24,4.761904761904762,61.96
23062,72,29,72,28,18,11,10.0,47.17
23063,10050516,1550,0,117207,846,704,1.0,0.0
23064,10011696,336,0,770722,163,173,3.0303030303030303,0.0
23065,144,18,144,21,16,2,6.25,49.24
23066,10064124,578,0,118902,307,271,1.6129032258064515,0.0
23067,11724,30,0,438,27,3,50.0,0.0
23068,144,20,144,24,17,3,6.25,50.27
23069,63888,12,63888,628,10,2,12.5,93.45
23070,615876,11,615756,39392,10,1,12.5,97.63
23071,1140,2,1140,120,2,0,25.0,97.69
23072,17736,11,1392,2053,9,2,10.0,67.24
23073,480,26,468,444,24,2,50.0,99.98
23074,240,2,240,132,2,0,25.0,61.84
23075,15120,199,612,639,144,55,1.0,29.29
23076,1764,19,1764,716,19,0,9.090909090909092,61.47
23077,83832,22,15876,5354,21,1,5.555555555555555,73.2
23078,8148,3,8148,724,3,0,7.142857142857143,1.26
23079,10486596,4394,574956,1386022,1873,2521,1.0,0.0
23080,8180544,1020,0,30903,589,431,1.0,0.0
23081,168,43,168,52,24,19,14.285714285714286,62.95
23082,1236,35,1236,395,24,11,7.142857142857143,50.66
23083,1416,3,0,656,2,1,14.285714285714286,9.0
23084,7958124,1275,6646410,34732,747,528,1.0,71.32
23085,15780,54,0,904,30,24,10.0,5.0
23086,156,7,156,96,6,1,11.11111111111111,53.63
23087,10242564,15927,772656,1447426,7172,8755,1.0,0.0
23088,7800252,436,0,25239,253,183,1.5384615384615383,0.0
23089,1404,4,1404,0,4,0,100.0,100.0
23090,1788,1,348,1788,1,0,100.0,100.0
23091,1812,39,1680,354,30,9,4.166666666666667,0.0
23092,10495740,2791,9888,56519,1576,1215,1.0,0.0
23093,1106124,60,1106124,44434,49,11,3.8461538461538463,91.23
23094,19272,11,19272,19216,11,0,8.333333333333334,80.35
23095,40692,111,0,26696,76,35,100.0,0.0
23096,2628,23,2628,220,21,2,4.545454545454546,64.09
23097,76536,51,76536,989,46,5,2.2222222222222223,23.46
23098,1384548,46,0,59374,21,25,100.0,0.0
23099,26064,21,26064,977,19,2,10.0,51.28
23100,1056,11,1056,295,10,1,50.0,51.3
23101,10404,23,10404,704,21,2,5.555555555555555,74.93
23102,59496,16,0,3804,15,1,100.0,0.0
23103,6420,12,6420,1073,12,0,7.142857142857143,2.65
23104,7805652,293,0,90723,148,145,4.545454545454546,5.8
23105,156,12,144,25,11,1,7.6923076923076925,47.3
23106,108,0,108,0,0,0,50.0,64.0
23107,2232,35,2232,859,20,15,10.0,88.13
23108,7920,50,7920,4301,43,7,2.7777777777777777,19.48
23109,2663484,164,2663484,1603,75,89,4.545454545454546,75.17
23110,119508,942,76314,5881,810,132,1.0,0.0
23111,418284,19,418284,8755,16,3,9.090909090909092,40.37
23112,4668,47,4668,1055,36,11,4.0,0.0
23113,156,1,156,12,1,0,50.0,84.17
23114,3924,3,3924,964,2,1,33.333333333333336,99.69
23115,18204,16,18204,376,15,1,6.666666666666667,41.22
23116,360,0,360,0,0,0,50.0,60.84
23117,968112,108,0,12094,49,59,10.0,5.0
23118,1896,34,984,467,25,9,5.555555555555555,0.0
23119,5028,15,5028,352,13,2,12.5,36.05
23120,144,3,144,52,1,2,50.0,99.68
23121,504,1,504,324,1,0,33.333333333333336,63.37
23122,168,0,168,0,0,0,50.0,70.9
23123,156,4,156,33,3,1,25.0,58.16
23124,288,24,180,144,21,3,5.555555555555555,92.64
23125,34368,32,34368,2459,24,8,5.882352941176471,12.1
23126,1068,3,1068,292,2,1,50.0,96.06
23127,480,105,216,72,82,23,20.0,99.88
23128,10443072,1366,9395856,3406905,831,535,1.0,0.0
23129,9852,52,4536,3159,38,14,4.3478260869565215,0.0
23130,19284,20,12408,2383,19,1,5.555555555555555,75.91
23131,75072,148,0,8166,121,27,16.666666666666668,0.0
23132,205224,426,143136,2105,311,115,1.0,52.01
23133,828,13,828,329,10,3,20.0,93.82
23134,7819608,164,0,283117,77,87,5.882352941176471,5.8
23135,6132,29,6132,352,22,7,6.25,0.0
23136,7798560,93,7798560,108579,53,40,6.25,0.0
23137,576,3,576,68,1,2,50.0,85.58
23138,1248,67,1200,713,50,17,2.5641025641025643,0.0
23139,72,1,72,0,1,0,33.333333333333336,69.5
23140,7008,21,7008,6394,19,2,5.0,92.01
23141,10532664,43425,589589,823376,23893,19532,1.0,0.0
23142,108,23,108,3,23,0,4.0,37.93
23143,94236,45,0,4749,31,14,100.0,0.0
23144,352212,2,352212,10518,2,0,100.0,94.73
23145,419028,14,419028,777,13,1,14.285714285714286,27.73
23146,166152,42,0,4862,37,5,50.0,0.0
23147,162444,57,0,3859,44,13,50.0,0.0
23148,1896,4,0,852,3,1,100.0,0.0
23149,2667372,137,2667372,9934,82,55,3.8461538461538463,77.66
23150,111324,7,111324,788,7,0,14.285714285714286,90.3
23151,10349424,633,0,233345,372,261,1.0,0.0
23152,168,10,168,73,10,0,8.333333333333334,63.84
23153,252,26,252,82,16,10,12.5,92.26
23154,2664,16,2664,681,16,0,14.285714285714286,43.45
23155,155700,50,0,13345,42,8,50.0,0.0
23156,21804,56,21804,1464,50,6,1.96078431372549,23.63
23157,276,1,276,0,1,0,33.333333333333336,58.71
23158,1416,42,792,258,38,4,2.702702702702702,34.29
23159,912,32,912,27,26,6,4.0,67.77
23160,36300,32,0,7399,18,14,14.285714285714286,2.93
23161,92808,50,0,3753,35,15,50.0,0.0
23162,1728,25,1728,394,21,4,4.761904761904762,57.39
23163,7835796,266,0,76889,141,125,2.702702702702702,0.0
23164,1668,59,1668,647,33,26,5.882352941176471,81.95
23165,228,29,228,60,16,13,20.0,73.25
23166,3936,0,3936,0,0,0,50.0,60.84
23167,9307704,305,0,658715,168,137,2.127659574468085,0.0
23168,8680200,1112,0,37674,618,494,1.2048192771084338,0.0
23169,1644,36,0,661,31,5,50.0,99.9
23170,264,50,264,101,42,8,2.702702702702702,64.41
23171,9510288,909,0,445828,546,363,1.351351351351351,0.0
23172,204,36,204,15,30,6,3.4482758620689653,33.38
23173,1032,70,1032,348,50,20,3.0303030303030303,0.0
23174,279864,145,252384,158732,78,67,2.7777777777777777,59.0
23175,600,3,600,48,3,0,20.0,71.04
23176,123084,47,0,4448,32,15,100.0,0.0
23177,6060,30,0,909,26,4,50.0,99.9
23178,408,3,408,96,1,2,100.0,100.0
23179,8604,1,8604,36,1,0,33.333333333333336,98.0
23180,2632668,724,2632668,99916,399,325,1.96078431372549,73.9
23181,2316,10,2316,2179,4,6,50.0,99.6
23182,8592,16,0,1836,7,9,16.666666666666668,0.0
23183,2112,51,2112,178,47,4,2.127659574468085,62.92
23184,6756000,658,0,24199,347,311,1.4492753623188406,0.0
23185,13812,94,0,1803,54,40,100.0,0.0
23186,11736,100,0,957,62,38,100.0,0.0
23187,3055236,688,0,12706,471,217,1.0,2.26
23188,444,1,444,420,1,0,33.333333333333336,76.75
23189,6300,78,6300,2690,56,22,5.555555555555555,0.0
23190,19968,78,0,638,63,15,100.0,0.0
23191,10553052,11569,4275120,2261200,6626,4943,1.0,0.0
23192,1344,15,1344,1120,6,9,25.0,96.89
23193,4392,151,0,1051,117,34,100.0,0.0
23194,124608,35,0,6109,28,7,100.0,0.0
23195,360,7,360,305,3,4,33.333333333333336,61.73
23196,182184,30,0,31972,25,5,5.0,0.0
23197,8466264,80,6779869,6194326,3,77,25.0,0.0
23198,1615596,59,1615596,9887,32,27,20.0,91.89
23199,9024,29,240,336,29,0,3.333333333333333,66.43
23200,130392,61,0,2353,52,9,50.0,0.0
23201,1020156,63,241668,150270,43,20,4.761904761904762,3.12
23202,53544,34,53268,6844,27,7,4.761904761904762,4.89
23203,744,106,744,63,98,8,1.818181818181818,55.14
23204,192,36,192,48,24,12,7.142857142857143,45.51
23205,6216,60,0,796,37,23,100.0,0.0
23206,6660,3,6660,156,3,0,20.0,88.11
23207,12300,6,12300,1228,5,1,25.0,79.84
23208,65988,110,0,1320,73,37,33.333333333333336,0.0
23209,180,55,180,84,37,18,3.333333333333333,79.55
23210,9882828,18,8862,5154747,9,9,1.0,0.0
23211,10531956,326,3701316,419927,159,167,1.5384615384615383,0.0
23212,76992,113,76992,3902,91,22,1.5873015873015872,2.14
23213,5640,229,0,1760,171,58,100.0,0.0
23214,1212,7,1212,997,6,1,20.0,0.0
23215,8291460,517,5577048,29050,208,309,1.818181818181818,71.35
23216,108,14,108,36,11,3,9.090909090909092,45.6
23217,678180,59,816,23380,29,30,6.25,76.23
23218,10550712,1275,5060220,2074456,553,722,1.0,0.0
23219,444,6,444,198,6,0,12.5,88.87
23220,3972,17,3972,751,14,3,12.5,92.16
23221,778296,222,778296,7337,111,111,3.225806451612903,78.3
23222,33240,3,0,11260,2,1,25.0,0.0
23223,74652,57,0,1556,44,13,33.333333333333336,0.0
23224,57072,128,0,3126,93,35,100.0,0.0
23225,7476,73,0,815,49,24,100.0,0.0
23226,5165328,266,0,167113,129,137,1.7857142857142858,0.0
23227,2940,170,0,727,118,52,50.0,0.0
23228,1764,0,1764,0,0,0,100.0,0.0
23229,147312,11,147312,1214,11,0,14.285714285714286,80.06
23230,2606256,1158,2606256,58679,608,550,1.2820512820512822,3.0
23231,39084,15,39084,964,14,1,10.0,63.61
23232,1212,10,1212,482,6,4,16.666666666666668,85.0
23233,2868,0,2868,0,0,0,25.0,50.0
23234,384,35,264,85,30,5,3.4482758620689653,50.68
23235,10550796,3615,2474892,2981887,2149,1466,1.0,0.3
23236,36480,48,0,2704,40,8,50.0,0.0
23237,432,2,432,132,2,0,33.333333333333336,99.89
23238,8020980,1515,8013936,239107,626,889,1.3888888888888888,0.0
23239,34224,54,0,1616,39,15,50.0,0.0
23240,1079076,923,421516,16996,832,91,1.098901098901099,76.62
23241,2412,81,0,853,57,24,100.0,0.0
23242,336,13,336,270,7,6,14.285714285714286,45.75
23243,2448,83,0,461,49,34,50.0,99.99
23244,5688,95,2244,254,65,30,2.0408163265306123,31.95
23245,10257264,56,360,183680,41,15,3.703703703703704,66.09
23246,348,3,0,240,1,2,20.0,97.0
23247,1944,205,0,675,164,41,100.0,0.0
23248,696,367,600,478,313,54,1.0,13.81
23249,2892,9,2892,1009,6,3,20.0,85.22
23250,288,42,264,109,23,19,20.0,67.25
23251,35160,30,35160,656,23,7,6.666666666666667,0.0
23252,4788,109,0,1425,68,41,50.0,0.0
23253,6072,41,0,1517,30,11,100.0,0.0
23254,258360,19,258360,14246,11,8,11.11111111111111,0.0
23255,45636,88,0,3225,67,21,14.285714285714286,0.0
23256,10117740,883,0,4352133,464,419,1.4285714285714286,0.0
23257,2520,32,0,144,31,1,100.0,0.0
23258,528,5,528,57,5,0,14.285714285714286,51.65
23259,10117824,32,10117824,5505,18,14,7.6923076923076925,81.22
23260,7400532,95,0,79274,66,29,33.333333333333336,0.0
23261,10573440,3343,0,5454057,1822,1521,1.0,0.0
23262,216,4,216,114,3,1,25.0,57.41
23263,848148,89,848148,311,63,26,2.0,26.48
23264,326076,3,1356,109116,2,1,100.0,100.0
23265,3936,48,0,816,39,9,50.0,50.0
23266,7015632,319,1188,59005,186,133,1.7857142857142858,0.0
23267,45744,24,0,3353,22,2,100.0,0.0
23268,1047708,522,0,54588,250,272,2.272727272727273,2.9
23269,253080,254,253080,64511,233,21,1.0416666666666667,18.89
23270,4237176,358,0,610431,217,141,6.25,0.0
23271,7376808,625,7376808,419015,347,278,1.1235955056179776,70.91
23272,3888,119,0,748,112,7,100.0,0.0
23273,2088,96,876,329,46,50,100.0,0.0
23274,1619844,539,0,9094,229,310,2.083333333333333,0.0
23275,10337100,422,0,391845,230,192,3.4482758620689653,0.0
23276,168,9,168,61,7,2,14.285714285714286,97.88
23277,93948,83,0,1507,57,26,33.333333333333336,0.0
23278,3876,66,0,639,41,25,100.0,0.0
23279,168,10,168,112,8,2,10.0,68.08
23280,527352,1307,464214,402449,1040,267,1.0,27.9
23281,19596,12,19596,786,11,1,11.11111111111111,61.19
23282,5380572,734,0,1872366,423,311,1.0,0.07
23283,2184,5,2184,1927,5,0,14.285714285714286,95.02
23284,60216,46,0,2324,31,15,100.0,0.0
23285,784476,31,784476,590,26,5,4.3478260869565215,51.54
23286,57840,18,57840,1604,15,3,7.6923076923076925,72.31
23287,18504,55,0,1174,42,13,50.0,0.0
23288,36756,36,0,2444,29,7,100.0,0.0
23289,96,1,96,12,1,0,33.333333333333336,55.5
23290,35100,51,35100,110,47,4,2.127659574468085,57.63
23291,10116180,54,0,262796,30,24,3.4482758620689653,0.0
23292,77436,15,0,5836,13,2,100.0,100.0
23293,842424,5,842424,297,5,0,16.666666666666668,80.64
23294,1716,3,1716,624,3,0,20.0,52.88
23295,5232,35,5232,1364,31,4,4.761904761904762,72.27
23296,17328,26,17328,1113,25,1,5.0,66.35
23297,15912,146,0,1495,98,48,100.0,0.0
23298,160608,64,160608,19210,56,8,100.0,0.0
23299,7625664,382,1283052,437447,193,189,1.4492753623188406,0.0
23300,9382080,363,0,30419,206,157,2.127659574468085,0.0
23301,13680,88,13680,200,64,24,1.8867924528301887,20.48
23302,492,6,0,264,2,4,20.0,0.0
23303,876,84,876,23,84,0,2.1739130434782608,48.68
23304,59736,52,0,2721,42,10,50.0,0.0
23305,57840,56,0,2621,46,10,100.0,0.0
23306,883872,175,146316,46660,138,37,1.1111111111111112,10.68
23307,3312,17,0,455,14,3,100.0,100.0
23308,14676,121,14676,185,78,43,2.083333333333333,42.34
23309,3432,61,0,913,49,12,50.0,50.0
23310,53736,42,0,2320,27,15,100.0,0.0
23311,900,40,900,460,30,10,3.8461538461538463,62.18
23312,6454680,36,676572,1390900,29,7,1.351351351351351,68.39
23313,5320440,262,3796080,2914215,222,40,3.703703703703704,11.53
23314,8168772,35,5292,233591,30,5,3.4482758620689653,40.39
23315,17052,37,17052,134,35,2,2.7777777777777777,29.89
23316,5688,8,5688,733,8,0,12.5,82.47
23317,161112,5,161112,9482,5,0,16.666666666666668,82.14
23318,19356,30,19356,3022,26,4,5.0,0.0
23319,10563564,2614,0,4539361,1747,867,1.0,0.0
23320,90144,22,90144,3678,19,3,8.333333333333334,61.5
23321,247716,99,247716,17621,78,21,2.631578947368421,5.03
23322,704100,98,704100,2635,82,16,100.0,0.0
23323,10884,12,10884,1244,10,2,12.5,75.56
23324,33372,59,0,1773,42,17,50.0,0.0
23325,9633084,246,9633072,120676,139,107,2.272727272727273,0.0
23326,67908,47,0,2548,39,8,50.0,0.0
23327,703032,1,703032,444,1,0,50.0,54.74
23328,25356,107,0,3096,80,27,20.0,0.0
23329,3012,22,3012,1015,19,3,6.666666666666667,1.28
23330,5052,14,0,975,12,2,50.0,99.99
23331,2040,37,2040,932,28,9,5.882352941176471,95.27
23332,8381532,64,0,3367937,28,36,2.7777777777777777,0.0
23333,33012,11,33012,463,10,1,12.5,28.74
23334,2532,21,2532,753,19,2,7.142857142857143,2.79
23335,15864,20,15864,653,19,1,5.882352941176471,75.79
23336,2184,16,0,615,13,3,100.0,0.0
23337,8924940,60,8924904,704491,35,25,8.333333333333334,0.0
23338,1212,34,1212,18,34,0,2.7777777777777777,44.3
23339,18336,39,0,2247,32,7,100.0,0.0
23340,2964,8,2964,354,8,0,14.285714285714286,75.2
23341,15480,25,15480,972,23,2,5.2631578947368425,75.24
23342,3636,7,3636,963,6,1,25.0,0.0
23343,4560,16,0,557,14,2,50.0,99.0
23344,24144,42,0,1766,27,15,100.0,0.0
23345,144,3,144,52,2,1,33.333333333333336,55.17
23346,31368,47,0,2188,40,7,100.0,0.0
23347,1216560,873,1216560,944103,726,147,1.0,47.3
23348,4548444,22,300,206816,22,0,5.0,56.21
23349,31128,51,31128,142,47,4,3.703703703703704,56.4
23350,23532,32,23532,6882,22,10,14.285714285714286,75.41
23351,1775484,29,784080,75086,25,4,4.761904761904762,52.67
23352,85248,8,0,10818,7,1,100.0,0.0
23353,48,0,48,0,0,0,50.0,78.15
23354,48,1,48,0,1,0,33.333333333333336,65.6
23355,33960,17,33960,100,16,1,5.882352941176471,40.09
23356,19992,45,0,1561,29,16,100.0,0.0
23357,19692,48,19692,385,39,9,2.702702702702702,12.79
23358,300,81,300,155,43,38,4.761904761904762,83.73
23359,789816,578,0,7000,295,283,1.0,0.0
23360,23700,101,0,2418,66,35,50.0,0.0
23361,31188,18,31188,969,15,3,9.090909090909092,81.49
23362,3456,43,3456,814,33,10,4.545454545454546,42.93
23363,372,100,276,130,57,43,3.333333333333333,0.0
23364,7476,34,0,1548,29,5,100.0,0.0
23365,900,61,900,28,49,12,2.2222222222222223,40.89
23366,607176,9,607176,396,9,0,12.5,79.12
23367,8208,35,0,1410,30,5,100.0,0.0
23368,239580,17,239580,34032,9,8,14.285714285714286,24.1
23369,5148,23,5148,733,20,3,5.555555555555555,10.76
23370,264,18,264,120,17,1,5.555555555555555,40.17
23371,8156076,2095,1207988,1524200,1259,836,1.0,0.0
23372,8385168,596,0,50615,341,255,1.96078431372549,1.75
23373,4776,2,4776,4560,2,0,25.0,96.46
23374,13752,15,0,1183,12,3,50.0,99.99
23375,1080,11,0,735,4,7,25.0,90.0
23376,44076,19,44076,2060,10,9,33.333333333333336,73.93
23377,14640,42,14640,5325,29,13,8.333333333333334,91.43
23378,1955304,141,1705014,336738,126,15,1.020408163265306,6.12
23379,24972,45,0,1809,34,11,50.0,0.0
23380,8360064,219,564,38517,145,74,1.0,24.27
23381,4656,24,4656,933,21,3,6.25,67.28
23382,300,36,300,114,21,15,7.142857142857143,74.76
23383,8604564,111,0,1559467,91,20,33.333333333333336,0.0
23384,120,30,120,33,18,12,7.142857142857143,56.97
23385,9456720,1123,0,46500,652,471,1.020408163265306,0.0
23386,1896,14,0,399,11,3,100.0,100.0
23387,17556,40,0,1428,25,15,100.0,0.0
23388,2112,59,0,619,50,9,50.0,99.98
23389,276,3,276,76,2,1,33.333333333333336,69.46
23390,1212,31,1212,318,21,10,12.5,83.91
23391,24384,54,0,1338,40,14,50.0,0.0
23392,156,16,156,52,11,5,12.5,66.02
23393,516,10,72,111,6,4,25.0,64.43
23394,27396,9,27396,206,8,1,12.5,0.84
23395,47784,1,47784,7800,1,0,33.333333333333336,57.87
23396,132,1,132,12,1,0,33.333333333333336,78.0
23397,72996,237,288,770,145,92,1.1904761904761905,9.67
23398,276,46,276,26,44,2,2.2222222222222223,58.82
23399,1992,49,1992,682,35,14,8.333333333333334,65.82
23400,1008,105,1008,195,59,46,2.5,48.71
23401,4748280,82,4748280,156619,41,41,9.090909090909092,82.47
23402,10033140,1269,0,70264,528,741,1.0,5.0
23403,324,3,324,140,3,0,25.0,63.83
23404,1716,43,1716,501,30,13,9.090909090909092,71.65
23405,1812,4,1812,408,4,0,16.666666666666668,47.66
23406,17316,71,0,2680,60,11,100.0,0.0
23407,348,41,348,19,41,0,4.3478260869565215,63.66
23408,75588,58,75588,10438,49,9,3.125,4.51
23409,1080,25,1080,315,13,12,14.285714285714286,45.63
23410,900,51,900,25,51,0,3.0303030303030303,73.79
23411,72312,11,72312,1023,7,4,25.0,88.54
23412,1560,44,1560,556,32,12,7.6923076923076925,69.63
23413,1008,32,840,386,27,5,4.761904761904762,49.65
23414,1752,5,1752,36,4,1,25.0,99.2
23415,42624,159,42624,3417,123,36,1.25,5.22
23416,924,31,924,627,23,8,5.0,84.63
23417,223632,96,0,4544,63,33,50.0,0.0
23418,5441532,7,0,1556240,6,1,100.0,100.0
23419,49968,166,0,3380,108,58,100.0,0.0
23420,2064,47,2064,985,34,13,7.142857142857143,60.07
23421,59664,88,0,1507,59,29,25.0,0.0
23422,25404,28,25404,2419,26,2,5.555555555555555,71.22
23423,2412,105,2412,95,60,45,2.702702702702702,0.0
23424,37164,7,37164,522,7,0,12.5,44.71
23425,32964,273,0,1078,135,138,50.0,0.0
23426,61692,94,0,1186,55,39,50.0,0.0
23427,4512,109,0,1432,61,48,100.0,0.0
23428,3240,27,3180,1232,26,1,6.666666666666667,73.74
23429,70500,51,70500,435,29,22,5.0,64.58
23430,63720,64,0,1730,49,15,50.0,0.0
23431,9285948,916,0,67338,568,348,1.098901098901099,0.0
23432,480,93,480,25,91,2,2.0,56.37
23433,768,5,768,122,3,2,100.0,0.0
23434,7452,10,3780,1428,9,1,16.666666666666668,83.34
23435,65196,125,0,919,101,24,33.333333333333336,0.0
23436,3113640,51,3113640,16026,28,23,6.25,75.13
23437,21480,10,21480,523,10,0,11.11111111111111,72.32
23438,18036,39,0,1500,25,14,100.0,0.0
23439,21204,38,0,1618,28,10,50.0,0.0
23440,85632,86,0,13398,34,52,20.0,0.0
23441,22044,73,0,1332,58,15,50.0,0.0
23442,492,101,492,45,99,2,1.6129032258064515,47.15
23443,3300,25,3300,1058,23,2,6.25,63.89
23444,7512,17,0,1776,14,3,50.0,0.0
23445,3708,187,0,1248,114,73,100.0,0.0
23446,4548,5,4548,388,4,1,25.0,88.83
23447,3528,13,3528,980,13,0,12.5,72.97
23448,1848,6,1848,554,6,0,14.285714285714286,89.05
23449,1248,34,1248,676,25,9,7.6923076923076925,57.5
23450,2124,16,0,453,11,5,100.0,100.0
23451,660,9,660,265,7,2,16.666666666666668,92.28
23452,4632,17,4632,1163,16,1,7.6923076923076925,35.39
23453,39396,46,0,1904,31,15,100.0,0.0
23454,3084,8,3084,436,8,0,14.285714285714286,71.36
23455,456,3,456,184,1,2,33.333333333333336,99.56
23456,132,26,132,77,21,5,5.555555555555555,76.29
23457,7783188,62,7783188,184882,36,26,9.090909090909092,0.0
23458,7905168,413,0,40357,212,201,2.272727272727273,0.0
23459,1380,23,1380,437,17,6,20.0,86.08
23460,792,4,792,288,2,2,50.0,93.48
23461,2868,17,2868,597,15,2,11.11111111111111,59.7
23462,2568,18,2568,654,14,4,10.0,28.89
23463,5872440,652,0,95399,319,333,3.125,0.0
23464,21636,70,0,3969,58,12,50.0,0.0
23465,10183368,5175,35376,371694,2222,2953,1.0,0.0
23466,5240100,125,5240100,112349,65,60,5.555555555555555,63.86
23467,23112,15,23112,1009,13,2,9.090909090909092,0.82
23468,1236,8,1236,372,2,6,33.333333333333336,95.9
23469,3120,11,3120,70,7,4,20.0,70.6
23470,4596,22,4596,2033,22,0,6.666666666666667,34.44
23471,31392,109,0,4865,77,32,50.0,0.0
23472,1092,14,0,302,10,4,50.0,0.0
23473,52224,31,22408,8217,31,0,4.166666666666667,0.18
23474,324,1,324,144,1,0,33.333333333333336,56.0
23475,6272928,547,2502624,61443,293,254,1.408450704225352,66.94
23476,1328676,19,2064,70676,16,3,9.090909090909092,27.31
23477,2916684,28,63432,209115,22,6,5.882352941176471,0.0
23478,91248,9,91248,15590,9,0,4.545454545454546,61.9
23479,9722736,2128,0,63100,1166,962,1.0,0.0
23480,19284,150,0,815,99,51,100.0,0.0
23481,34296,79,0,2404,63,16,50.0,0.0
23482,6516,46,5604,2504,33,13,7.6923076923076925,65.0
23483,1155864,1333,592098,7596,1163,170,1.0,43.01
23484,6245832,334,598512,71774,210,124,3.125,0.0
23485,75768,127,0,1657,113,14,50.0,0.0
23486,8628,75,0,1360,48,27,50.0,0.0
23487,6612,48,0,2051,41,7,100.0,0.0
23488,1944,12,1944,613,11,1,10.0,35.49
23489,3096,57,0,844,46,11,50.0,50.0
23490,15492,50,0,1405,40,10,50.0,0.0
23491,2914500,18,6336,486927,17,1,7.6923076923076925,76.21
23492,5352,107,0,1824,55,52,100.0,0.0
23493,4644,56,4644,1335,47,9,2.5641025641025643,0.0
23494,372,20,372,115,17,3,6.666666666666667,0.0
23495,348,3,348,108,3,0,33.333333333333336,90.49
23496,12420,15,12420,1037,14,1,8.333333333333334,84.45
23497,5772,104,0,1135,79,25,100.0,0.0
23498,816,23,816,361,19,4,6.25,0.0
23499,30036,20,30036,421,16,4,10.0,70.9
23500,504,17,504,273,11,6,12.5,71.85
23501,11952,91,11952,113,91,0,1.8867924528301887,54.78
23502,2616,13,2616,542,11,2,12.5,83.33
23503,23412,24,23412,849,22,2,5.555555555555555,75.73
23504,9281448,380,0,458023,221,159,3.0303030303030303,0.0
23505,228,0,228,0,0,0,100.0,100.0
23506,5544,166,5544,2130,140,26,1.0526315789473684,11.78
23507,2492592,186,2492592,16864,97,89,3.225806451612903,84.0
23508,16764,35,0,1894,21,14,50.0,0.0
23509,22800,43,0,1916,28,15,100.0,0.0
23510,408,24,408,174,21,3,6.25,59.01
23511,27768,27,5316,1938,19,8,3.0303030303030303,0.0
23512,18516,34,11064,1588,31,3,5.555555555555555,61.88
23513,2484,61,2484,2176,39,22,3.333333333333333,76.7
23514,1272,136,0,247,109,27,1.020408163265306,0.0
23515,13548,42,0,2184,37,5,100.0,0.0
23516,5052,44,0,690,36,8,50.0,50.0
23517,852048,17,14328,50896,17,0,8.333333333333334,33.77
23518,7869684,191,0,136330,115,76,5.2631578947368425,4.06
23519,7720980,25,0,310039,19,6,50.0,0.0
23520,132,7,132,20,7,0,11.11111111111111,50.39
23521,84,0,84,0,0,0,50.0,64.0
23522,9552168,38,6112260,3414,20,18,9.090909090909092,61.68
23523,936,2,168,474,2,0,50.0,95.91
23524,524976,45,524976,1805,30,15,14.285714285714286,69.89
23525,10051308,325,0,144932,164,161,3.225806451612903,5.0
23526,16068,63,0,1663,54,9,50.0,0.0
23527,10693452,8091,122496,1479286,5150,2941,1.0,0.0
23528,37320,65,37320,32012,46,19,4.761904761904762,73.06
23529,101496,6,101496,188,6,0,12.5,0.0
23530,7937484,340,0,149610,185,155,2.1739130434782608,2.0
23531,276,14,276,40,11,3,10.0,57.27
23532,768,34,768,214,26,8,6.25,49.9
23533,2016,92,2016,136,88,4,1.1904761904761905,40.29
23534,9658632,137,5558886,254837,66,71,5.882352941176471,91.1
23535,66672,34,14556,2698,28,6,7.142857142857143,0.0
23536,4373292,36,0,365827,30,6,50.0,0.0
23537,13404,27,13404,1414,18,9,10.0,81.84
23538,432,9,432,85,6,3,25.0,52.7
23539,528,17,528,190,14,3,8.333333333333334,0.0
23540,2472,40,2472,1282,32,8,6.25,76.09
23541,6828,12,6828,973,11,1,12.5,39.98
23542,17952,48,0,1378,31,17,100.0,0.0
23543,103920,123,0,1943,80,43,25.0,0.0
23544,84,14,84,26,9,5,16.666666666666668,51.61
23545,900,82,900,81,74,8,1.408450704225352,39.28
23546,1294560,20,1294560,8817,17,3,6.666666666666667,45.79
23547,19128,55,0,1222,37,18,50.0,0.0
23548,18420,5,18420,405,5,0,16.666666666666668,46.34
23549,8964,37,0,1458,30,7,100.0,0.0
23550,6420,15,0,775,12,3,100.0,100.0
23551,16308,25,16308,999,23,2,5.555555555555555,70.37
23552,19584,60,0,1242,40,20,50.0,0.0
23553,44892,68,44892,2281,42,26,10.0,55.12
23554,67044,11,67044,1275,9,2,16.666666666666668,70.43
23555,10524,20,10524,1548,19,1,5.882352941176471,54.86
23556,10108428,272,2530164,94856,167,105,2.4390243902439024,71.2
23557,2100,6,2100,460,6,0,16.666666666666668,67.42
23558,1068,40,1068,40,36,4,2.7777777777777777,45.04
23559,45852,15,45852,2899,12,3,11.11111111111111,79.39
23560,2472,21,0,535,18,3,50.0,99.99
23561,1675068,617,309320,186359,617,0,1.818181818181818,97.71
23562,240,111,240,91,57,54,3.125,61.78
23563,6300,20,6300,1725,18,2,6.666666666666667,73.43
23564,17112,49,0,1503,33,16,100.0,0.0
23565,6201924,465,0,36884,231,234,3.571428571428572,4.75
23566,1080,42,1080,7,42,0,2.272727272727273,27.08
23567,2156388,719,2156388,89498,407,312,1.2658227848101269,0.0
23568,10488,39,0,2108,33,6,100.0,0.0
23569,372,18,372,100,16,2,6.25,66.75
23570,61428,8,0,8554,7,1,50.0,0.0
23571,12588,70,0,1783,59,11,50.0,0.0
23572,283068,70,283068,3832,57,13,2.3255813953488373,65.7
23573,924,0,906,0,0,0,100.0,100.0
23574,12936,55,0,1165,39,16,100.0,0.0
23575,96612,17,96612,698,14,3,10.0,70.16
23576,12300,52,0,1046,35,17,50.0,0.0
23577,1284,2,1284,660,1,1,50.0,55.61
23578,783984,146,783864,91219,115,31,1.0,29.79
23579,6924,25,0,2993,22,3,100.0,0.0
23580,14208,73,0,1746,50,23,50.0,0.0
23581,387612,1038,156964,7524,877,161,1.0,0.0
23582,1596,6,1596,1420,4,2,20.0,93.98
23583,3468,22,0,1627,18,4,33.333333333333336,0.0
23584,14460,50,7212,4589,36,14,7.142857142857143,51.16
23585,509976,228,1536,31622,140,88,2.9411764705882355,0.0
23586,15456,18,0,1012,10,8,50.0,0.0
23587,53100,51,0,2724,43,8,50.0,0.0
23588,696,34,696,4,34,0,2.7777777777777777,27.02
23589,1668,64,0,765,55,9,50.0,99.98
23590,12180,16,12180,710,14,2,10.0,85.88
23591,2568,1,0,2568,0,1,50.0,0.0
23592,82284,16,82284,354,15,1,12.5,77.09
23593,3995616,28,3995616,7286,15,13,20.0,60.27
23594,1008,33,1008,100,32,1,4.166666666666667,67.77
23595,10212,56,0,1155,38,18,100.0,0.0
23596,20496,13,20496,1223,13,0,8.333333333333334,21.02
23597,936,11,936,354,10,1,10.0,83.55
23598,468,41,468,18,41,0,2.3255813953488373,36.53
23599,4308,25,768,386,23,2,4.3478260869565215,63.47
23600,360,4,360,129,4,0,20.0,75.35
23601,2868,2,2868,1272,2,0,25.0,87.0
23602,504,28,504,89,26,2,3.703703703703704,56.94
23603,4116,18,4116,1458,13,5,14.285714285714286,86.07
23604,1896,19,1896,768,16,3,8.333333333333334,71.81
23605,3204,51,0,806,43,8,50.0,87.89
23606,91812,52,0,7211,45,7,50.0,0.0
23607,1212,12,1212,400,12,0,9.090909090909092,89.14
23608,6152976,49,7020,495276,40,9,4.166666666666667,62.52
23609,14028,3,14028,388,2,1,33.333333333333336,79.66
23610,3336,28,3336,3136,16,12,8.333333333333334,77.34
23611,768,15,648,374,13,2,10.0,71.65
23612,31512,11,15984,5859,5,6,14.285714285714286,96.2
23613,4836300,63,4836180,76967,32,31,5.2631578947368425,16.64
23614,7596924,618,7596924,151697,271,347,2.4390243902439024,80.82
23615,17664,51,216,408,30,21,8.333333333333334,58.46
23616,5184,96,5184,76,93,3,1.8867924528301887,52.84
23617,1776,16,1776,729,15,1,10.0,69.86
23618,1356,0,1356,0,0,0,50.0,75.0
23619,10719192,157,4580481,1713002,91,66,3.571428571428572,0.0
23620,7656,43,7656,131,34,9,3.333333333333333,60.72
23621,5580,19,1620,1026,16,3,8.333333333333334,73.36
23622,768,84,768,161,56,28,2.272727272727273,35.46
23623,7140,55,684,282,52,3,1.96078431372549,49.67
23624,10501848,47,123678,3095088,27,20,1.0,0.0
23625,816,10,816,274,8,2,16.666666666666668,78.68
23626,10689156,3141,0,810849,1760,1381,1.0,0.0
23627,132,8,132,36,7,1,12.5,51.37
23628,960,55,960,354,41,14,2.857142857142857,47.05
23629,2496,108,1296,380,80,28,2.083333333333333,55.75
23630,19824,67,0,1134,48,19,100.0,0.0
23631,7512,57,624,359,53,4,2.1739130434782608,41.26
23632,2016,89,2016,31,89,0,1.96078431372549,55.42
23633,216024,5,216024,24098,2,3,50.0,0.0
23634,10536,61,0,2450,52,9,100.0,0.0
23635,192,12,192,89,4,8,50.0,89.2
23636,228,11,228,56,4,7,50.0,64.85
23637,1116,5,1116,244,3,2,50.0,98.0
23638,2808,18,2808,678,14,4,14.285714285714286,85.5
23639,180,22,96,56,18,4,20.0,99.96
23640,360,7,360,51,5,2,20.0,72.58
23641,3204,234,612,127,123,111,3.571428571428572,71.59
23642,708,0,708,0,0,0,50.0,56.25
23643,1800,51,1800,163,51,0,1.9230769230769231,21.0
23644,1860,133,1860,148,79,54,2.0,44.63
23645,5256,13,5256,361,7,6,25.0,95.77
23646,51852,194,0,3647,115,79,100.0,0.0
23647,12540,70,0,1369,56,14,33.333333333333336,0.0
23648,372,42,372,147,24,18,6.25,76.84
23649,252,23,252,80,21,2,4.545454545454546,81.14
23650,1788,24,1788,584,17,7,16.666666666666668,81.33
23651,70416,83,70416,311,83,0,1.408450704225352,15.32
23652,5964,62,0,1494,38,24,100.0,0.0
23653,47508,117,1128,874,111,6,1.4705882352941178,47.11
23654,1884,24,1884,179,20,4,5.882352941176471,88.49
23655,4140,6,4140,770,5,1,14.285714285714286,56.67
23656,39996,26,39996,2950,19,7,10.0,60.37
23657,10507704,1559,0,59364,924,635,1.0,0.0
23658,10625748,117,10117152,6822104,60,57,1.351351351351351,0.0
23659,240,0,240,0,0,0,50.0,89.2
23660,2376,68,0,752,45,23,50.0,0.0
23661,55260,16,55260,646,13,3,50.0,99.99
23662,9072,57,9072,5423,41,16,6.666666666666667,52.38
23663,17796,14,17796,1321,14,0,8.333333333333334,55.85
23664,1032,99,1032,444,90,9,1.4705882352941178,37.65
23665,16272,21,16272,489,19,2,5.882352941176471,0.64
23666,8034744,187,0,43593,99,88,8.333333333333334,0.0
23667,65088,216,0,839,174,42,50.0,0.0
23668,1356,4,1356,288,3,1,50.0,99.99
23669,648,24,600,501,14,10,10.0,66.82
23670,12408,34,12408,1089,29,5,5.0,43.52
23671,9444276,892,0,231364,361,531,1.351351351351351,0.0
23672,324,67,300,127,41,26,4.166666666666667,65.41
23673,53400,160,53400,2369,121,39,1.3333333333333333,2.32
23674,2664,13,2664,712,9,4,20.0,54.83
23675,4272,22,4272,1351,21,1,6.25,74.48
23676,9432,22,9432,2552,18,4,8.333333333333334,55.11
23677,150660,48,1704,4080,40,8,4.166666666666667,84.73
23678,6670596,63,77808,106533,59,4,1.694915254237288,52.95
23679,1596,20,1596,346,10,10,20.0,0.0
23680,3795576,27,3795576,835,16,11,20.0,91.0
23681,28116,43,0,1721,29,14,100.0,0.0
23682,10692708,233,0,264774,117,116,5.0,0.0
23683,10703976,1276,0,978850,743,533,1.0,1.81
23684,19644,34,19644,1984,28,6,5.555555555555555,47.97
23685,23448,43,23448,1467,36,7,4.166666666666667,0.0
23686,9932280,1416,363393,81529,1203,213,1.0,51.2
23687,602232,16,0,38331,12,4,10.0,0.04
23688,432396,50,216924,13444,31,19,20.0,97.17
23689,1416,47,0,669,36,11,3.8461538461538463,0.0
23690,666468,147,666468,11802,89,58,4.166666666666667,64.82
23691,792,46,792,367,35,11,4.166666666666667,0.0
23692,2028,10,2028,322,10,0,7.6923076923076925,43.44
23693,55176,2,55176,90,1,1,50.0,74.06
23694,1284,7,1284,138,4,3,25.0,29.02
23695,1320,10,1320,130,7,3,16.666666666666668,85.5
23696,28896,122,0,645,78,44,33.333333333333336,0.0
23697,1236,27,504,193,20,7,7.142857142857143,0.0
23698,571032,2,571032,162,1,1,50.0,76.11
23699,672,24,672,380,15,9,14.285714285714286,83.28
23700,180,22,180,19,18,4,6.25,36.96
23701,312,9,312,74,5,4,33.333333333333336,48.39
23702,2904,71,1200,488,42,29,6.25,74.74
23703,237252,43,0,6758,32,11,4.761904761904762,0.0
23704,9546108,304,0,724393,148,156,1.2658227848101269,0.0
23705,758280,3,68808,253376,2,1,33.333333333333336,95.98
23706,519912,88,519912,24414,45,43,4.761904761904762,80.39
23707,120,0,120,0,0,0,100.0,85.0
23708,6448476,836,0,38502,424,412,2.380952380952381,1.99
23709,288,53,288,46,40,13,3.8461538461538463,38.51
23710,540,46,528,320,33,13,4.545454545454546,0.0
23711,30420,45,0,917,35,10,50.0,0.0
23712,120,15,120,37,11,4,11.11111111111111,36.41
23713,10529352,768,0,47581,418,350,1.8867924528301887,0.1
23714,432948,1847,219048,21584,971,876,1.0,0.0
23715,6979284,40,0,177868,32,8,33.333333333333336,0.0
23716,588,41,576,181,27,14,6.666666666666667,79.47
23717,2643828,91,2643828,5379,40,51,9.090909090909092,72.49
23718,34644,74,0,672,58,16,50.0,0.0
23719,2784,56,0,800,41,15,50.0,0.0
23720,46764,47,0,3980,33,14,50.0,0.0
23721,3660,7,3660,3414,7,0,12.5,88.15
23722,8798352,2263,0,156737,1215,1048,1.0,0.0
23723,5124,40,5124,1356,36,4,3.4482758620689653,0.0
23724,3840,20,0,2139,7,13,20.0,0.0
23725,15816,18,15816,1331,18,0,5.882352941176471,72.76
23726,38328,89,0,1348,63,26,50.0,0.0
23727,14352,151,0,761,98,53,100.0,0.0
23728,9457980,516,0,76209,273,243,2.083333333333333,0.0
23729,318864,190,318864,30567,126,64,1.0,54.26
23730,10350432,1354,0,225642,711,643,1.0,0.0
23731,62568,5,62568,312,5,0,14.285714285714286,57.49
23732,6672,3,6672,204,3,0,25.0,75.95
23733,2412,37,2412,601,33,4,3.4482758620689653,0.0
23734,836928,79,836856,70757,64,15,1.020408163265306,35.24
23735,90396,47,90396,2614,37,10,3.8461538461538463,51.54
23736,4128,1,4128,3996,1,0,25.0,75.44
23737,10768524,11653,7946412,8475194,7938,3715,1.0,0.0
23738,3180,45,0,857,37,8,50.0,50.0
23739,16308,35,16308,4330,25,10,6.666666666666667,66.93
23740,791760,67,791760,12220,53,14,100.0,0.0
23741,6251712,506,1537740,1264731,298,208,1.1764705882352942,0.0
23742,17244,29,17244,7640,21,8,7.6923076923076925,67.25
23743,48960,15,48960,450,14,1,14.285714285714286,74.22
23744,72048,22,72048,1675,19,3,6.666666666666667,74.52
23745,14256,45,0,2148,30,15,100.0,0.0
23746,648,59,648,24,57,2,1.7241379310344829,28.53
23747,4323228,46,0,329692,32,14,50.0,0.0
23748,37272,57,0,5308,46,11,100.0,0.0
23749,47784,14,47784,986,12,2,9.090909090909092,79.39
23750,59964,55,0,3097,40,15,50.0,0.0
23751,732,7,732,25,4,3,33.333333333333336,91.53
23752,4320,7,1260,1402,1,6,50.0,0.0
23753,8551440,70,0,2772172,41,29,11.11111111111111,0.0
23754,2604,28,2604,844,20,8,7.6923076923076925,64.13
23755,3636,24,3636,1390,17,7,12.5,73.69
23756,128712,31,7620,4418,30,1,4.545454545454546,0.0
23757,120,12,120,10,12,0,7.142857142857143,47.25
23758,420,4,420,99,3,1,50.0,99.76
23759,17808,49,0,2317,41,8,100.0,0.0
23760,2700,51,2700,617,44,7,3.4482758620689653,0.0
23761,23568,6,23568,276,4,2,25.0,96.66
23762,14244,45,0,2039,40,5,33.333333333333336,0.0
23763,2232,48,0,764,39,9,50.0,50.0
23764,25896,5,25896,600,4,1,33.333333333333336,93.61
23765,288,6,288,116,2,4,100.0,100.0
23766,9936,47,0,1412,32,15,100.0,0.0
23767,840,19,840,322,16,3,7.6923076923076925,55.37
23768,70128,67,0,2414,44,23,33.333333333333336,0.0
23769,22608,3,13032,7968,3,0,25.0,47.59
23770,13380,15,13380,747,14,1,8.333333333333334,73.81
23771,2563500,23,18000,223641,21,2,5.882352941176471,77.79
23772,22116,17,22116,1784,17,0,6.25,77.16
23773,10558800,257,0,298993,146,111,2.272727272727273,0.0
23774,6696,39,0,1648,35,4,100.0,0.0
23775,4716,15,4716,742,12,3,11.11111111111111,61.08
23776,8448,89,0,3726,77,12,2.7777777777777777,0.0
23777,8688,45,0,1938,36,9,100.0,0.0
23778,74856,62,0,5923,46,16,50.0,0.0
23779,38652,8,38652,727,6,2,20.0,85.0
23780,1214112,21,0,69234,18,3,100.0,0.0
23781,173460,32,173460,645,29,3,3.333333333333333,40.76
23782,8184,60,0,1015,42,18,100.0,0.0
23783,55332,3,55332,1980,3,0,33.333333333333336,90.92
23784,6336,11,0,916,9,2,100.0,100.0
23785,1327956,91,0,187006,43,48,20.0,0.0
23786,458376,771,429468,75670,732,39,1.0,6.09
23787,10152552,93,0,574854,78,15,25.0,0.0
23788,1243236,126,0,48906,75,51,4.3478260869565215,0.0
23789,19716,20,19716,1464,18,2,7.6923076923076925,50.57
23790,0,0,0,0,0,0,50.0,0.0
23791,6756,10,6756,294,9,1,12.5,77.56
23792,6396,41,0,1412,35,6,100.0,0.0
23793,10644180,455,0,3551008,297,158,1.098901098901099,0.69
23794,5796,50,5796,1071,42,8,3.333333333333333,0.0
23795,251664,70,0,11870,46,24,50.0,0.0
23796,4824,4,4824,1587,3,1,33.333333333333336,88.03
23797,1920,5,1920,165,3,2,33.333333333333336,72.02
23798,54576,6,54576,764,5,1,16.666666666666668,87.14
23799,9590976,236,4795596,86265,174,62,7.6923076923076925,8.05
23800,432,11,432,60,6,5,16.666666666666668,50.26
23801,42576,66,0,2230,43,23,50.0,0.0
23802,732,38,732,262,19,19,50.0,81.7
23803,9672,79,9672,2130,67,12,1.6666666666666667,18.27
23804,10147980,185,0,139972,88,97,3.8461538461538463,0.0
23805,5520,78,5520,829,38,40,4.0,64.42
23806,80340,2,80340,6,2,0,25.0,58.07
23807,156,3,156,84,1,2,100.0,100.0
23808,3410028,60,0,282040,51,9,33.333333333333336,0.0
23809,2304,37,0,985,32,5,50.0,87.89
23810,81000,0,81000,0,0,0,50.0,59.29
23811,348,5,348,0,5,0,14.285714285714286,85.77
23812,132,6,108,44,5,1,14.285714285714286,56.34
23813,14808,62,0,1652,47,15,50.0,0.0
23814,14076,61,0,1247,43,18,100.0,0.0
23815,144,2,144,24,2,0,20.0,60.2
23816,758856,93,0,17481,52,41,20.0,0.0
23817,120,1,120,120,1,0,100.0,100.0
23818,240,4,240,90,4,0,20.0,89.79
23819,8800356,325,0,81406,167,158,3.703703703703704,0.0
23820,336,8,336,6,8,0,10.0,60.01
23821,396,11,396,56,11,0,7.6923076923076925,63.04
23822,192,14,192,29,6,8,25.0,60.8
23823,287496,4,287496,30,4,0,16.666666666666668,64.02
23824,120,5,96,52,4,1,16.666666666666668,65.93
23825,96,3,96,0,3,0,20.0,63.92
23826,2555760,68,2555760,1623,27,41,9.090909090909092,90.01
23827,8098824,71,0,117696,28,43,16.666666666666668,0.0
23828,47664,58,47664,664,50,8,2.083333333333333,34.52
23829,168,17,168,41,11,6,10.0,68.58
23830,108,0,108,0,0,0,100.0,0.0
23831,8004,38,0,846,31,7,50.0,87.89
23832,876,3,876,0,3,0,20.0,61.43
23833,13092,92,1500,8342,73,19,2.631578947368421,0.0
23834,10657896,3375,1029552,1036928,1877,1498,1.0,0.0
23835,1042536,178,0,7660,82,96,8.333333333333334,0.0
23836,8100744,266,0,79665,129,137,5.0,0.0
23837,204,6,168,104,6,0,14.285714285714286,95.0
23838,1573980,55,1573980,22799,27,28,25.0,0.0
23839,96,1,96,0,1,0,33.333333333333336,62.4
23840,1404,40,1404,1125,38,2,2.5641025641025643,42.44
23841,216,27,216,49,20,7,6.666666666666667,41.09
23842,216,7,216,48,6,1,14.285714285714286,72.82
23843,96,3,96,0,3,0,20.0,64.16
23844,3228,2,3228,78,2,0,33.333333333333336,66.05
23845,1537644,26,420,118423,14,12,10.0,77.02
23846,1200,5,1200,60,5,0,14.285714285714286,68.61
23847,10544016,850,0,128278,473,377,1.0869565217391304,0.0
23848,252,0,252,0,0,0,50.0,59.29
23849,156,56,156,35,46,10,2.272727272727273,33.37
23850,516,10,516,232,7,3,50.0,95.13
23851,216,28,132,24,25,3,4.0,38.98
23852,420,2,420,30,2,0,33.333333333333336,96.01
23853,396,1,396,24,1,0,33.333333333333336,99.04
23854,960,41,960,93,37,4,2.5641025641025643,25.52
23855,780,12,720,130,10,2,10.0,66.96
23856,744,39,744,137,31,8,3.8461538461538463,31.56
23857,5844,0,5844,0,0,0,50.0,95.0
23858,660,4,648,171,3,1,20.0,55.47
23859,30528,108,264,365,88,20,1.351351351351351,36.67
23860,10231080,2105,0,502637,1181,924,1.0,0.0
23861,1056,12,504,167,10,2,10.0,86.52
23862,11304,47,11304,3376,42,5,2.7777777777777777,0.0
23863,780,251,780,179,154,97,1.0,26.32
23864,252,11,252,55,7,4,20.0,55.42
23865,4296,46,4296,3811,41,5,2.4390243902439024,59.09
23866,2532,1,2532,684,1,0,33.333333333333336,58.13
23867,504,19,504,145,11,8,11.11111111111111,86.78
23868,456,0,456,0,0,0,50.0,56.25
23869,10810956,55062,623940,1377725,32172,22890,1.0,0.0
23870,660,20,660,126,20,0,6.25,82.48
23871,767592,176,0,11887,89,87,3.8461538461538463,0.0
23872,600,18,0,318,14,4,50.0,0.0
23873,20988,22,20988,372,17,5,11.11111111111111,73.03
23874,117000,0,117000,0,0,0,50.0,88.0
23875,1056,4,1056,165,4,0,16.666666666666668,60.38
23876,2328,17,0,552,14,3,100.0,100.0
23877,1224,29,168,85,25,4,8.333333333333334,83.93
23878,3216,7,3216,833,6,1,20.0,99.01
23879,1188,42,1188,1000,36,6,3.0303030303030303,57.72
23880,331092,2,331092,18336,1,1,50.0,84.59
23881,276,8,276,81,6,2,16.666666666666668,49.33
23882,1572,3,1572,424,3,0,50.0,98.0
23883,42336,67,0,1013,52,15,50.0,0.0
23884,552,39,552,162,17,22,10.0,50.29
23885,13620,55,528,357,52,3,2.5641025641025643,60.18
23886,39528,152,39528,3444,108,44,4.761904761904762,0.42
23887,45060,137,0,2440,86,51,50.0,0.0
23888,1536,16,1536,532,13,3,10.0,87.92
23889,8703804,2,8703804,831186,1,1,50.0,99.28
23890,59556,48,0,11821,27,21,12.5,0.0
23891,960,15,960,536,11,4,16.666666666666668,58.07
23892,168,1,168,36,1,0,33.333333333333336,55.63
23893,33972,55,0,2722,45,10,100.0,0.0
23894,46524,20,46524,1513,18,2,6.25,7.29
23895,10780092,3476,0,165002,2041,1435,1.0,0.0
23896,7781688,75,7781688,2249,45,30,5.2631578947368425,87.21
23897,9833472,1235,0,55827,709,526,1.0,1.87
23898,672,0,672,0,0,0,50.0,72.25
23899,8606892,382,0,85319,233,149,2.0,0.0
23900,43920,5,43920,9050,4,1,25.0,95.11
23901,11232,3,11232,880,2,1,50.0,93.44
23902,516,11,516,72,11,0,7.6923076923076925,89.3
23903,6480,118,0,1972,74,44,50.0,0.0
23904,190632,32,0,137830,12,20,14.285714285714286,89.42
23905,7749768,56,7749768,999,26,30,8.333333333333334,86.18
23906,792,123,636,192,74,49,1.96078431372549,0.0
23907,52272,121,0,1357,83,38,50.0,0.0
23908,9420,27,9420,1841,23,4,5.882352941176471,65.96
23909,86280,8,86280,477,6,2,20.0,68.43
23910,168,8,168,24,6,2,14.285714285714286,56.22
23911,10753800,325,0,6675735,165,160,1.2048192771084338,90.0
23912,9719640,176,0,105689,73,103,9.090909090909092,0.0
23913,4596,12,4596,1485,6,6,20.0,74.0
23914,468,22,468,285,8,14,25.0,98.33
23915,10589328,648,0,135031,367,281,1.851851851851852,0.0
23916,10364340,14,10364340,3391,8,6,14.285714285714286,90.84
23917,888,77,780,253,42,35,5.2631578947368425,60.28
23918,60936,4,60936,1329,4,0,20.0,96.56
23919,12816,70,0,1644,55,15,33.333333333333336,0.13
23920,10234368,2279,914016,1405702,1247,1032,1.0,4.71
23921,1620,0,1620,0,0,0,25.0,32.0
23922,660,60,660,157,56,4,2.272727272727273,51.79
23923,341508,160,0,3853,119,41,100.0,0.0
23924,300,6,300,100,2,4,50.0,80.74
23925,10830228,15591,708200,3984871,9561,6030,1.0,0.0
23926,10461456,137,114522,1977936,93,44,4.3478260869565215,0.0
23927,4200,9,48,485,8,1,10.0,73.71
23928,1320,2,1320,1116,2,0,25.0,96.0
23929,1836,9,1836,601,6,3,20.0,96.69
23930,29088,48,0,1711,36,12,50.0,0.0
23931,58188,59,0,1377,45,14,50.0,0.0
23932,1776,11,0,567,8,3,100.0,0.0
23933,30156,50,0,2176,42,8,50.0,0.0
23934,40404,9,40404,770,9,0,14.285714285714286,92.28
23935,1092,51,1092,774,33,18,4.0,62.76
23936,1080,18,1080,24,12,6,12.5,43.31
23937,6468,1,6468,360,1,0,33.333333333333336,94.39
23938,21408,29,0,782,16,13,100.0,0.0
23939,60612,80,0,1029,63,17,50.0,0.0
23940,22284,49,0,2497,44,5,100.0,0.0
23941,27060,39,27060,3997,30,9,5.0,0.0
23942,648,80,648,115,54,26,2.272727272727273,36.27
23943,4164,144,0,1349,122,22,100.0,0.0
23944,1008,27,852,339,24,3,4.761904761904762,0.0
23945,9899592,943,0,386171,707,236,1.0,0.0
23946,7476,77,3576,3089,55,22,2.2222222222222223,52.9
23947,23172,109,0,1612,76,33,100.0,0.0
23948,9335232,1401,2661744,30873,771,630,1.0,0.0
23949,2568,193,0,80,140,53,1.0,0.0
23950,10839744,15564,497964,2295929,8356,7208,1.0,0.0
23951,38796,76,0,2634,59,17,50.0,0.0
23952,4068,8,4068,1735,3,5,33.333333333333336,88.11
23953,73284,27,0,3349,24,3,50.0,0.0
23954,80460,8,80460,183,6,2,25.0,94.62
23955,646308,1454,160939,11645,1098,356,1.0,0.0
23956,48840,92,48840,14573,80,12,1.351351351351351,16.47
23957,132,17,96,48,13,4,9.090909090909092,90.56
23958,33780,49,420,817,34,15,4.0,58.26
23959,1236,3,1236,112,2,1,50.0,99.99
23960,7372608,126,0,87260,74,52,4.761904761904762,0.0
23961,1500,38,0,695,33,5,50.0,0.0
23962,12132,51,0,1857,40,11,50.0,0.0
23963,239160,9,239160,31962,7,2,3.4482758620689653,81.39
23964,29976,160,0,966,135,25,100.0,0.0
23965,45720,76,45720,5232,68,8,1.5873015873015872,17.2
23966,252,9,252,84,5,4,6.25,45.53
23967,444,11,444,173,7,4,16.666666666666668,69.91
23968,2316,21,2316,982,11,10,14.285714285714286,58.76
23969,1086912,218,0,176427,130,88,3.703703703703704,0.0
23970,52176,4,52176,267,3,1,25.0,49.37
23971,14136,62,0,1500,50,12,50.0,0.0
23972,3012,38,3012,716,32,6,4.0,0.0
23973,1903500,11,1903500,2866,6,5,33.333333333333336,61.8
23974,1298208,496,0,12016,278,218,1.5625,6.85
23975,69336,172,0,1649,120,52,100.0,0.0
23976,20856,98,0,12919,62,36,50.0,0.0
23977,2280,56,2280,627,45,11,3.333333333333333,0.0
23978,2172,44,2172,600,39,5,3.225806451612903,0.0
23979,6886224,404,0,51937,236,168,2.7777777777777777,0.0
23980,9869232,383,0,29719,200,183,2.5,0.0
23981,5825388,7,0,4463936,4,3,1.0,0.0
23982,84480,39,84480,11736,33,6,100.0,0.0
23983,30300,30,30300,1780,26,4,5.555555555555555,7.23
23984,1908,17,1908,712,12,5,11.11111111111111,95.13
23985,924,47,0,504,39,8,3.225806451612903,0.0
23986,2232,52,2232,932,41,11,4.166666666666667,0.0
23987,1343592,1710,248756,21584,1448,262,1.0,30.54
23988,281304,105,0,14332,82,23,5.555555555555555,0.0
23989,34788,62,0,3056,50,12,50.0,50.0
23990,132,18,72,30,11,7,14.285714285714286,51.65
23991,2328,40,2328,997,35,5,3.333333333333333,0.0
23992,26124,15,26124,1492,14,1,7.6923076923076925,67.18
23993,243072,33,0,9318,29,4,100.0,0.0
23994,3714732,9,3714732,101166,5,4,12.5,70.31
23995,7737840,153,7737840,34297,93,60,3.225806451612903,74.65
23996,437616,36,3192,25392,32,4,4.166666666666667,0.0
23997,6480,29,6480,316,26,3,4.0,51.38
23998,8109312,17159,1828509,1625190,9757,7402,1.0,0.0
23999,1159980,102,524547,426512,92,10,1.5873015873015872,65.17
24000,72204,3,72204,160,3,0,25.0,97.27
24001,3420,3,3420,272,3,0,33.333333333333336,61.72
24002,9138372,230,0,57929,114,116,9.090909090909092,5.8
24003,21708,74,0,1157,59,15,50.0,0.0
24004,3720,2,3720,330,2,0,33.333333333333336,0.89
24005,66228,47,0,3635,37,10,100.0,0.0
24006,3648180,543,3648180,108237,295,248,1.639344262295082,65.47
24007,21036,46,21036,8788,23,23,50.0,99.6
24008,17664,21,17664,851,21,0,5.555555555555555,76.4
24009,612,46,552,337,36,10,5.0,49.78
24010,2505492,81,2505492,496011,40,41,1.9230769230769231,42.87
24011,1288728,29,0,459866,14,15,1.0,15.32
24012,1416,8,960,898,5,3,20.0,69.99
24013,12144,96,0,720,45,51,9.090909090909092,0.0
24014,14856,43,14856,2837,39,4,2.9411764705882355,0.0
24015,552,4,0,279,3,1,25.0,0.0
24016,27000,67,27000,2888,62,5,1.6666666666666667,17.55
24017,36588,15,0,2905,13,2,100.0,100.0
24018,165612,22,165612,4400,18,4,9.090909090909092,51.92
24019,8040,26,8040,767,24,2,5.0,73.09
24020,168,15,168,24,10,5,14.285714285714286,60.63
24021,5760,8,5760,444,7,1,14.285714285714286,93.91
24022,34956,67,0,2176,54,13,50.0,0.0
24023,3108,28,3108,222,26,2,3.8461538461538463,0.0
24024,63840,20,63840,915,18,2,7.142857142857143,74.65
24025,312,7,312,164,4,3,25.0,0.0
24026,28272,52,0,1902,39,13,50.0,0.0
24027,2638800,12,0,245179,8,4,16.666666666666668,0.08
24028,384,11,384,181,8,3,16.666666666666668,0.0
24029,4270092,46,0,609726,37,9,50.0,0.0
24030,5281164,70,5280972,3929,35,35,5.2631578947368425,0.0
24031,252,9,252,80,6,3,25.0,0.0
24032,276,10,276,73,7,3,14.285714285714286,0.0
24033,276,16,276,108,12,4,9.090909090909092,0.0
24034,228,15,228,65,12,3,8.333333333333334,0.0
24035,372,20,372,142,15,5,7.6923076923076925,0.0
24036,5820,13,5820,1561,12,1,12.5,38.12
24037,852,5,204,259,3,2,33.333333333333336,58.05
24038,38268,68,38268,1568,62,6,1.7857142857142858,19.83
24039,8927436,184,0,101993,94,90,4.166666666666667,0.0
24040,0,0,0,0,0,0,16.666666666666668,0.0
24041,372,34,372,165,16,18,11.11111111111111,68.75
24042,144,22,144,29,16,6,8.333333333333334,53.97
24043,1128,53,1128,466,38,15,4.3478260869565215,0.0
24044,5280,12,5280,639,12,0,9.090909090909092,78.97
24045,372,92,354,79,34,58,14.285714285714286,49.63
24046,1392,3,1392,264,2,1,33.333333333333336,62.37
24047,23940,11,23940,1273,11,0,8.333333333333334,71.79
24048,684,9,684,266,7,2,16.666666666666668,0.0
24049,1200,40,1200,370,33,7,3.703703703703704,0.0
24050,174408,151,174408,2112,93,58,1.6666666666666667,58.1
24051,9857172,797,0,76430,448,349,1.408450704225352,1.16
24052,6480,44,0,1687,38,6,100.0,0.0
24053,156,2,156,12,1,1,50.0,58.69
24054,2357916,184,2357916,6638,99,85,3.8461538461538463,80.56
24055,1536,46,1536,415,35,11,4.545454545454546,0.0
24056,23388,43,23388,5624,30,13,7.142857142857143,88.22
24057,8303784,351,4836,33094,197,154,2.1739130434782608,0.0
24058,28560,37,0,2101,31,6,100.0,0.0
24059,2844,90,0,471,46,44,5.0,1.0
24060,1836,23,0,455,17,6,100.0,100.0
24061,4548,152,0,1515,113,39,100.0,0.0
24062,761784,14,761784,7807,8,6,33.333333333333336,80.75
24063,96,4,96,30,2,2,50.0,58.1
24064,5088,66,0,1148,56,10,33.333333333333336,87.89
24065,336,52,0,168,21,31,12.5,0.0
24066,276,45,276,108,25,20,5.882352941176471,90.09
24067,9931092,860,0,1363934,470,390,2.5641025641025643,0.0
24068,1512,114,0,547,88,26,100.0,0.0
24069,10032,10,10032,21,10,0,9.090909090909092,61.09
24070,84,0,84,0,0,0,50.0,64.0
24071,2316,0,2316,0,0,0,50.0,95.0
24072,180,43,180,70,21,22,8.333333333333334,50.66
24073,408,0,408,0,0,0,50.0,59.29
24074,10884,0,10884,0,0,0,50.0,61.23
24075,10428216,467,0,58681,254,213,1.9230769230769231,0.0
24076,8188380,259,0,320780,128,131,3.571428571428572,0.0
24077,5016,53,0,1012,45,8,50.0,87.89
24078,3456,5,3456,2013,3,2,25.0,99.65
24079,360,0,360,0,0,0,50.0,59.29
24080,12408,19,12408,1177,16,3,9.090909090909092,34.3
24081,780,32,780,198,21,11,10.0,88.7
24082,216,0,216,0,0,0,50.0,59.29
24083,108,7,108,27,5,2,20.0,53.71
24084,1692,8,1692,31,4,4,50.0,58.84
24085,1428,43,0,480,37,6,100.0,0.0
24086,120816,61,120816,352,53,8,2.4390243902439024,40.82
24087,1728,2,1728,834,1,1,50.0,74.46
24088,2544,0,2544,0,0,0,50.0,59.29
24089,3192,107,0,478,80,27,100.0,0.0
24090,10888980,3843,2993316,2942652,2180,1663,1.0,0.0
24091,28536,15,28536,364,13,2,9.090909090909092,0.67
24092,10571712,1356,1615698,382408,813,543,1.0,0.0
24093,252,8,252,55,7,1,12.5,67.3
24094,1452,24,1452,380,17,7,20.0,43.07
24095,1560,50,0,644,17,33,12.5,0.0
24096,1260,3,1260,28,3,0,20.0,79.01
24097,132,5,132,7,5,0,14.285714285714286,48.75
24098,2412,8,2412,30,6,2,16.666666666666668,68.44
24099,132,1,132,36,1,0,33.333333333333336,78.0
24100,144,8,144,16,7,1,12.5,64.6
24101,108,0,108,0,0,0,50.0,56.25
24102,516,63,516,181,27,36,14.285714285714286,73.81
24103,792,16,792,73,16,0,5.555555555555555,67.33
24104,42132,15,108,2832,13,2,7.142857142857143,60.55
24105,588,5,588,223,4,1,25.0,98.43
24106,10495080,887,0,35435,502,385,1.098901098901099,0.0
24107,684,58,684,78,50,8,2.0408163265306123,20.1
24108,468,2,468,144,2,0,100.0,100.0
24109,552,195,552,219,109,86,1.5151515151515151,63.71
24110,756,34,564,219,28,6,3.8461538461538463,77.7
24111,984,8,0,316,4,4,25.0,0.0
24112,134076,100,1116,3207,74,26,1.694915254237288,15.7
24113,192,2,192,66,0,2,50.0,76.2
24114,288,59,288,84,47,12,2.380952380952381,14.77
24115,888,13,888,184,12,1,7.6923076923076925,36.69
24116,1008,2,996,552,2,0,25.0,88.7
24117,33300,30,33300,636,23,7,5.555555555555555,0.39
24118,324,3,204,128,2,1,50.0,58.69
24119,10437156,2,10437156,42,1,1,50.0,99.28
24120,1644,26,1644,288,22,4,4.761904761904762,80.86
24121,2052,99,0,412,81,18,100.0,0.0
24122,10852836,8111,62292,122495,4747,3364,1.0,0.0
24123,480,0,480,0,0,0,33.333333333333336,92.53
24124,764724,63,764724,50076,46,17,6.666666666666667,34.83
24125,27624,140,372,332,68,72,3.0303030303030303,81.04
24126,41916,119,41916,3855,95,24,1.5151515151515151,5.9
24127,576,73,552,219,35,38,5.555555555555555,82.81
24128,2352,0,2352,0,0,0,50.0,62.41
24129,233004,638,0,1339,305,333,1.6129032258064515,0.0
24130,8199456,260,0,65516,133,127,3.333333333333333,0.0
24131,293352,74,293352,2316,58,16,3.125,6.79
24132,2791548,358,2791548,7900,189,169,2.0408163265306123,84.21
24133,2612664,302,2612664,18955,122,180,3.571428571428572,81.02
24134,168,0,168,0,0,0,50.0,94.51
24135,7377396,7,192,2227164,3,4,2.3255813953488373,0.0
24136,1128120,65,1128120,29438,33,32,8.333333333333334,49.4
24137,5112,6,5112,28,6,0,12.5,67.73
24138,312,3,312,24,2,1,33.333333333333336,91.79
24139,52656,27,52656,16087,25,2,5.2631578947368425,4.59
24140,612,18,612,175,18,0,5.0,83.11
24141,78480,30,1476,3059,24,6,9.090909090909092,24.23
24142,108,18,84,35,12,6,11.11111111111111,46.75
24143,23136,137,0,2911,89,48,100.0,0.0
24144,2076,0,2076,0,0,0,50.0,57.76
24145,324,11,324,2,10,1,9.090909090909092,56.13
24146,180,13,180,36,8,5,20.0,69.45
24147,159756,172,0,4896,113,59,6.666666666666667,0.0
24148,12276,98,0,2897,55,43,50.0,0.0
24149,588,138,588,176,97,41,1.408450704225352,16.49
24150,384,0,384,0,0,0,33.333333333333336,73.4
24151,276,13,276,146,13,0,6.666666666666667,77.25
24152,248088,151,0,2876,67,84,10.0,0.0
24153,50304,81,0,1461,66,15,100.0,0.0
24154,252,8,252,99,4,4,50.0,58.81
24155,8204652,183,0,56885,85,98,5.2631578947368425,4.71
24156,2694468,56,2694468,506,24,32,11.11111111111111,0.0
24157,792,168,0,87,138,30,1.0,0.0
24158,5480892,153,0,41947,72,81,4.0,0.0
24159,9348324,137,5513106,6248,68,69,4.3478260869565215,0.0
24160,489912,37,489912,28,25,12,4.761904761904762,55.55
24161,972,48,972,95,38,10,3.0303030303030303,25.66
24162,1260,274,336,152,194,80,1.0,34.05
24163,10445640,1400,0,30975,803,597,1.0,0.0
24164,8487864,94,1176,90649,59,35,2.4390243902439024,48.59
24165,48804,130,0,1573,87,43,100.0,0.0
24166,732,120,732,271,58,62,3.703703703703704,71.39
24167,1704,36,1704,403,31,5,33.333333333333336,87.81
24168,3420,58,3420,462,29,29,7.6923076923076925,69.08
24169,8295384,655,8295384,234946,354,301,3.8461538461538463,73.36
24170,888,34,888,82,28,6,4.0,63.36
24171,17952,75,17952,149,69,6,1.5151515151515151,44.86
24172,7771020,61,7062420,391741,31,30,5.882352941176471,17.0
24173,49080,64,49080,326,44,20,2.7777777777777777,42.62
24174,900684,327,0,52042,96,231,50.0,50.0
24175,9180432,361,0,1375297,156,205,1.5384615384615383,5.16
24176,456,18,456,138,16,2,5.882352941176471,63.56
24177,10852848,1264,0,1654487,721,543,1.0,0.0
24178,2208,54,1284,217,51,3,2.702702702702702,59.15
24179,3576,89,0,1718,63,26,100.0,0.0
24180,660,8,660,274,5,3,25.0,55.61
24181,38556,3,38556,156,3,0,25.0,87.97
24182,1442412,1120,345244,29495,945,175,1.0,31.65
24183,193416,9,0,115257,8,1,50.0,0.0
24184,7602588,841,0,34022,446,395,2.380952380952381,0.0
24185,2616,22,0,276,16,6,100.0,100.0
24186,8483028,1062,4482882,327954,476,586,1.020408163265306,65.83
24187,672,6,672,248,4,2,16.666666666666668,92.54
24188,10919184,14116,1258284,2905948,8599,5517,1.0,0.0
24189,7108368,41,0,173857,22,19,16.666666666666668,12.38
24190,60,0,60,0,0,0,100.0,100.0
24191,1164,55,1164,155,27,28,9.090909090909092,89.59
24192,5551032,67,0,85547,38,29,6.666666666666667,0.0
24193,5424,12,5424,412,7,5,33.333333333333336,0.0
24194,219960,7,0,33620,4,3,50.0,0.0
24195,10203972,78,5108598,322772,37,41,11.11111111111111,97.54
24196,3732,16,3732,2409,16,0,6.666666666666667,85.38
24197,7164,142,7164,3150,121,21,1.851851851851852,37.85
24198,10736520,126,7879260,87822,67,59,3.0303030303030303,79.29
24199,10880868,2930,0,257900,1636,1294,1.0,0.0
24200,1308,0,1308,0,0,0,100.0,100.0
24201,32964,28,0,3066,22,6,100.0,0.0
24202,3708,28,0,877,27,1,100.0,0.0
24203,7628784,166,7628784,5212,71,95,5.555555555555555,83.76
24204,73704,28,73704,684,22,6,4.761904761904762,65.67
24205,8887920,176,3320284,3432,122,54,1.0869565217391304,41.18
24206,13308,26,13308,13082,20,6,4.545454545454546,66.48
24207,8938452,197,0,362165,83,114,9.090909090909092,0.0
24208,300,5,300,105,3,2,33.333333333333336,96.16
24209,8797908,121,5244156,823,74,47,2.127659574468085,53.08
24210,10927512,8703,1985605,4894888,4871,3832,1.0,0.0
24211,8926716,263,7457666,102685,135,128,2.272727272727273,0.0
24212,8326800,445,0,29534,281,164,1.0,0.01
24213,540,48,540,76,28,20,5.555555555555555,0.0
24214,180,20,84,46,14,6,11.11111111111111,56.42
24215,424644,1,424644,263856,1,0,100.0,100.0
24216,8842272,603,1695180,258205,273,330,1.9230769230769231,0.0
24217,1224996,0,1224996,0,0,0,50.0,65.0
24218,312,0,312,0,0,0,33.333333333333336,7.29
24219,170376,1626,49083,10593,1268,358,1.0,0.0
24220,8546148,174,8546148,131134,57,117,2.631578947368421,76.33
24221,360,9,0,133,5,4,33.333333333333336,0.0
24222,1368,5,1368,350,3,2,33.333333333333336,79.13
24223,2728440,308,2728440,276896,168,140,2.272727272727273,0.0
24224,21012,33,21012,1203,29,4,3.333333333333333,57.67
24225,6950808,199,0,39242,121,78,1.6666666666666667,0.0
24226,146376,32,0,11721,24,8,50.0,49.99
24227,10591464,4000,0,279351,2307,1693,1.0,0.0
24228,1284,26,432,228,15,11,14.285714285714286,54.29
24229,40776,26,0,5151,24,2,100.0,0.0
24230,25776,127,0,1231,86,41,100.0,0.0
24231,9575616,661,0,89149,347,314,2.2222222222222223,2.05
24232,1044,1,1044,960,1,0,25.0,24.92
24233,5434452,56,94872,101639,48,8,2.272727272727273,14.36
24234,238968,19,238968,25062,15,4,10.0,54.08
24235,10764,20,10764,2450,15,5,12.5,71.93
24236,2004,23,2004,464,22,1,5.0,0.0
24237,10926636,3812,4095330,553669,2078,1734,1.0,0.0
24238,4824216,40,0,129010,21,19,25.0,0.0
24239,778416,1477,445020,228316,1149,328,1.0,0.0
24240,576,1,576,396,1,0,11.11111111111111,62.0
24241,10934352,1595,0,467728,701,894,1.0,0.0
24242,9582372,252,5643276,57830,110,142,3.8461538461538463,88.94
24243,550704,889,276534,80615,854,35,3.125,13.26
24244,58572,41,0,6668,31,10,25.0,0.0
24245,339624,61,339540,57882,47,14,3.125,52.83
24246,2268,4,2268,597,4,0,50.0,97.95
24247,156504,253,0,8404,154,99,33.333333333333336,0.0
24248,67212,38,0,4762,31,7,100.0,0.0
24249,5844,66,5844,612,53,13,2.127659574468085,34.52
24250,7946280,1144,6690444,568793,482,662,1.0,0.0
24251,64596,25,64596,3709,24,1,5.555555555555555,72.73
24252,15396,120,0,11353,70,50,50.0,0.0
24253,32316,63,0,6734,50,13,33.333333333333336,0.0
24254,54468,18,54468,538,16,2,7.6923076923076925,3.59
24255,4752,23,4752,204,18,5,7.142857142857143,29.82
24256,672,11,672,238,9,2,11.11111111111111,81.74
24257,10380,9,10380,576,6,3,50.0,99.76
24258,360,35,300,61,26,9,4.0,0.0
24259,10861980,1160,0,277294,640,520,1.2820512820512822,0.0
24260,7637100,177,0,743033,104,73,4.3478260869565215,0.0
24261,528,24,528,271,16,8,7.142857142857143,80.42
24262,182448,1,182448,0,1,0,33.333333333333336,91.94
24263,1812,13,1812,638,8,5,25.0,86.23
24264,6120,230,6120,855,158,72,1.0,12.13
24265,804,12,804,345,6,6,33.333333333333336,96.84
24266,4345008,21,0,223500,12,9,9.090909090909092,0.0
24267,3783060,2,3783060,42,1,1,33.333333333333336,78.49
24268,7884,14,7884,877,13,1,9.090909090909092,44.41
24269,295884,74,295884,23610,63,11,1.6129032258064515,28.27
24270,8640,1,8640,504,1,0,50.0,53.34
24271,1800,5,1800,962,2,3,50.0,90.0
24272,96,20,96,31,14,6,10.0,51.33
24273,6225624,53,0,138993,38,15,33.333333333333336,0.0
24274,17784,36,0,3811,29,7,100.0,0.0
24275,8880,3,8880,180,3,0,20.0,74.26
24276,852,8,852,312,5,3,100.0,100.0
24277,876,151,0,152,125,26,1.0,0.0
24278,82704,22,82704,713,19,3,6.25,74.67
24279,10732872,294,0,365810,153,141,2.702702702702702,4.73
24280,540,15,540,239,7,8,20.0,94.92
24281,120,22,120,8,19,3,5.555555555555555,45.21
24282,3120,21,3120,843,19,2,8.333333333333334,50.77
24283,144,8,144,39,5,3,25.0,55.1
24284,2232,42,0,266,23,19,100.0,0.0
24285,101664,98,0,6696,77,21,14.285714285714286,0.0
24286,17928,9,17928,2438,8,1,16.666666666666668,66.25
24287,8530200,23,36240,405493,19,4,4.761904761904762,46.86
24288,132,31,132,35,23,8,4.761904761904762,47.02
24289,13188,15,0,1626,12,3,100.0,100.0
24290,8940,23,8940,1279,20,3,6.666666666666667,74.89
24291,1344,19,1344,234,18,1,5.555555555555555,0.0
24292,90492,22,0,21043,18,4,100.0,0.0
24293,240,43,240,32,33,10,3.333333333333333,39.58
24294,10963848,6906,5462532,6602422,3968,2938,1.0,0.0
24295,84204,15,84204,504,14,1,9.090909090909092,61.63
24296,17988,18,17988,906,18,0,5.882352941176471,78.24
24297,732,11,732,171,4,7,50.0,90.89
24298,10745640,811,7934784,4194884,499,312,1.0,0.0
24299,47712,35,47712,6561,26,9,5.0,70.51
24300,20520,15,20520,998,13,2,11.11111111111111,82.2
24301,4572,21,4572,1140,19,2,7.142857142857143,1.8
24302,192,0,192,0,0,0,50.0,59.29
24303,600,12,600,272,8,4,16.666666666666668,76.19
24304,7398192,185,0,42786,91,94,3.333333333333333,5.0
24305,216,23,216,76,23,0,4.0,78.25
24306,420,32,420,118,24,8,4.545454545454546,73.42
24307,2172,20,2172,739,18,2,7.142857142857143,0.52
24308,10796004,703,0,87521,414,289,1.1363636363636365,0.0
24309,1452,38,1452,84,26,12,4.545454545454546,67.34
24310,6797004,99,0,138990,48,51,9.090909090909092,0.0
24311,51228,61,4308,2349,32,29,33.333333333333336,23.9
24312,1776,21,1776,28,21,0,4.3478260869565215,58.26
24313,254616,144,254616,28656,78,66,4.0,33.8
24314,780,15,780,454,14,1,6.25,63.17
24315,3764196,88,0,100184,56,32,7.142857142857143,0.0
24316,444,4,444,24,2,2,50.0,60.03
24317,3797244,21,3797244,98382,10,11,16.666666666666668,93.6
24318,588,2,588,18,1,1,50.0,58.66
24319,22872,46,0,3915,39,7,50.0,0.0
24320,504,10,504,250,6,4,16.666666666666668,93.63
24321,10768056,773,0,984695,429,344,1.5384615384615383,0.0
24322,12828,45,0,2486,36,9,100.0,0.0
24323,672,6,420,258,3,3,33.333333333333336,0.0
24324,10320552,643,0,76161,338,305,1.8867924528301887,6.14
24325,1044,4,588,435,3,1,25.0,0.0
24326,6636,18,6636,832,16,2,8.333333333333334,39.84
24327,1428,3,1428,92,2,1,25.0,98.69
24328,7286652,290,1142016,523414,179,111,2.857142857142857,0.0
24329,840,0,840,0,0,0,50.0,60.84
24330,4152,12,0,736,10,2,100.0,100.0
24331,2244,19,2244,135,7,12,33.333333333333336,85.08
24332,696,37,696,81,29,8,3.703703703703704,73.9
24333,202716,6,0,201748,6,0,16.666666666666668,0.0
24334,1932,0,1932,0,0,0,100.0,100.0
24335,2412,34,0,837,29,5,50.0,87.88
24336,120,47,120,20,29,18,4.545454545454546,55.33
24337,156,12,144,72,6,6,33.333333333333336,71.2
24338,900,1,900,864,1,0,33.333333333333336,56.63
24339,324,66,240,80,43,23,3.4482758620689653,33.72
24340,10953660,4687,0,923657,2586,2101,1.0,0.0
24341,10522692,743,0,179771,324,419,2.0,0.0
24342,240,0,240,0,0,0,50.0,60.84
24343,10794840,242,0,74297,140,102,5.882352941176471,0.0
24344,144,18,144,52,12,6,9.090909090909092,63.77
24345,756,60,756,46,34,26,4.761904761904762,45.82
24346,156,5,156,50,3,2,33.333333333333336,66.17
24347,96,50,96,30,38,12,2.9411764705882355,33.22
24348,5088,24,0,636,21,3,50.0,87.89
24349,1416,209,708,232,131,78,1.351351351351351,0.0
24350,2376,10,2376,168,6,4,16.666666666666668,93.99
24351,204,22,168,67,13,9,14.285714285714286,58.28
24352,1272,22,1272,0,22,0,4.166666666666667,57.58
24353,0,0,0,0,0,0,50.0,0.0
24354,2544,1,2544,120,1,0,100.0,100.0
24355,240,6,240,28,4,2,25.0,67.91
24356,1296,3,1296,12,3,0,50.0,62.7
24357,10383336,5453,0,75337,3059,2394,1.0,0.0
24358,1824,11,1824,18,7,4,20.0,69.57
24359,21792,2,21792,564,2,0,50.0,95.25
24360,3636,180,0,777,133,47,100.0,0.0
24361,168,19,168,89,7,12,33.333333333333336,68.52
24362,3809940,115,3809940,4661,57,58,7.142857142857143,89.8
24363,876,96,876,261,44,52,5.555555555555555,78.94
24364,384,47,276,112,36,11,3.225806451612903,0.0
24365,444,2,444,138,1,1,100.0,100.0
24366,1536,63,1536,351,49,14,2.272727272727273,38.73
24367,2364,21,2364,1129,16,5,25.0,95.82
24368,10149768,1461,0,246622,822,639,1.3888888888888888,0.0
24369,924,91,924,185,76,15,1.5384615384615383,0.0
24370,216,9,216,116,5,4,33.333333333333336,70.19
24371,3876,9,3876,1068,6,3,100.0,100.0
24372,10818744,1521,0,49916,861,660,1.1494252873563218,0.0
24373,10826256,1327,0,39971,677,650,1.4492753623188406,0.0
24374,4248,84,0,562,65,19,100.0,0.0
24375,10717560,268,7997196,99705,96,172,3.0303030303030303,69.69
24376,77184,40,77184,25136,36,4,3.4482758620689653,5.49
24377,19368,55,0,3656,47,8,100.0,0.0
24378,612,10,612,80,10,0,8.333333333333334,63.65
24379,10752276,418,0,76741,228,190,2.857142857142857,1.5
24380,385752,110,385752,11952,88,22,1.2195121951219512,22.68
24381,1392,3,1392,328,2,1,33.333333333333336,71.51
24382,46896,92,0,1014,68,24,100.0,0.0
24383,4164,46,4164,22,44,2,2.2222222222222223,60.69
24384,564,35,564,175,23,12,5.2631578947368425,86.34
24385,9390360,363,0,72274,192,171,3.125,1.5
24386,352824,17,352824,51402,11,6,11.11111111111111,97.46
24387,612,7,612,248,6,1,50.0,51.84
24388,47952,211,0,2068,114,97,100.0,0.0
24389,852,0,852,0,0,0,100.0,100.0
24390,39084,197,0,3183,110,87,50.0,0.0
24391,2208,3,2208,392,3,0,20.0,83.49
24392,336,45,144,64,25,20,6.666666666666667,52.24
24393,79188,8,79188,6217,7,1,14.285714285714286,0.49
24394,10844964,9808,1702224,2147660,4575,5233,1.0,0.0
24395,140352,10,140352,1015,8,2,12.5,81.23
24396,540,1,540,360,1,0,33.333333333333336,94.85
24397,20484,23,14820,3427,23,0,6.25,15.9
24398,52452,250,0,2213,161,89,100.0,0.0
24399,324,2,324,120,2,0,25.0,56.25
24400,1332144,483,0,7165,232,251,1.1904761904761905,0.29
24401,180,6,180,0,6,0,12.5,71.24
24402,600,11,0,233,9,2,100.0,0.0
24403,2436,8,2436,955,8,0,10.0,11.07
24404,299988,1,299988,336,1,0,50.0,94.43
24405,1212,214,0,120,190,24,1.0,0.0
24406,4008,98,0,1089,67,31,50.0,0.0
24407,1092,92,1092,766,52,40,2.9411764705882355,52.02
24408,2244,8,2244,265,8,0,12.5,72.93
24409,132,0,132,0,0,0,50.0,65.61
24410,504,70,432,117,54,16,2.1739130434782608,64.17
24411,8124132,168,0,245759,96,72,1.0,11.84
24412,58236,138,0,2567,98,40,50.0,0.0
24413,311952,34,0,11727,25,9,20.0,0.0
24414,1536684,759,277086,33436,646,113,1.0,15.28
24415,7745472,175,7745472,10576,84,91,4.3478260869565215,74.44
24416,2389032,153,38520,52269,118,35,1.4705882352941178,2.3
24417,1349412,32,4134,44073,32,0,3.333333333333333,12.24
24418,168,17,168,79,12,5,11.11111111111111,50.31
24419,59208,197,0,3338,124,73,100.0,0.0
24420,70404,29,70404,309,15,14,33.333333333333336,64.79
24421,10008,9,384,2356,5,4,5.0,92.51
24422,3648,4,3648,420,4,0,11.11111111111111,94.56
24423,2472,31,0,657,27,4,50.0,99.9
24424,7068,41,7068,374,41,0,2.4390243902439024,42.09
24425,8640,0,8640,0,0,0,50.0,59.29
24426,1656,6,1656,94,4,2,33.333333333333336,99.63
24427,1332,23,300,102,19,4,5.555555555555555,36.27
24428,42360,54,42360,1377,31,23,14.285714285714286,0.0
24429,408,10,408,61,10,0,14.285714285714286,64.3
24430,10838916,700,0,115179,357,343,1.1363636363636365,0.0
24431,8309952,299,0,90681,173,126,3.125,0.0
24432,9012816,268,0,101134,154,114,2.857142857142857,0.0
24433,288,3,288,56,2,1,33.333333333333336,57.23
24434,10461480,796,10259199,762461,294,502,2.1739130434782608,0.0
24435,5664276,313,516,36899,220,93,1.0,57.47
24436,10835436,181,0,117836,88,93,5.0,4.74
24437,71232,13,71232,6054,11,2,14.285714285714286,63.07
24438,336,21,0,62,12,9,50.0,0.0
24439,9917004,349,0,393155,185,164,3.0303030303030303,0.0
24440,72,0,72,0,0,0,100.0,0.0
24441,8206392,37,8206392,14883,17,20,11.11111111111111,89.34
24442,448692,344,0,3923,181,163,3.225806451612903,0.0
24443,9536856,243,9536856,55437,136,107,2.631578947368421,85.22
24444,227412,34,227412,3805,32,2,3.0303030303030303,32.15
24445,13788,24,12084,1548,22,2,5.0,69.52
24446,9870564,827,0,34857,504,323,1.0,0.0
24447,208584,1126,57061,12665,864,262,1.0,0.0
24448,2220,4,2220,885,3,1,25.0,74.97
24449,1872,0,1872,0,0,0,50.0,66.61
24450,504,11,504,79,11,0,8.333333333333334,0.0
24451,172872,0,172872,0,0,0,50.0,65.8
24452,28032,49,0,696,43,6,100.0,0.0
24453,168,58,168,62,36,22,3.703703703703704,48.07
24454,10122504,196,0,309756,90,106,6.666666666666667,0.0
24455,8320440,474,0,66206,260,214,2.5641025641025643,0.0
24456,439080,225,439080,897,168,57,1.0,20.12
24457,10764180,6980,5527008,185722,4459,2521,1.0,0.0
24458,605424,87,828,19204,56,31,3.8461538461538463,0.0
24459,63456,42,63456,2301,41,1,5.882352941176471,57.41
24460,816,5,816,655,3,2,50.0,95.68
24461,59640,12,59640,622,11,1,8.333333333333334,40.42
24462,2832,81,0,1059,51,30,50.0,0.0
24463,2670372,337,1335438,12479,223,114,1.098901098901099,13.39
24464,49932,5,49932,14827,3,2,33.333333333333336,72.22
24465,54336,20,54336,754,17,3,7.6923076923076925,34.1
24466,29844,85,29844,2246,68,17,1.5873015873015872,32.18
24467,2640240,933,2638122,271632,511,422,1.0,3.17
24468,132,0,132,0,0,0,50.0,59.29
24469,38496,42,0,4582,37,5,100.0,0.0
24470,172068,147,0,5805,71,76,9.090909090909092,0.0
24471,9561240,348,0,61472,181,167,2.7777777777777777,3.82
24472,37392,13,37392,3092,12,1,10.0,67.29
24473,3456,16,1008,480,11,5,16.666666666666668,87.37
24474,1064772,202,0,7059,94,108,4.3478260869565215,0.0
24475,1428,33,1428,299,19,14,7.142857142857143,1.59
24476,1176,26,276,193,18,8,7.6923076923076925,38.72
24477,55152,32,0,4416,19,13,12.5,0.0
24478,10568532,125,10568532,143073,53,72,5.2631578947368425,77.57
24479,7721244,249,0,62138,131,118,7.142857142857143,0.0
24480,7897428,315,0,28835,161,154,3.333333333333333,9.82
24481,303972,13,1992,23894,9,4,14.285714285714286,50.86
24482,228,2,228,0,2,0,25.0,60.8
24483,516,101,0,60,82,19,1.3333333333333333,0.0
24484,9515616,642,0,37353,350,292,1.2987012987012987,0.0
24485,348,0,348,0,0,0,50.0,64.0
24486,7722324,118,0,134261,50,68,7.142857142857143,3.57
24487,3792,174,0,365,99,75,100.0,0.0
24488,3264,9,3264,2568,7,2,12.5,0.0
24489,6804576,10,0,683529,6,4,14.285714285714286,2.1
24490,4932,13,0,798,11,2,100.0,100.0
24491,6456,13,6456,684,12,1,8.333333333333334,0.0
24492,73788,12,73788,660,12,0,9.090909090909092,79.98
24493,55992,37,55992,204,34,3,3.125,50.71
24494,10492104,423,0,36727,224,199,2.5,0.0
24495,11038728,712,0,5574069,445,267,1.0,0.0
24496,2556,13,2556,220,12,1,8.333333333333334,60.12
24497,23796,3,23796,328,3,0,25.0,44.29
24498,2628,17,2628,955,16,1,8.333333333333334,47.25
24499,6226200,29,6226200,204362,19,10,10.0,93.75
24500,19272,16,11328,2997,16,0,5.555555555555555,4.96
24501,6496416,18,6496416,15621,8,10,14.285714285714286,0.0
24502,5880,47,5880,1590,35,12,4.0,27.14
24503,55548,10,55548,1168,8,2,20.0,95.95
24504,6600,0,6600,0,0,0,11.11111111111111,20.0
24505,6768,1,6768,240,1,0,33.333333333333336,88.67
24506,2772,18,2772,827,16,2,9.090909090909092,52.39
24507,11844,56,0,2034,46,10,100.0,0.0
24508,7015788,82,39120,86250,65,17,1.851851851851852,66.53
24509,16584,27,16584,965,23,4,5.555555555555555,73.71
24510,252,15,252,110,8,7,33.333333333333336,47.63
24511,252852,79,0,4942,67,12,100.0,0.0
24512,10939380,470,5291700,4438180,266,204,1.7241379310344829,0.05
24513,900204,59,0,24180,41,18,4.761904761904762,0.0
24514,8568,62,0,2523,50,12,100.0,0.0
24515,564,3,564,200,3,0,25.0,23.66
24516,8586192,233,5171064,71110,93,140,3.703703703703704,79.03
24517,5304,18,5304,702,16,2,8.333333333333334,0.11
24518,20136,22,20136,801,21,1,5.555555555555555,76.96
24519,6816,5,6816,708,3,2,25.0,96.44
24520,4716,108,4140,1939,74,34,5.555555555555555,0.0
24521,3363468,173,0,34268,84,89,7.142857142857143,1.95
24522,5550360,11,4047162,133274,3,8,33.333333333333336,96.74
24523,82380,14,82380,804,11,3,11.11111111111111,25.22
24524,4332,16,0,548,13,3,100.0,100.0
24525,84,15,84,11,13,2,7.6923076923076925,41.99
24526,5779224,9784,620964,2175998,5573,4211,1.0,1.02
24527,516,18,516,84,16,2,7.142857142857143,37.77
24528,25368,19,25368,690,19,0,5.0,81.3
24529,91032,158,0,2062,77,81,4.761904761904762,4.75
24530,10326144,5756,549360,811926,3107,2649,1.0,0.0
24531,10101768,369,3386508,80866,229,140,2.4390243902439024,72.53
24532,888,6,888,340,5,1,33.333333333333336,93.37
24533,7245624,469,0,40142,239,230,4.0,10.06
24534,2520,19,2520,231,18,1,5.882352941176471,0.0
24535,7073316,6,7073316,620,4,2,16.666666666666668,69.92
24536,120,6,108,54,3,3,33.333333333333336,69.65
24537,76824,2,76824,54,2,0,33.333333333333336,99.8
24538,321672,67,0,6130,59,8,50.0,0.0
24539,1008,3,1008,808,3,0,33.333333333333336,71.84
24540,864,16,864,684,16,0,5.555555555555555,60.77
24541,5780784,241,0,230173,116,125,4.166666666666667,0.0
24542,60384,40,432,1547,32,8,3.4482758620689653,40.77
24543,384,37,384,221,21,16,6.666666666666667,70.88
24544,318120,54,0,8202,45,9,50.0,0.0
24545,1368,0,1368,0,0,0,50.0,59.29
24546,10550556,2226,0,251275,1214,1012,1.0,0.0
24547,9680448,1133,0,111788,607,526,1.2345679012345678,6.74
24548,9670068,176,0,108969,77,99,7.142857142857143,0.0
24549,120,19,120,12,17,2,5.882352941176471,46.63
24550,2376,3,2376,96,3,0,20.0,71.01
24551,192,29,192,110,19,10,6.25,88.99
24552,22980,18,22980,928,16,2,7.6923076923076925,76.84
24553,2388,57,2388,110,38,19,3.333333333333333,64.71
24554,1596,36,1596,36,26,10,5.0,41.67
24555,5916,31,5916,348,29,2,5.2631578947368425,0.0
24556,10734444,483,0,1040148,253,230,2.857142857142857,4.35
24557,0,0,0,0,0,0,50.0,0.0
24558,1176,2,1128,948,1,1,100.0,0.0
24559,2064,31,0,804,27,4,3.8461538461538463,0.0
24560,4140,14,4140,36,13,1,7.142857142857143,42.29
24561,10918536,577,0,2363772,303,274,1.851851851851852,0.0
24562,9060,3,9060,380,3,0,33.333333333333336,99.86
24563,2232,12,2232,1752,10,2,11.11111111111111,95.94
24564,1692,80,1692,596,56,24,3.333333333333333,0.0
24565,144,33,72,37,21,12,9.090909090909092,51.34
24566,5028,4,5028,33,2,2,50.0,58.04
24567,5268,10,0,1038,8,2,100.0,100.0
24568,2244,16,0,659,12,4,100.0,100.0
24569,4044,51,0,464,41,10,2.631578947368421,0.02
24570,168,38,168,44,32,6,3.225806451612903,33.5
24571,10104288,326,0,1088025,167,159,2.5641025641025643,0.0
24572,6267216,1886,0,121988,1059,827,1.351351351351351,0.0
24573,120,24,120,33,20,4,5.555555555555555,46.14
24574,273624,195,273624,3502,117,78,2.0408163265306123,78.94
24575,2376,37,0,910,32,5,50.0,0.0
24576,684,2,654,246,2,0,33.333333333333336,96.98
24577,912,4,912,720,4,0,16.666666666666668,96.0
24578,852,0,852,0,0,0,100.0,100.0
24579,1308,22,0,354,17,5,100.0,100.0
24580,120,0,120,0,0,0,100.0,100.0
24581,18612,17,18612,619,15,2,9.090909090909092,40.56
24582,10398360,465,0,50124,237,228,1.851851851851852,3.0
24583,10766700,1619,1233852,809026,718,901,1.0,0.0
24584,14592,4,14592,6060,3,1,33.333333333333336,67.84
24585,2892564,42,2892564,5356,16,26,14.285714285714286,47.86
24586,10775100,3,34896,10775048,1,2,50.0,0.01
24587,21072,176,0,1095,127,49,100.0,0.0
24588,397560,0,397560,0,0,0,50.0,80.0
24589,29076,12,29076,494,10,2,14.285714285714286,7.41
24590,4560,13,0,690,11,2,50.0,87.89
24591,744,13,744,285,9,4,20.0,97.25
24592,204,8,192,93,6,2,14.285714285714286,70.69
24593,408,5,408,256,3,2,50.0,91.58
24594,398784,32,398784,21,26,6,4.0,40.32
24595,83388,51,83388,149,37,14,3.703703703703704,56.39
24596,336,3,336,152,2,1,50.0,95.9
24597,600,98,600,249,45,53,7.142857142857143,87.14
24598,96,13,96,25,10,3,10.0,56.02
24599,6804,54,6804,86,32,22,4.545454545454546,37.33
24600,372,3,372,0,2,1,50.0,99.92
24601,5809992,102,0,57445,41,61,14.285714285714286,0.0
24602,8508,20,8508,436,17,3,8.333333333333334,68.9
24603,27696,97,0,1014,63,34,33.333333333333336,0.0
24604,38964,8,38964,5232,5,3,25.0,55.94
24605,396,46,72,29,40,6,2.702702702702702,27.5
24606,264,15,264,49,12,3,9.090909090909092,58.86
24607,353616,242,0,3603,120,122,3.225806451612903,0.0
24608,2280,125,0,465,96,29,100.0,0.0
24609,324,5,324,38,3,2,25.0,0.87
24610,2388,81,2388,519,57,24,2.5641025641025643,66.44
24611,10526364,255,0,142687,130,125,3.8461538461538463,0.0
24612,7263384,128,0,61992,69,59,5.0,0.0
24613,120324,166,0,3510,99,67,25.0,0.0
24614,17400,54,0,2322,45,9,100.0,0.0
24615,7962300,589,7962156,120770,306,283,1.4285714285714286,0.0
24616,936,25,936,595,23,2,4.0,54.27
24617,1098900,79,1098900,605734,79,0,1.4285714285714286,42.01
24618,3168,13,3168,1000,3,10,5.555555555555555,54.23
24619,32688,4,32688,225,3,1,33.333333333333336,50.95
24620,780,23,0,429,13,10,25.0,0.0
24621,120,4,120,45,2,2,50.0,78.88
24622,7668,15,7668,841,13,2,8.333333333333334,7.37
24623,42864,4,42864,735,4,0,16.666666666666668,66.78
24624,432,96,432,39,92,4,1.9230769230769231,56.7
24625,768,42,768,78,28,14,4.166666666666667,0.0
24626,1440,25,1440,176,22,3,5.882352941176471,0.0
24627,2167464,443,0,13737,271,172,1.7543859649122806,0.0
24628,619188,430,242004,85536,236,194,1.851851851851852,71.02
24629,46440,153,0,10163,99,54,50.0,0.0
24630,96,11,96,8,9,2,10.0,76.0
24631,1644,36,1644,403,34,2,5.0,35.95
24632,83004,28,2460,3441,17,11,14.285714285714286,88.64
24633,576,0,576,0,0,0,100.0,100.0
24634,30384,773,29118,2239,334,439,2.0408163265306123,0.0
24635,8262072,224,5710764,83044,128,96,6.666666666666667,59.38
24636,4836,107,0,997,68,39,100.0,0.0
24637,5652996,249,0,28766,124,125,2.5,0.0
24638,144,8,0,72,6,2,100.0,0.0
24639,38988,93,0,855,60,33,50.0,0.0
24640,636,72,0,90,68,4,1.4492753623188406,0.0
24641,1584,38,1584,1004,24,14,5.555555555555555,93.89
24642,12060,7,12060,617,6,1,20.0,94.32
24643,11041080,3871,0,558365,2212,1659,1.0,0.0
24644,9084,3,9084,40,2,1,33.333333333333336,77.72
24645,129708,5,129708,9760,4,1,20.0,95.65
24646,41676,110,0,938,66,44,50.0,0.0
24647,2807424,1356,752412,26905,1200,156,1.0,18.54
24648,540,5,540,141,3,2,33.333333333333336,79.01
24649,11030796,1087,5070331,5078188,484,603,1.0,0.0
24650,8940,13,8940,27,7,6,33.333333333333336,70.42
24651,4488,82,0,446,56,26,100.0,0.0
24652,900,153,0,156,103,50,1.1904761904761905,0.0
24653,43872,89,0,1997,65,24,100.0,0.0
24654,11042208,1205,0,422147,650,555,1.6666666666666667,0.0
24655,72,1,72,0,1,0,33.333333333333336,78.52
24656,55464,182,0,2995,113,69,100.0,0.0
24657,66276,27,0,2731,15,12,25.0,0.12
24658,7692912,1348,0,35931,696,652,1.0,0.0
24659,7889844,770,4871424,270903,422,348,1.5151515151515151,1.61
24660,336,11,0,117,7,4,100.0,100.0
24661,624,26,0,93,20,6,50.0,0.0
24662,624,25,0,108,19,6,50.0,0.0
24663,11079444,1424,1244928,4111261,839,585,1.0,9.69
24664,18156,8,18156,99,4,4,50.0,63.5
24665,11640,96,0,714,84,12,100.0,0.0
24666,68928,6,0,11986,4,2,16.666666666666668,0.07
24667,2172,9,2172,1445,9,0,9.090909090909092,74.59
24668,132,0,132,0,0,0,50.0,72.03
24669,4560,28,0,585,14,14,50.0,0.0
24670,47652,110,0,1252,73,37,33.333333333333336,0.0
24671,708,268,708,176,179,89,1.0,16.44
24672,936,28,936,65,24,4,4.0,11.86
24673,888,10,888,500,7,3,33.333333333333336,89.12
24674,505260,138,0,12968,84,54,100.0,100.0
24675,3900,9,3900,388,6,3,25.0,95.13
24676,7124160,151,4860988,57525,79,72,5.0,24.59
24677,540,5,0,540,5,0,14.285714285714286,1.19
24678,15192,25,15192,2073,22,3,5.555555555555555,5.57
24679,2564592,193,2564592,4062,86,107,6.666666666666667,84.61
24680,8647248,670,0,165647,260,410,2.083333333333333,2.96
24681,8412,134,0,3594,86,48,50.0,0.0
24682,6576,130,0,663,85,45,100.0,0.0
24683,10860,2,10860,294,1,1,100.0,100.0
24684,5628,2,5628,96,1,1,50.0,59.88
24685,506304,311,506304,172,232,79,1.0,13.32
24686,528,4,0,366,4,0,33.333333333333336,0.0
24687,312,10,96,74,8,2,12.5,59.65
24688,1404,50,1404,1047,28,22,14.285714285714286,92.71
24689,10368,6,10368,192,6,0,14.285714285714286,88.42
24690,648,236,648,108,159,77,1.0,14.61
24691,96,5,96,33,2,3,100.0,100.0
24692,144,15,144,47,13,2,7.142857142857143,65.18
24693,11007780,5190,0,2790002,2985,2205,1.0,0.0
24694,3310428,238,0,20569,132,106,1.7241379310344829,2.5
24695,624,0,624,0,0,0,50.0,81.0
24696,252,37,252,123,21,16,6.666666666666667,0.0
24697,6257100,208,0,588000,96,112,2.5,0.0
24698,588,11,588,240,6,5,33.333333333333336,79.7
24699,66672,9,66672,473,9,0,11.11111111111111,47.13
24700,72,22,72,33,17,5,7.6923076923076925,56.89
24701,10248420,37,30864,289467,28,9,5.0,0.0
24702,3924,0,3924,0,0,0,50.0,60.84
24703,1296,33,276,301,19,14,7.142857142857143,93.76
24704,540,51,168,84,49,2,1.96078431372549,40.43
24705,409944,17,409944,9116,10,7,25.0,0.0
24706,912,14,912,876,14,0,6.25,77.23
24707,900,146,900,293,84,62,1.851851851851852,42.95
24708,180,0,180,0,0,0,50.0,64.0
24709,3699960,95,3699960,1931569,29,66,1.0,0.0
24710,204,17,204,72,11,6,14.285714285714286,77.83
24711,2076,3,2076,60,2,1,33.333333333333336,91.11
24712,519216,186,0,4004,94,92,5.0,0.0
24713,69276,9,216,7760,6,3,16.666666666666668,67.88
24714,10947768,249,0,202582,120,129,1.9230769230769231,0.0
24715,3360,18,3360,777,16,2,6.666666666666667,0.0
24716,312,20,312,24,17,3,6.25,53.02
24717,8395068,268,0,34643,133,135,3.8461538461538463,9.93
24718,6695676,861,0,53552,485,376,1.25,0.0
24719,306456,163,128970,5337,104,59,2.631578947368421,66.99
24720,3144,50,2436,258,39,11,3.225806451612903,30.21
24721,240,55,240,79,30,25,7.142857142857143,58.52
24722,10870044,85,2686464,331335,46,39,5.2631578947368425,88.81
24723,1632,12,1632,859,7,5,16.666666666666668,71.14
24724,228,32,228,115,23,9,7.142857142857143,46.85
24725,2868,57,2868,1934,42,15,4.166666666666667,0.0
24726,10838928,60,2925336,362033,30,30,33.333333333333336,79.04
24727,8398716,333,0,52505,175,158,3.225806451612903,4.35
24728,348,12,0,61,6,6,50.0,0.0
24729,97956,16,0,6567,10,6,14.285714285714286,3.0
24730,756,4,756,60,4,0,20.0,92.55
24731,4284,70,4284,291,50,20,2.4390243902439024,18.62
24732,11105244,20983,1820124,756559,11767,9216,1.0,0.0
24733,264,8,264,90,7,1,14.285714285714286,97.17
24734,936,2,936,444,1,1,100.0,100.0
24735,10922436,114,0,96230,55,59,8.333333333333334,0.0
24736,420,22,420,59,12,10,11.11111111111111,61.38
24737,216,43,216,70,25,18,8.333333333333334,67.91
24738,216,9,192,154,8,1,12.5,95.15
24739,1716,43,1716,691,35,8,3.703703703703704,0.0
24740,15852,13,15852,204,12,1,8.333333333333334,0.71
24741,11007912,8247,756672,2944570,4957,3290,1.0,0.0
24742,8852772,139,869904,232901,81,58,50.0,98.85
24743,58308,0,58308,0,0,0,50.0,75.51
24744,96,0,96,0,0,0,50.0,64.0
24745,264,4,0,84,2,2,100.0,100.0
24746,252,46,252,51,36,10,3.0303030303030303,34.13
24747,336,0,336,0,0,0,50.0,64.0
24748,1164,15,1164,20,13,2,7.6923076923076925,53.28
24749,11108904,6205,870864,4543790,3419,2786,1.0,0.0
24750,288,11,288,109,6,5,33.333333333333336,70.96
24751,528,6,528,100,6,0,14.285714285714286,93.31
24752,48,1,48,0,1,0,33.333333333333336,70.95
24753,252,10,252,66,6,4,25.0,58.89
24754,11112852,24751,1041228,1014978,14215,10536,1.0,0.0
24755,143268,5,103458,31420,5,0,100.0,100.0
24756,612,65,456,88,64,1,1.5384615384615383,13.64
24757,16956,116,0,772,80,36,100.0,0.0
24758,96,1,96,0,1,0,50.0,88.2
24759,228,0,228,0,0,0,50.0,64.0
24760,84,5,84,26,3,2,50.0,99.01
24761,26904,5,26904,10778,3,2,25.0,97.25
24762,96,24,96,27,17,7,8.333333333333334,54.07
24763,6010152,930,2145564,757279,655,275,1.0,0.0
24764,2321184,271,0,10255,143,128,3.125,0.0
24765,468,41,468,76,25,16,10.0,62.07
24766,1740,25,0,632,22,3,5.0,0.0
24767,7435320,897,0,71864,507,390,1.694915254237288,0.0
24768,651456,108,0,11947,52,56,14.285714285714286,0.0
24769,22872,78,0,765,56,22,50.0,0.0
24770,8410560,248,0,35207,122,126,4.0,12.17
24771,6971328,422,0,18736,226,196,1.818181818181818,4.85
24772,4488,19,0,334,10,9,33.333333333333336,0.0
24773,780,108,0,278,99,9,1.0309278350515465,0.0
24774,2856,30,2856,287,18,12,7.142857142857143,68.72
24775,20400,22,20400,2233,20,2,5.882352941176471,5.88
24776,54588,336,0,627,165,171,3.8461538461538463,0.0
24777,8451216,1964,0,57968,1113,851,1.0,0.0
24778,24336,77,0,654,56,21,100.0,0.0
24779,540,4,540,195,3,1,25.0,63.43
24780,180,19,180,49,17,2,5.882352941176471,46.64
24781,9803424,532,0,130719,294,238,1.7241379310344829,0.0
24782,209556,22,23364,10461,20,2,5.2631578947368425,77.08
24783,8450928,518,0,119902,302,216,1.1111111111111112,2.09
24784,4788,27,4788,954,24,3,5.2631578947368425,0.0
24785,5784,20,0,567,18,2,6.25,0.0
24786,420,8,420,148,4,4,16.666666666666668,14.74
24787,384,52,384,124,41,11,2.702702702702702,31.85
24788,2646408,88,2646144,81739,35,53,12.5,0.0
24789,1260,17,1260,96,15,2,7.6923076923076925,52.12
24790,71580,31,0,3894,26,5,100.0,0.0
24791,1044,2,1044,564,2,0,25.0,79.04
24792,10511412,518,0,1041776,263,255,2.857142857142857,3.7
24793,54696,18,54696,654,15,3,8.333333333333334,34.04
24794,1380,26,0,358,20,6,50.0,50.0
24795,104352,120,104352,1074,88,32,1.6666666666666667,36.53
24796,876,11,876,304,7,4,20.0,57.21
24797,8506356,205,8506356,59476,103,102,5.0,83.89
24798,176100,102,0,16103,51,51,10.0,1.0
24799,2928,3,2928,32,3,0,25.0,87.78
24800,10495800,567,0,250656,305,262,2.0408163265306123,3.66
24801,5124,49,3864,2744,35,14,5.2631578947368425,0.0
24802,5016,4,5016,1242,3,1,25.0,99.42
24803,168,2,168,78,1,1,50.0,84.53
24804,216,4,216,123,3,1,33.333333333333336,99.78
24805,132,0,132,0,0,0,50.0,64.0
24806,8702028,1362,0,152541,788,574,1.7241379310344829,0.0
24807,9300,17,9300,1872,15,2,12.5,51.06
24808,69948,76,0,3424,66,10,100.0,0.0
24809,228,12,228,54,10,2,9.090909090909092,56.81
24810,144,3,144,44,2,1,33.333333333333336,95.83
24811,7658772,46,0,168407,40,6,50.0,0.0
24812,10784604,4938,0,264310,2796,2142,1.0,0.0
24813,78036,1,78036,168,1,0,33.333333333333336,68.66
24814,144,0,144,0,0,0,50.0,95.49
24815,8544012,43,0,199195,28,15,10.0,0.0
24816,1068,10,1068,240,8,2,20.0,60.23
24817,10948104,1787,0,231769,967,820,1.0,1.7
24818,396,16,396,159,12,4,12.5,87.63
24819,8423040,625,0,46690,334,291,3.571428571428572,0.0
24820,192,0,192,0,0,0,100.0,100.0
24821,804,53,0,224,37,16,100.0,0.0
24822,11133132,5461,0,5396495,3266,2195,1.0,0.0
24823,540,72,540,278,34,38,6.666666666666667,73.57
24824,372,14,372,96,10,4,10.0,86.9
24825,8140512,37,8140512,2703,18,19,12.5,93.42
24826,7992,20,1158,3480,18,2,100.0,0.0
24827,9228,39,9228,4997,30,9,5.2631578947368425,0.0
24828,5972040,179,0,1229815,81,98,2.7777777777777777,3.0
24829,17400,24,17400,950,23,1,5.0,70.95
24830,7944312,305,7944312,127294,150,155,2.1739130434782608,71.3
24831,144,13,144,12,11,2,9.090909090909092,56.71
24832,404928,3,8136,269908,2,1,25.0,1.6
24833,108,0,108,0,0,0,50.0,64.0
24834,5484,5,5484,108,3,2,20.0,15.0
24835,1630260,148,252,13157,77,71,4.761904761904762,0.0
24836,228,4,228,60,3,1,20.0,15.0
24837,14592,21,14592,1056,17,4,8.333333333333334,0.0
24838,172140,48,172140,55199,38,10,4.545454545454546,0.39
24839,648,6,648,194,3,3,20.0,15.0
24840,6720,10,6720,230,4,6,33.333333333333336,91.87
24841,3540,63,3540,943,63,0,1.851851851851852,23.8
24842,10050024,599,0,1140204,319,280,1.7857142857142858,5.8
24843,39972,1,39972,39900,1,0,50.0,69.14
24844,624,25,624,175,25,0,3.703703703703704,55.95
24845,9840,44,0,1787,36,8,100.0,0.0
24846,36948,2,36948,84,1,1,50.0,60.23
24847,9273120,254,0,152420,129,125,4.3478260869565215,0.0
24848,684,84,684,92,74,10,1.3333333333333333,36.87
24849,1668,18,1668,702,16,2,8.333333333333334,39.21
24850,96,3,96,24,2,1,33.333333333333336,65.06
24851,174084,8,174084,1035,8,0,11.11111111111111,81.23
24852,336,7,336,34,6,1,20.0,99.85
24853,7130604,29,0,1619383,21,8,14.285714285714286,0.0
24854,2664,6,2664,724,3,3,50.0,62.44
24855,3000,65,3000,726,60,5,1.851851851851852,64.9
24856,4416,33,0,1419,28,5,100.0,0.0
24857,420,6,420,30,5,1,100.0,0.0
24858,2280,13,2280,968,13,0,7.6923076923076925,0.0
24859,17748,81,0,2221,69,12,100.0,0.0
24860,1116,39,1116,105,39,0,2.7777777777777777,69.63
24861,1632,45,1632,321,40,5,1.851851851851852,76.21
24862,3228,28,0,916,24,4,100.0,0.0
24863,99864,87,0,21301,64,23,100.0,0.0
24864,2100,1,2100,60,1,0,50.0,98.5
24865,561120,115,561120,416,101,14,1.075268817204301,11.87
24866,7032,20,240,457,14,6,9.090909090909092,50.81
24867,3972,17,0,747,14,3,100.0,100.0
24868,2952,56,2952,1630,51,5,1.8867924528301887,95.39
24869,1980,33,0,801,28,5,50.0,39.04
24870,7908960,29,7908960,2972,15,14,14.285714285714286,87.54
24871,3684,2,3684,324,1,1,25.0,87.78
24872,40116,13,40116,75,7,6,25.0,94.2
24873,10745856,38,0,1456573,25,13,3.703703703703704,0.01
24874,9332352,158,0,123215,79,79,4.0,1.0
24875,240,21,240,26,19,2,5.0,64.3
24876,7838628,612,0,128629,325,287,2.272727272727273,2.84
24877,563556,249,563556,280,195,54,1.0,18.8
24878,30264,0,30264,0,0,0,50.0,59.29
24879,12720,2,12720,306,2,0,33.333333333333336,97.33
24880,7332,4,7332,1638,2,2,100.0,100.0
24881,4332,26,0,895,22,4,50.0,0.0
24882,828,30,0,362,19,11,5.882352941176471,50.0
24883,5892,53,0,2200,44,9,100.0,0.0
24884,936,1,0,936,1,0,33.333333333333336,0.13
24885,9852012,235,0,42587,140,95,4.761904761904762,0.0
24886,1176,1,1176,432,1,0,33.333333333333336,99.0
24887,6060,2,6060,306,1,1,33.333333333333336,86.71
24888,565416,368,565416,2457,144,224,3.333333333333333,44.64
24889,10657284,656,0,514001,366,290,1.6129032258064515,0.0
24890,660,1,660,456,1,0,50.0,97.69
24891,108,6,108,30,6,0,12.5,55.3
24892,82212,19,82212,622,17,2,6.666666666666667,67.62
24893,11161320,1171,0,5859565,694,477,1.0,0.0
24894,5405652,3266,3324360,550084,1879,1387,1.0,65.15
24895,1263504,28,81468,45900,25,3,4.3478260869565215,48.87
24896,132,8,132,31,6,2,25.0,89.37
24897,1224,3,0,792,1,2,100.0,0.0
24898,5765628,211,5765628,143684,116,95,4.166666666666667,74.52
24899,34320,97,0,1068,74,23,100.0,0.0
24900,108,0,108,0,0,0,100.0,100.0
24901,5472,12,5472,1828,9,3,16.666666666666668,93.76
24902,30816,8,30816,120,7,1,14.285714285714286,0.81
24903,2700,2,2700,96,1,1,33.333333333333336,87.6
24904,4955760,696,4955760,718,390,306,1.0,72.95
24905,5256,34,408,2252,26,8,100.0,0.0
24906,4512,233,1332,707,160,73,1.0,19.86
24907,864,54,864,132,38,16,3.125,43.19
24908,444,31,444,148,17,14,9.090909090909092,45.1
24909,288,9,288,128,9,0,10.0,83.28
24910,11148588,7871,0,437403,4559,3312,1.0,0.0
24911,166488,201,0,2881,96,105,5.2631578947368425,0.0
24912,10242228,1684,0,76837,947,737,1.0,0.0
24913,744,0,744,0,0,0,50.0,65.44
24914,1200,22,1200,291,16,6,6.666666666666667,76.19
24915,312,1,312,60,1,0,33.333333333333336,65.93
24916,144,40,144,45,24,16,5.555555555555555,40.18
24917,8647020,130,0,73603,71,59,2.1739130434782608,2.1
24918,36804,96,0,1228,70,26,20.0,0.1
24919,480,24,480,74,19,5,6.25,52.57
24920,348,19,348,162,15,4,7.142857142857143,57.52
24921,204,24,120,37,18,6,6.666666666666667,49.83
24922,10148856,909,0,83488,546,363,1.0,0.0
24923,1776,9,1776,54,8,1,100.0,0.0
24924,19284,54,19284,103,44,10,2.4390243902439024,46.14
24925,8332056,368,0,33620,175,193,2.702702702702702,1.0
24926,5340,46,0,1911,37,9,100.0,0.0
24927,5328,6,5328,196,5,1,20.0,43.95
24928,264,4,264,69,2,2,50.0,63.93
24929,41988,35,41988,364,26,9,4.166666666666667,68.2
24930,21180,36,21180,56,32,4,3.125,53.56
24931,147480,138,45132,8867,99,39,1.96078431372549,3.89
24932,684,32,684,405,20,12,6.25,88.41
24933,195360,17,195360,734,16,1,7.6923076923076925,75.04
24934,3840,25,0,1770,20,5,100.0,0.0
24935,22092,11,22092,45,6,5,33.333333333333336,76.38
24936,13500,33,0,1648,28,5,100.0,0.0
24937,7181364,209,4254828,767,204,5,1.0,39.79
24938,108,0,108,0,0,0,50.0,64.0
24939,4247292,84,0,795154,48,36,4.3478260869565215,0.0
24940,4032,1,4032,2220,0,1,50.0,95.0
24941,8088,19,8088,677,18,1,6.25,68.4
24942,11424,14,264,3293,10,4,9.090909090909092,82.39
24943,10696872,60,10696872,22874,26,34,10.0,88.05
24944,84,13,84,24,7,6,20.0,46.33
24945,756,9,756,96,9,0,10.0,91.54
24946,5388,114,0,1822,78,36,100.0,0.0
24947,2988,3,0,2024,0,3,3.571428571428572,66.4
24948,1742904,58,257772,41081,46,12,2.272727272727273,14.88
24949,11169528,5974,3243504,1814989,3343,2631,1.0,0.76
24950,5959812,30,0,1573040,25,5,3.703703703703704,11.11
24951,96,4,0,75,4,0,14.285714285714286,50.0
24952,96,5,96,43,5,0,16.666666666666668,70.03
24953,45768,24,45768,818,21,3,8.333333333333334,7.02
24954,408,27,408,49,25,2,3.8461538461538463,0.0
24955,72792,9,72792,460,9,0,9.090909090909092,11.87
24956,396,1,0,396,1,0,33.333333333333336,0.98
24957,11161572,14822,2779111,3354516,9737,5085,1.0,0.14
24958,576,149,408,92,71,78,5.555555555555555,83.28
24959,45432,151,0,1284,80,71,50.0,0.0
24960,4925160,24,22308,571617,17,7,9.090909090909092,74.1
24961,432,9,432,185,7,2,12.5,91.28
24962,17652,105,0,1035,56,49,3.4482758620689653,0.0
24963,624,26,624,249,18,8,6.25,87.38
24964,8127228,461,8127228,41276,183,278,2.3255813953488373,76.62
24965,1335720,66,1335720,514,66,0,1.5625,10.0
24966,31512,15,31512,1779,12,3,8.333333333333334,68.08
24967,1800,50,1800,524,40,10,3.4482758620689653,92.03
24968,2030592,6,0,683614,3,3,100.0,0.0
24969,7440,3,7440,228,3,0,25.0,83.09
24970,2184,89,0,722,58,31,100.0,0.0
24971,740184,517,740184,12325,280,237,1.7543859649122806,70.22
24972,3072,0,3072,0,0,0,50.0,89.33
24973,8340,23,8340,1186,20,3,9.090909090909092,76.97
24974,3576,29,3576,1476,13,16,25.0,0.0
24975,720,2,720,96,1,1,50.0,58.69
24976,288,76,288,74,35,41,7.6923076923076925,80.23
24977,76068,192,0,5812,124,68,100.0,0.0
24978,132,0,132,0,0,0,50.0,80.0
24979,316452,38,316452,884,32,6,3.0303030303030303,37.26
24980,180,3,180,48,3,0,20.0,65.09
24981,5604,30,5604,155,27,3,3.703703703703704,64.32
24982,8796,30,8796,876,30,0,3.0303030303030303,72.37
24983,67572,4,67572,15669,3,1,25.0,61.91
24984,12,1,0,12,1,0,33.333333333333336,0.0
24985,7122984,127,68688,57579,99,28,1.1494252873563218,21.29
24986,10254924,24,39504,5388470,11,13,1.0,0.0
24987,240,53,240,78,30,23,6.666666666666667,65.34
24988,192,0,192,0,0,0,50.0,80.0
24989,9122832,228,0,485236,116,112,6.25,0.0
24990,10944156,2138,0,888792,1205,933,1.0,0.0
24991,2751780,8,2751780,12441,4,4,20.0,0.0
24992,2280,7,2280,747,7,0,12.5,77.41
24993,10709340,140,10709340,44244,74,66,10.0,84.97
24994,336,34,108,60,29,5,3.571428571428572,0.0
24995,2220,102,0,504,70,32,100.0,0.0
24996,4032,25,4032,1575,22,3,7.142857142857143,75.58
24997,9538248,1041,0,61318,563,478,1.0,0.0
24998,15996,22,15996,1154,20,2,5.882352941176471,86.71
24999,4656228,862,639391,56585,762,100,1.0,33.84
25000,564,19,564,258,19,0,4.761904761904762,49.28
25001,5388,4,5388,1494,2,2,50.0,59.2
25002,140652,37,140652,9397,22,15,14.285714285714286,0.0
25003,11113992,1922,0,968480,1050,872,1.0,0.0
25004,4128,7,4128,2250,6,1,14.285714285714286,69.94
25005,504,85,504,81,49,36,3.333333333333333,80.38
25006,780,60,132,51,35,25,5.2631578947368425,69.58
25007,17712,24,1416,1238,20,4,9.090909090909092,51.39
25008,120,5,120,28,3,2,33.333333333333336,76.56
25009,684,45,96,62,37,8,2.7777777777777777,31.16
25010,59556,118,0,14367,77,41,50.0,0.0
25011,10954668,15,4662576,5368561,6,9,1.2987012987012987,0.0
25012,192,1,192,0,1,0,33.333333333333336,60.51
25013,27060,0,27060,0,0,0,100.0,100.0
25014,2052,16,204,150,14,2,6.666666666666667,43.42
25015,12984,88,0,697,64,24,100.0,0.0
25016,1188,3,0,604,2,1,50.0,0.0
25017,8477616,478,0,22613,268,210,1.639344262295082,3.5
25018,10649592,2125,5851188,1519685,1199,926,1.0,0.0
25019,10717152,53,10717152,5668,24,29,8.333333333333334,90.05
25020,220824,281,220824,178963,164,117,1.0,0.0
25021,6408,2,6408,126,2,0,33.333333333333336,50.17
25022,278004,7,278004,14933,6,1,100.0,0.0
25023,78516,89,78516,4991,72,17,1.5384615384615383,31.87
25024,948,5,948,338,2,3,100.0,100.0
25025,13776,1,13776,12,1,0,50.0,50.0
25026,1213824,16,0,198649,13,3,16.666666666666668,0.0
25027,3120,0,3120,0,0,0,50.0,51.2
25028,756,27,756,128,27,0,4.3478260869565215,37.42
25029,2664,109,0,476,85,24,100.0,0.0
25030,43164,65,43164,3965,37,28,25.0,24.92
25031,157848,119,157848,132,94,25,1.2820512820512822,21.8
25032,2683740,1,2683740,1236,1,0,50.0,81.0
25033,23652,32,0,2123,26,6,100.0,0.0
25034,8901372,756,0,97760,365,391,1.5873015873015872,0.0
25035,15600,1,15600,1536,1,0,25.0,0.0
25036,492,37,492,129,21,16,6.666666666666667,66.65
25037,59916,151,0,2141,90,61,25.0,0.0
25038,8480880,333,0,198408,176,157,3.333333333333333,0.0
25039,1957296,53,0,112782,45,8,50.0,0.0
25040,136728,39,134268,37208,39,0,2.857142857142857,29.86
25041,81660,60,81660,2593,57,3,1.7543859649122806,19.75
25042,582900,8,582900,4206,6,2,16.666666666666668,76.98
25043,360,0,360,0,0,0,20.0,98.97
25044,13380,8,13380,2931,5,3,25.0,54.59
25045,3048,17,0,523,14,3,50.0,99.99
25046,11808,22,11808,886,21,1,5.2631578947368425,79.4
25047,4032,22,4032,3717,19,3,5.2631578947368425,86.95
25048,2472,0,2472,0,0,0,50.0,80.0
25049,1596,2,1596,750,1,1,50.0,50.0
25050,474480,1501,178812,9012,1172,329,1.0,0.0
25051,10273572,497,0,68640,273,224,2.380952380952381,0.0
25052,240168,67,240168,12360,60,7,1.7241379310344829,19.24
25053,324,7,324,132,5,2,16.666666666666668,93.78
25054,11436,5,11436,264,5,0,16.666666666666668,95.66
25055,1004256,49,0,62013,39,10,50.0,0.0
25056,1020,32,840,117,29,3,3.4482758620689653,64.87
25057,607368,160,607368,519,122,38,1.0,11.01
25058,19080,24,19080,1645,20,4,6.25,67.88
25059,3269016,195,3269016,11575,104,91,6.666666666666667,84.75
25060,251472,75,251472,8470,70,5,1.4705882352941178,16.56
25061,38580,6,38580,8286,6,0,10.0,33.69
25062,1064040,494,0,6433,252,242,2.4390243902439024,6.29
25063,228,108,132,54,72,36,2.1739130434782608,41.94
25064,11880,138,0,785,93,45,100.0,0.0
25065,8494284,1903,0,37185,1049,854,1.0,1.09
25066,132,4,132,48,4,0,16.666666666666668,72.25
25067,2964,28,2964,108,17,11,11.11111111111111,83.83
25068,804,34,84,36,32,2,3.125,30.64
25069,8425368,332,0,53057,174,158,4.761904761904762,0.0
25070,552,38,552,307,38,0,2.5641025641025643,35.05
25071,2676,120,0,277,70,50,100.0,0.0
25072,384,12,384,96,8,4,12.5,90.44
25073,1275660,1,1275660,4008,1,0,50.0,80.0
25074,38016,150,0,2199,98,52,33.333333333333336,0.0
25075,840,15,840,373,11,4,10.0,85.79
25076,10906572,1751,0,901905,963,788,1.0,1.38
25077,176112,271,157122,7139,164,107,2.272727272727273,79.06
25078,10236,139,0,1096,88,51,100.0,0.0
25079,384,5,0,175,3,2,3.125,0.0
25080,24408,121,0,1827,83,38,100.0,0.0
25081,3809088,290,3809088,840,150,140,2.0,77.73
25082,7584,26,0,1219,23,3,100.0,0.0
25083,2028,21,0,460,16,5,100.0,100.0
25084,126348,42,126348,504,40,2,2.702702702702702,46.28
25085,36756,31,36756,8113,26,5,4.761904761904762,3.45
25086,1548,34,1548,431,26,8,4.166666666666667,50.99
25087,242004,124,0,30341,97,27,20.0,0.0
25088,7260,30,7260,1316,27,3,5.555555555555555,69.44
25089,69696,51,0,3373,42,9,100.0,0.0
25090,11207148,1243,0,206015,735,508,1.2820512820512822,0.0
25091,420924,293,354312,208209,293,0,1.5151515151515151,95.82
25092,5268,10,5268,291,10,0,10.0,64.24
25093,21540,171,0,12383,102,69,50.0,0.0
25094,25104,15,25104,18688,15,0,5.882352941176471,10.77
25095,2556,0,2556,0,0,0,100.0,100.0
25096,15300,33,0,1478,28,5,100.0,0.0
25097,1440,31,0,634,24,7,100.0,0.0
25098,5232852,250,3512784,211612,104,146,2.5641025641025643,3.0
25099,34212,121,34212,1844,96,25,1.25,22.16
25100,4572,36,0,1154,29,7,100.0,0.0
25101,59088,16,59088,533,15,1,8.333333333333334,36.44
25102,10224,14,10224,3928,10,4,7.142857142857143,27.4
25103,35592,26,35592,8972,20,6,6.25,1.42
25104,15636,10,15636,1668,8,2,14.285714285714286,75.13
25105,2040,3,2040,756,3,0,33.333333333333336,71.39
25106,19392,23,19392,931,22,1,5.0,76.45
25107,170496,13,170496,14613,12,1,8.333333333333334,93.35
25108,2136,20,2136,659,18,2,8.333333333333334,2.18
25109,10967520,486,0,486601,265,221,2.0408163265306123,0.0
25110,11209200,4605,765420,2552061,3442,1163,1.0,30.33
25111,1788,21,1788,681,19,2,8.333333333333334,39.42
25112,948,90,948,657,90,0,1.2345679012345678,35.84
25113,263772,5,263772,17292,4,1,25.0,97.71
25114,9360,18,9360,936,13,5,8.333333333333334,1.74
25115,1944,17,1944,594,14,3,10.0,3.4
25116,11175924,151,0,175993,81,70,4.3478260869565215,0.0
25117,12540,19,12540,919,17,2,7.142857142857143,74.26
25118,8935848,804,0,26796,453,351,2.1739130434782608,0.0
25119,253188,94,960,3464,87,7,1.2048192771084338,45.06
25120,84,0,84,0,0,0,50.0,67.24
25121,9876,42,0,1549,35,7,100.0,0.0
25122,2052,15,2052,695,14,1,11.11111111111111,75.59
25123,12696,23,12696,698,21,2,5.882352941176471,76.71
25124,73488,86,0,3366,72,14,100.0,0.0
25125,57432,3,0,34972,2,1,33.333333333333336,1.85
25126,9881508,58,0,1388562,44,14,50.0,0.0
25127,2544,15,2544,677,14,1,8.333333333333334,78.16
25128,10980,13,10980,1323,9,4,20.0,75.86
25129,4992,49,0,1711,40,9,50.0,0.0
25130,1536,18,1536,562,16,2,7.6923076923076925,58.49
25131,2832,24,2832,658,16,8,16.666666666666668,81.97
25132,1644,24,1644,682,22,2,7.142857142857143,77.35
25133,20100,92,0,2094,71,21,20.0,0.0
25134,518304,34,518304,17852,28,6,4.3478260869565215,45.75
25135,21468,2,21468,510,2,0,50.0,97.0
25136,109020,23,0,108277,0,23,50.0,99.81
25137,8988,51,0,1881,43,8,100.0,0.0
25138,12900,89,12900,396,64,25,1.851851851851852,39.54
25139,1152,22,0,380,18,4,100.0,100.0
25140,14556,50,14556,61,42,8,2.5,34.41
25141,24888,21,14112,5027,11,10,16.666666666666668,84.24
25142,636,2,0,606,2,0,33.333333333333336,0.0
25143,8328,9,8328,3209,5,4,100.0,100.0
25144,259248,3,0,172944,3,0,50.0,0.0
25145,1620,16,0,470,12,4,100.0,100.0
25146,136044,83,0,33731,50,33,3.4482758620689653,0.0
25147,13116,47,0,1670,39,8,100.0,0.0
25148,93192,10,93192,1514,10,0,12.5,48.03
25149,192,4,0,93,2,2,50.0,90.0
25150,1824,20,0,559,17,3,33.333333333333336,48.8
25151,62196,23,62196,1828,18,5,7.6923076923076925,70.74
25152,9924324,24,11016,414742,16,8,11.11111111111111,73.36
25153,7475064,160,0,466389,59,101,4.0,9.12
25154,3216,43,0,765,35,8,50.0,97.66
25155,3792,11,3792,1968,11,0,7.6923076923076925,78.19
25156,22644,29,22644,1592,26,3,5.555555555555555,66.61
25157,1296,8,1296,1150,6,2,12.5,95.69
25158,1248696,6,0,210510,5,1,33.333333333333336,45.24
25159,0,0,0,0,0,0,100.0,100.0
25160,9843384,116,6079428,2638849,24,92,1.492537313432836,0.0
25161,32424,13,32424,831,11,2,11.11111111111111,0.88
25162,2712,17,2712,645,16,1,7.142857142857143,73.95
25163,5232,22,5232,866,20,2,7.142857142857143,67.16
25164,6528,51,0,1450,44,7,100.0,0.0
25165,1428,13,1428,426,8,5,20.0,0.0
25166,38988,23,38988,833,20,3,5.555555555555555,14.96
25167,71004,36,0,7308,31,5,50.0,0.0
25168,1776,4,1776,843,2,2,33.333333333333336,99.04
25169,324,99,324,131,51,48,3.4482758620689653,56.92
25170,744,12,744,705,10,2,9.090909090909092,87.79
25171,38016,250,0,2764,154,96,50.0,0.0
25172,744,125,0,54,76,49,100.0,100.0
25173,48636,152,48636,2835,111,41,1.639344262295082,3.82
25174,6828,15,6828,815,14,1,7.6923076923076925,72.77
25175,228,1,228,204,1,0,33.333333333333336,96.46
25176,936,0,936,0,0,0,2.5,66.13
25177,636,2,0,540,2,0,50.0,56.44
25178,15600,25,15600,604,22,3,4.761904761904762,50.0
25179,19044,279,0,7621,154,125,50.0,0.0
25180,1104,22,1104,43,20,2,4.761904761904762,87.37
25181,23352,201,0,4683,127,74,100.0,0.0
25182,142512,43,142512,3861,24,19,12.5,94.3
25183,156,4,0,39,3,1,100.0,100.0
25184,264,6,0,72,5,1,100.0,100.0
25185,49992,169,0,1985,118,51,100.0,0.0
25186,1279056,20,647526,202282,15,5,11.11111111111111,74.74
25187,58032,10,58032,1531,10,0,9.090909090909092,54.95
25188,8736,16,8736,1328,15,1,9.090909090909092,80.76
25189,681552,11,1644,124124,8,3,20.0,86.74
25190,13692,31,13692,2417,26,5,4.545454545454546,11.81
25191,11568,7,11568,313,5,2,20.0,0.0
25192,3285540,27,3285540,18217,13,14,12.5,64.73
25193,235764,115,235764,239,80,35,1.7241379310344829,18.46
25194,46812,96,0,1426,63,33,50.0,0.0
25195,144,0,144,0,0,0,50.0,60.84
25196,11191776,19704,1073646,680289,10976,8728,1.0,0.0
25197,552,49,552,21,47,2,2.083333333333333,58.86
25198,17796,25,4164,2187,22,3,6.666666666666667,68.48
25199,1056,46,1056,49,45,1,2.127659574468085,50.19
25200,21636,0,21636,0,0,0,100.0,100.0
25201,3000,22,3000,114,22,0,4.166666666666667,78.63
25202,58224,108,58224,3973,90,18,1.162790697674419,26.98
25203,5448,11,5448,164,10,1,11.11111111111111,79.0
25204,8763408,677,0,93145,362,315,2.857142857142857,4.0
25205,792,5,792,242,4,1,20.0,46.64
25206,14652,147,0,791,108,39,50.0,0.0
25207,192,2,192,30,2,0,25.0,60.81
25208,10803048,84,10803048,17229,34,50,12.5,90.1
25209,24612,54,0,2900,46,8,100.0,0.0
25210,5844,10,5844,1142,8,2,12.5,86.63
25211,7464,6,7464,590,5,1,25.0,82.95
25212,828,118,0,348,87,31,1.5873015873015872,0.0
25213,10219368,3569,0,293039,2044,1525,1.0,0.0
25214,7462068,329,0,77145,186,143,3.571428571428572,1.81
25215,5628,13,5628,251,12,1,8.333333333333334,81.06
25216,8356560,1953,2094080,469375,1361,592,1.0,3.59
25217,7212,19,7212,1518,18,1,8.333333333333334,80.39
25218,11175996,17,0,4021939,10,7,1.0,0.0
25219,266412,1255,164986,131436,965,290,1.0,0.0
25220,300732,673,162774,9358,520,153,1.0,0.0
25221,4368,33,0,1487,28,5,100.0,0.0
25222,19092,101,0,7884,69,32,50.0,0.0
25223,21720,214,0,1443,133,81,100.0,0.0
25224,5316,7,5316,466,7,0,12.5,62.4
25225,27804,53,0,2949,46,7,100.0,0.0
25226,83004,24,15408,4467,23,1,4.545454545454546,78.73
25227,8573040,978,0,44634,533,445,1.9230769230769231,0.0
25228,3012,6,3012,1020,3,3,100.0,100.0
25229,127428,5,127428,66912,3,2,16.666666666666668,94.04
25230,3900,25,3900,647,21,4,7.142857142857143,67.35
25231,35184,23,35184,914,21,2,6.666666666666667,70.97
25232,1716,156,1716,736,84,72,2.857142857142857,51.51
25233,7188,50,7188,1143,39,11,3.225806451612903,52.25
25234,1239780,149,943932,134346,124,25,1.020408163265306,8.86
25235,17244,75,0,661,57,18,50.0,0.0
25236,43080,26,43080,707,22,4,11.11111111111111,54.54
25237,2952,23,2952,762,20,3,6.666666666666667,66.78
25238,19716,27,19716,2407,23,4,6.666666666666667,6.02
25239,5940,23,5940,1053,21,2,5.555555555555555,66.55
25240,6960,16,6960,359,12,4,8.333333333333334,83.03
25241,75192,115,75192,9717,95,20,1.3157894736842106,32.3
25242,18468,14,18468,595,13,1,10.0,54.24
25243,2784,3,0,1376,2,1,33.333333333333336,0.0
25244,11280,51,0,2572,44,7,100.0,0.0
25245,2340,17,2340,753,16,1,7.6923076923076925,49.79
25246,5253468,9,5253468,291889,6,3,33.333333333333336,59.16
25247,3971844,3,3971844,0,3,0,20.0,75.14
25248,4596,20,4596,889,18,2,6.25,12.15
25249,7553472,752,2762064,51322,475,277,1.162790697674419,72.78
25250,7308,22,7308,1068,21,1,5.2631578947368425,70.82
25251,2064,24,2064,759,21,3,7.142857142857143,66.29
25252,390756,45,347268,40131,38,7,1.7241379310344829,63.88
25253,13596,43,0,3694,36,7,100.0,0.0
25254,2568,17,2568,813,16,1,8.333333333333334,72.93
25255,3036,22,3036,1134,21,1,5.2631578947368425,86.9
25256,7536,22,7536,1045,21,1,5.882352941176471,72.82
25257,98796,45,0,4549,35,10,100.0,0.0
25258,1932,17,1932,565,15,2,10.0,81.09
25259,1176,1,0,1176,1,0,25.0,0.0
25260,22272,4,22272,471,3,1,100.0,0.0
25261,22476,0,22476,0,0,0,100.0,0.0
25262,6804,1,6804,216,0,1,50.0,99.9
25263,112692,53,112692,10326,46,7,2.2222222222222223,28.56
25264,9984,2,9984,582,1,1,100.0,100.0
25265,18216,5,0,7500,3,2,33.333333333333336,0.0
25266,1320,16,0,691,13,3,100.0,0.0
25267,3240,17,3240,1417,15,2,7.6923076923076925,67.68
25268,2784,20,0,544,16,4,50.0,99.99
25269,4776,15,4776,704,13,2,8.333333333333334,79.28
25270,432,2,432,96,2,0,25.0,91.0
25271,10032,25,10032,1449,23,2,5.2631578947368425,74.11
25272,169020,3,169020,16556,3,0,20.0,52.51
25273,9672,27,9672,1334,25,2,5.2631578947368425,64.99
25274,12324,4,12324,1830,4,0,20.0,66.31
25275,4452,27,4452,1494,25,2,5.2631578947368425,72.97
25276,6408,16,6408,804,15,1,16.666666666666668,65.2
25277,11820,47,0,1980,37,10,100.0,0.0
25278,5268,4,5268,789,3,1,20.0,55.65
25279,2832,0,2832,0,0,0,50.0,65.61
25280,29652,64,0,557,55,9,100.0,0.0
25281,75864,98,0,5208,74,24,16.666666666666668,0.0
25282,132,10,132,2,10,0,8.333333333333334,48.01
25283,72,17,72,14,14,3,7.6923076923076925,45.79
25284,10686708,4924,0,178716,2703,2221,1.0,2.31
25285,1824,129,0,268,73,56,100.0,0.0
25286,972,93,972,146,87,6,1.1494252873563218,38.81
25287,259620,262,0,4322,154,108,7.142857142857143,0.0
25288,144,2,144,72,1,1,50.0,96.45
25289,10859124,293,0,99595,158,135,4.545454545454546,5.0
25290,1554588,2,0,779142,1,1,9.090909090909092,0.0
25291,8424,6,8424,690,3,3,14.285714285714286,85.0
25292,4764,22,4764,1010,20,2,5.0,48.7
25293,14208,38,0,1604,31,7,100.0,0.0
25294,303024,1144,268874,249920,901,243,1.0,0.0
25295,5988,28,5988,1583,24,4,5.882352941176471,75.51
25296,1991316,360,0,102301,198,162,2.7777777777777777,0.0
25297,56424,1067,21601,7636,862,205,1.0,0.0
25298,90072,74,0,2952,65,9,100.0,0.0
25299,3420,24,0,836,20,4,100.0,0.0
25300,1079352,22,4296,98826,19,3,6.666666666666667,71.97
25301,8112,8,8112,445,7,1,16.666666666666668,18.66
25302,1296,3,1296,688,2,1,33.333333333333336,63.53
25303,96,17,84,32,15,2,6.666666666666667,46.53
25304,612,0,612,0,0,0,100.0,100.0
25305,1080,85,1080,84,79,6,1.2658227848101269,35.79
25306,2040,33,2040,126,27,6,4.0,40.12
25307,7416180,68,0,1613239,55,13,16.666666666666668,0.0
25308,3252,23,0,770,18,5,100.0,100.0
25309,8448,20,8448,1509,17,3,11.11111111111111,76.27
25310,2088,11,2088,541,10,1,14.285714285714286,86.0
25311,15708,24,9402,995,22,2,5.882352941176471,68.2
25312,5532,39,5532,294,29,10,3.8461538461538463,54.35
25313,6204,29,6204,821,27,2,5.555555555555555,64.87
25314,1416,129,1416,331,81,48,1.7241379310344829,64.35
25315,2592,120,0,680,81,39,100.0,0.0
25316,42876,12,42876,6706,11,1,11.11111111111111,80.08
25317,4152,28,4152,741,25,3,5.882352941176471,63.88
25318,753576,9,0,249232,5,4,14.285714285714286,0.0
25319,9480,44,0,1662,37,7,100.0,0.0
25320,2484,17,0,634,13,4,100.0,100.0
25321,7848,11,7848,483,9,2,16.666666666666668,89.9
25322,1932,15,0,943,12,3,100.0,100.0
25323,718668,117,0,77674,71,46,2.5,0.0
25324,10416,3,0,3912,2,1,100.0,0.0
25325,2748,24,2748,650,22,2,5.882352941176471,69.31
25326,1380,21,0,511,17,4,100.0,100.0
25327,1632,13,1632,584,12,1,12.5,87.11
25328,1519380,2565,763308,72932,906,1659,1.0,0.0
25329,141216,18,0,8816,14,4,33.333333333333336,0.0
25330,2496,74,0,1071,61,13,50.0,87.88
25331,78228,11,78228,3165,11,0,8.333333333333334,89.62
25332,50268,2,50268,252,2,0,25.0,59.61
25333,1020,0,1020,0,0,0,100.0,100.0
25334,9456,7,9456,965,6,1,16.666666666666668,95.03
25335,4452,33,4452,1161,30,3,5.555555555555555,68.19
25336,7788,50,0,1549,42,8,100.0,0.0
25337,348,47,348,39,34,13,3.703703703703704,42.28
25338,1500,10,1500,1352,10,0,8.333333333333334,66.48
25339,14004,137,0,766,91,46,100.0,0.0
25340,228,0,228,0,0,0,50.0,60.63
25341,7528788,887,0,46199,540,347,1.492537313432836,0.0
25342,370824,198,0,8650,89,109,5.882352941176471,0.0
25343,564,4,564,180,4,0,16.666666666666668,96.0
25344,73572,175,73572,4575,133,42,1.2987012987012987,3.79
25345,51756,111,0,48829,71,40,50.0,0.0
25346,50928,224,0,9170,138,86,100.0,0.0
25347,3036,19,3036,505,16,3,8.333333333333334,84.06
25348,11179380,45,588,2851086,27,18,1.0,16.46
25349,188304,37,188304,26680,29,8,3.571428571428572,35.43
25350,2714820,85,2714820,123378,36,49,11.11111111111111,0.0
25351,468,2,468,204,2,0,25.0,98.0
25352,10183236,2600,0,787801,1450,1150,1.0869565217391304,1.0
25353,1301028,1,875172,1301028,0,1,50.0,0.0
25354,79944,35,14220,4333,30,5,5.2631578947368425,75.47
25355,780,31,780,415,30,1,3.125,50.67
25356,300,1,300,0,1,0,33.333333333333336,88.0
25357,384,2,384,96,1,1,50.0,80.0
25358,10719936,450,150324,1461575,260,190,2.0408163265306123,0.0
25359,885912,9,885912,1429,7,2,25.0,0.0
25360,129852,52,129852,37372,38,14,5.555555555555555,0.81
25361,40032,11,40032,327,11,0,8.333333333333334,0.52
25362,7704696,569,5763924,43432,329,240,1.4705882352941178,81.14
25363,780,42,780,15,42,0,2.272727272727273,59.15
25364,57744,15,57744,27589,7,8,25.0,96.42
25365,372,6,372,68,3,3,33.333333333333336,98.17
25366,66180,28,0,3287,22,6,100.0,0.0
25367,9195468,794,0,38114,447,347,1.7857142857142858,5.95
25368,62172,46,62172,5415,37,9,3.8461538461538463,8.16
25369,168,89,108,41,70,19,1.6129032258064515,33.29
25370,29772,126,0,17891,73,53,50.0,0.0
25371,892236,22,0,46451,14,8,100.0,100.0
25372,6084,14,6084,373,13,1,8.333333333333334,75.98
25373,9674988,340,7765896,4300246,229,111,1.0,7.11
25374,7812,22,7812,796,21,1,5.2631578947368425,75.36
25375,217404,6,217404,1796,5,1,20.0,99.57
25376,150480,68,150480,4175,64,4,1.639344262295082,18.31
25377,2577708,51,963245,314264,20,31,25.0,0.0
25378,71052,129,0,1486,90,39,100.0,0.0
25379,27672,35,0,1931,31,4,100.0,0.0
25380,52644,128,52644,7757,62,66,3.571428571428572,0.0
25381,864,56,0,441,55,1,100.0,0.0
25382,24072,156,0,2478,94,62,100.0,0.0
25383,42000,18,42000,3252,14,4,10.0,96.19
25384,210876,255,210876,359,186,69,1.0,12.45
25385,26352,136,0,849,90,46,100.0,0.0
25386,10984224,648,0,164234,357,291,1.492537313432836,3.0
25387,38412,45,0,2937,37,8,100.0,0.0
25388,3543432,1109,3543432,38285,624,485,1.3157894736842106,0.0
25389,270720,161,270720,18142,107,54,1.0,58.97
25390,12756,19,12756,923,18,1,5.882352941176471,0.52
25391,960,15,960,707,5,10,100.0,100.0
25392,50004,31,50004,1206,27,4,5.0,67.56
25393,4360572,14,16020,313296,13,1,8.333333333333334,50.28
25394,86088,51,86088,1548,41,10,2.631578947368421,54.91
25395,304260,9,0,66512,3,6,20.0,0.0
25396,161112,81,161112,8833,75,6,1.3888888888888888,24.87
25397,8921628,472,1362568,426872,280,192,1.0526315789473684,0.0
25398,8850264,261,0,603473,113,148,3.571428571428572,0.0
25399,8664396,305,0,108619,150,155,4.545454545454546,0.0
25400,12924,25,12924,803,22,3,6.25,67.46
25401,5211672,402,5211672,116822,193,209,4.761904761904762,79.53
25402,9021480,5210,15876,258448,2989,2221,1.0,0.0
25403,8405976,1071,1092,24093,576,495,1.5384615384615383,0.0
25404,10918176,228,9221112,1154171,134,94,2.9411764705882355,68.78
25405,8394636,43,8394636,67705,30,13,5.0,71.13
25406,84576,97,84576,8560,83,14,1.2820512820512822,27.89
25407,504,3,504,116,3,0,33.333333333333336,99.9
25408,51924,10,51924,284,9,1,12.5,71.7
25409,36444,163,0,2024,106,57,50.0,0.0
25410,9216,52,0,2632,43,9,100.0,0.0
25411,20028,4,20028,663,3,1,33.333333333333336,95.26
25412,66888,96,0,1893,63,33,100.0,0.0
25413,5688,32,5688,829,29,3,5.2631578947368425,65.12
25414,384,7,384,252,5,2,25.0,29.93
25415,17148,53,0,2489,45,8,100.0,0.0
25416,12576,39,12576,2621,35,4,4.3478260869565215,62.15
25417,341472,34,341472,52671,30,4,3.8461538461538463,56.56
25418,2184,24,0,422,19,5,100.0,100.0
25419,301764,224,88056,6343,125,99,2.272727272727273,79.05
25420,1584,6,0,1260,2,4,100.0,0.0
25421,912,3,912,504,1,2,50.0,99.83
25422,69876,73,0,2457,62,11,100.0,0.0
25423,7680,29,7680,1564,26,3,6.666666666666667,73.73
25424,6052692,208,6052692,49181,119,89,3.703703703703704,59.9
25425,33168,27,33168,1701,19,8,9.090909090909092,90.96
25426,10985004,243,4080720,5755070,112,131,1.0,0.0
25427,9144,13,9144,1026,13,0,7.6923076923076925,76.06
25428,598320,2,0,299448,1,1,33.333333333333336,0.0
25429,1872216,43,0,132168,36,7,50.0,0.0
25430,2580,20,2580,678,17,3,7.142857142857143,77.43
25431,12852,25,12852,901,22,3,5.882352941176471,79.31
25432,174876,0,174876,0,0,0,100.0,100.0
25433,82848,107,0,4640,82,25,5.555555555555555,0.0
25434,165888,34,37188,40164,33,1,50.0,99.99
25435,3744,14,0,644,12,2,100.0,100.0
25436,248760,345,204792,21779,191,154,2.2222222222222223,79.02
25437,768,6,768,248,3,3,14.285714285714286,0.0
25438,3864,9,3864,898,8,1,16.666666666666668,70.43
25439,5340,5,5340,2092,3,2,7.6923076923076925,73.9
25440,6852,50,0,1855,41,9,50.0,0.0
25441,264,22,264,75,19,3,5.555555555555555,37.44
25442,1121208,5,0,468463,2,3,33.333333333333336,99.94
25443,8532,20,0,1187,16,4,100.0,100.0
25444,2597016,97,2597016,11903,34,63,25.0,96.0
25445,73044,8,73044,481,7,1,20.0,88.94
25446,1944,21,0,418,16,5,100.0,100.0
25447,1164,10,1164,439,9,1,14.285714285714286,81.14
25448,8340,1,8340,468,1,0,25.0,80.0
25449,1416,23,0,389,20,3,100.0,100.0
25450,1968,1,1968,432,1,0,100.0,100.0
25451,1656,19,0,363,14,5,100.0,100.0
25452,15060,14,15060,1166,13,1,7.142857142857143,82.17
25453,1956,27,0,607,21,6,100.0,100.0
25454,153024,21,153024,16739,13,8,6.666666666666667,9.29
25455,7968,49,0,2083,40,9,100.0,0.0
25456,2004,7,2004,833,6,1,20.0,16.62
25457,120,0,120,0,0,0,50.0,60.84
25458,4092,28,4092,1215,25,3,5.555555555555555,67.89
25459,2196,27,0,377,21,6,50.0,99.99
25460,11411892,14093,5817199,4427497,8537,5556,1.0,0.0
25461,8628,11,8628,764,11,0,11.11111111111111,15.41
25462,1236,1,1236,468,1,0,100.0,100.0
25463,20448,20,20448,1236,19,1,6.666666666666667,68.1
25464,2088,58,0,804,48,10,50.0,89.0
25465,3660,25,3660,1010,23,2,5.882352941176471,43.89
25466,18372,108,0,3003,83,25,12.5,0.0
25467,2052,10,2052,625,9,1,14.285714285714286,75.93
25468,181932,1,181826,181908,1,0,33.333333333333336,5.06
25469,1788,45,1788,1298,33,12,3.4482758620689653,76.84
25470,276,6,276,64,6,0,12.5,80.9
25471,1044,1,1044,216,1,0,50.0,99.0
25472,60,2,60,30,1,1,50.0,70.48
25473,2136,9,2136,716,9,0,14.285714285714286,64.76
25474,3204,23,3204,2065,21,2,5.0,84.16
25475,11099268,529,0,3371229,277,252,1.020408163265306,0.04
25476,768,3,768,104,3,0,100.0,100.0
25477,3348,16,3348,824,16,0,7.142857142857143,72.81
25478,157284,46,0,5429,38,8,50.0,0.0
25479,84,8,84,27,6,2,16.666666666666668,70.62
25480,5166432,78,5166432,1853,47,31,2.5,85.27
25481,39708,56,0,2325,42,14,100.0,0.0
25482,48924,28,48924,1195,26,2,5.882352941176471,57.28
25483,1728,17,1728,458,15,2,9.090909090909092,61.12
25484,39672,82,0,2197,52,30,33.333333333333336,0.0
25485,10503744,14,10503744,219,10,4,10.0,84.57
25486,695844,169,35160,6335,125,44,1.4285714285714286,7.04
25487,264,21,264,66,19,2,5.0,58.71
25488,244680,60,244662,36676,22,38,20.0,97.55
25489,50388,24,50388,1828,21,3,5.882352941176471,6.47
25490,3336,15,3336,688,14,1,9.090909090909092,33.09
25491,42864,65,0,1002,47,18,25.0,0.0
25492,2820,26,2820,1149,22,4,5.0,63.32
25493,10668,14,10668,515,13,1,9.090909090909092,77.69
25494,8076,16,0,4668,10,6,11.11111111111111,0.0
25495,33636,10,33636,4075,6,4,50.0,98.34
25496,11011824,297,11011824,11213,153,144,4.3478260869565215,83.82
25497,2436,104,0,664,71,33,100.0,0.0
25498,46056,128,0,3343,93,35,100.0,0.0
25499,132,2,132,96,2,0,25.0,60.8
25500,948,41,948,332,22,19,11.11111111111111,86.6
25501,6804,4,0,4023,2,2,25.0,0.0
25502,10509132,20,10509132,49213,10,10,14.285714285714286,91.4
25503,840,0,840,0,0,0,50.0,81.0
25504,22356,108,0,747,70,38,100.0,0.0
25505,5640,0,5640,0,0,0,50.0,80.0
25506,2256,16,2256,326,14,2,11.11111111111111,72.97
25507,636,29,636,74,29,0,4.3478260869565215,76.51
25508,11418204,4501,63756,395711,2587,1914,1.0,0.0
25509,2292,12,2292,913,8,4,20.0,90.83
25510,192,0,192,0,0,0,50.0,81.0
25511,235680,0,235530,0,0,0,100.0,100.0
25512,48444,114,0,1133,74,40,50.0,0.0
25513,2896788,80,2896788,24492,34,46,16.666666666666668,93.09
25514,136872,120,136872,6646,99,21,1.1363636363636365,22.89
25515,11280180,1366,0,2002935,891,475,1.0,0.0
25516,3144,161,0,485,94,67,100.0,0.0
25517,456,127,456,170,115,12,1.0,52.47
25518,12900,57,0,2097,46,11,100.0,0.0
25519,547368,6,547368,46144,4,2,25.0,97.35
25520,3096,97,0,1188,62,35,100.0,0.0
25521,11074416,665,0,104405,332,333,2.083333333333333,0.0
25522,57000,7,57000,1009,7,0,11.11111111111111,83.35
25523,1488,73,1488,972,55,18,2.083333333333333,57.23
25524,9843408,370,2200344,54935,197,173,3.4482758620689653,0.0
25525,3852,18,3852,1212,14,4,9.090909090909092,3.75
25526,708,3,708,156,2,1,33.333333333333336,0.0
25527,6744,21,6744,968,18,3,7.6923076923076925,71.5
25528,4692,21,4692,901,12,9,14.285714285714286,0.0
25529,4375404,421,1150152,53579,381,40,1.0,49.08
25530,11390544,2754,0,1292817,1559,1195,1.0,0.64
25531,408,7,408,72,7,0,11.11111111111111,93.56
25532,51852,264,0,9094,140,124,50.0,0.0
25533,14352,27,3828,1600,24,3,6.25,70.09
25534,2765124,446,2765124,5443,222,224,2.5,81.43
25535,96,5,96,0,5,0,14.285714285714286,94.92
25536,6884184,258,5904186,2202,177,81,1.0,20.94
25537,3228,12,0,459,11,1,50.0,99.99
25538,1380,15,648,516,14,1,7.6923076923076925,81.4
25539,898596,49,0,33620,29,20,11.11111111111111,4.88
25540,147720,4,147720,1116,2,2,50.0,22.24
25541,244044,65,244044,5412,60,5,1.7241379310344829,19.99
25542,10871304,1098,242376,97882,586,512,1.2820512820512822,1.0
25543,2592,8,2592,657,4,4,50.0,79.23
25544,10373964,668,0,43366,292,376,1.2820512820512822,0.0
25545,2748684,31,2748684,97488,15,16,10.0,0.0
25546,2280,16,2280,2123,12,4,8.333333333333334,84.98
25547,210888,1410,28558,11593,1109,301,1.0,0.0
25548,48324,9,48324,1262,9,0,10.0,54.95
25549,7782624,40,0,1473060,35,5,33.333333333333336,0.0
25550,252,19,252,8,17,2,5.882352941176471,39.97
25551,4032,4,4032,2235,4,0,20.0,84.72
25552,14448,53,0,2013,44,9,100.0,0.0
25553,11460,5,11460,4473,4,1,20.0,96.73
25554,70644,132,70644,4721,104,28,1.1494252873563218,25.98
25555,1082832,394,0,6577,214,180,2.2222222222222223,0.0
25556,1104,12,1104,146,12,0,7.142857142857143,52.09
25557,756,39,756,312,35,4,3.125,72.42
25558,714720,34,0,88088,12,22,8.333333333333334,0.0
25559,4878504,12,0,407708,6,6,100.0,0.0
25560,2892,18,0,844,15,3,100.0,100.0
25561,384,11,384,105,9,2,5.2631578947368425,42.77
25562,48480,139,0,15373,83,56,100.0,0.0
25563,564312,2,0,564270,1,1,50.0,2.87
25564,10962204,2099,7917888,141529,1210,889,1.0,52.04
25565,49644,88,0,14019,67,21,50.0,0.0
25566,223608,136,0,8364,68,68,10.0,5.0
25567,31128,16,31128,689,15,1,9.090909090909092,36.75
25568,10116,29,10116,2062,22,7,6.666666666666667,3.0
25569,46704,159,0,3643,135,24,2.272727272727273,0.0
25570,6804,45,0,3756,41,4,100.0,0.0
25571,14628,20,14628,931,19,1,5.882352941176471,78.22
25572,396,9,396,110,5,4,33.333333333333336,62.1
25573,2496,20,0,703,17,3,100.0,100.0
25574,38688,26,38688,1824,24,2,4.761904761904762,63.67
25575,1968,29,0,571,24,5,33.333333333333336,49.75
25576,8543844,526,0,28666,294,232,1.7857142857142858,0.0
25577,450888,34,0,14246,25,9,100.0,0.0
25578,6060,0,6060,0,0,0,100.0,100.0
25579,11467704,3520,0,8115254,2238,1282,1.0,0.0
25580,5388,13,5388,642,12,1,10.0,22.68
25581,4356,14,4356,1032,13,1,10.0,8.24
25582,40548,13,40548,1893,9,4,11.11111111111111,84.83
25583,5784,24,5784,1310,22,2,5.882352941176471,67.21
25584,2679708,42,2679708,25258,28,14,8.333333333333334,96.84
25585,8847060,723,4424982,59123,413,310,1.4492753623188406,74.74
25586,28020,152,0,2226,93,59,50.0,0.0
25587,239652,55,0,12633,44,11,100.0,0.0
25588,2768472,15,2768472,58025,8,7,20.0,96.43
25589,4848,16,4848,709,15,1,9.090909090909092,33.43
25590,1020,182,1020,148,133,49,1.1111111111111112,59.07
25591,9907884,1897,7961088,841891,815,1082,1.0,0.14
25592,11472936,1170,603204,4434656,720,450,1.0,0.0
25593,295200,109,295200,30887,80,29,1.36986301369863,9.75
25594,73572,0,73572,0,0,0,100.0,100.0
25595,7936500,175,7936500,90730,124,51,9.090909090909092,0.0
25596,1695804,48,0,37182,38,10,50.0,0.0
25597,522384,73,522324,170877,60,13,1.1111111111111112,48.83
25598,788832,2,788832,27810,2,0,33.333333333333336,94.07
25599,50388,1,50388,3360,0,1,100.0,100.0
25600,62652,99,62652,4114,73,26,5.0,0.0
25601,28848,7,28848,195,6,1,16.666666666666668,84.88
25602,208500,97,208500,13801,75,22,1.4285714285714286,38.92
25603,3528,11,3528,526,11,0,12.5,64.52
25604,207312,8,59808,57406,6,2,25.0,79.09
25605,103992,108,103992,13479,91,17,1.2987012987012987,17.49
25606,31116,1,31116,31032,1,0,33.333333333333336,70.1
25607,2028,17,2028,604,16,1,8.333333333333334,73.64
25608,272100,7,272100,24173,7,0,14.285714285714286,92.25
25609,10788,2,7608,10698,1,1,50.0,81.0
25610,83844,5,83844,2940,1,4,20.0,0.01
25611,6744,47,0,1827,41,6,100.0,0.0
25612,11483592,789,0,5602980,340,449,1.0,0.0
25613,13104,19,13104,883,19,0,5.882352941176471,78.91
25614,103488,49,0,11884,38,11,50.0,0.0
25615,2912100,90,2912100,310174,40,50,7.142857142857143,80.77
25616,7380,18,7380,686,16,2,10.0,52.4
25617,15732,20,15732,1132,18,2,6.666666666666667,77.22
25618,93276,75,0,3985,64,11,100.0,0.0
25619,49656,127,49656,4563,107,20,1.0,20.0
25620,216,27,216,18,24,3,4.3478260869565215,39.7
25621,387864,354,387864,338450,280,74,1.1764705882352942,40.7
25622,18828,27,18828,2116,25,2,5.555555555555555,64.39
25623,163752,8,83124,151167,6,2,16.666666666666668,0.0
25624,339732,8,339732,9403,5,3,50.0,41.02
25625,1488,2,1488,174,1,1,50.0,79.2
25626,7872,43,0,1721,36,7,100.0,0.0
25627,4308,18,4308,818,16,2,10.0,26.26
25628,6108,2,6108,1296,2,0,25.0,49.1
25629,4080,0,2898,0,0,0,1.5873015873015872,22.42
25630,3720,16,3720,679,15,1,7.142857142857143,7.46
25631,72000,121,0,5999,97,24,9.090909090909092,0.0
25632,37896,145,0,2409,94,51,33.333333333333336,0.0
25633,10824,38,0,2013,33,5,100.0,0.0
25634,0,0,0,0,0,0,100.0,0.0
25635,168,6,168,80,4,2,25.0,66.46
25636,2352,37,0,691,27,10,100.0,0.0
25637,8628,54,0,1677,44,10,100.0,0.0
25638,265032,115,312,3711,82,33,1.5625,1.82
25639,264,17,264,93,17,0,5.2631578947368425,83.73
25640,4380,122,0,1770,80,42,100.0,0.0
25641,88704,37,88704,13906,30,7,100.0,0.0
25642,826296,208,0,62103,83,125,3.225806451612903,0.0
25643,38820,2,38820,1224,2,0,25.0,98.0
25644,84,1,84,12,1,0,33.333333333333336,79.2
25645,2004,29,2004,822,20,9,10.0,0.0
25646,1647864,269,0,11794,137,132,5.555555555555555,0.0
25647,264,15,0,72,11,4,50.0,0.0
25648,8268,37,8268,107,31,6,3.225806451612903,30.27
25649,9024,19,9024,796,9,10,16.666666666666668,92.76
25650,783564,535,0,11328,235,300,3.4482758620689653,0.0
25651,12636,66,12636,12270,36,30,4.545454545454546,78.34
25652,1136856,94,0,75365,61,33,2.5641025641025643,0.0
25653,52836,24,52836,887,22,2,5.882352941176471,55.22
25654,1848,60,0,709,49,11,50.0,87.0
25655,168,24,96,49,13,11,20.0,51.07
25656,1152,63,0,488,51,12,100.0,0.0
25657,1034952,22,0,58369,14,8,100.0,100.0
25658,444,80,444,138,76,4,1.4705882352941178,36.01
25659,29844,22,29844,282,18,4,7.142857142857143,77.73
25660,45516,70,14256,1414,46,24,2.702702702702702,46.87
25661,924,2,924,162,2,0,33.333333333333336,95.65
25662,1944,57,1944,1041,43,14,2.631578947368421,69.29
25663,428652,11,144,39133,6,5,25.0,59.2
25664,307452,20,307452,556,18,2,5.882352941176471,76.54
25665,10272,40,0,1857,32,8,100.0,0.0
25666,372,6,372,68,4,2,25.0,96.25
25667,132,2,132,6,2,0,33.333333333333336,98.0
25668,10884,47,0,1477,37,10,100.0,0.0
25669,648,23,372,296,22,1,4.3478260869565215,0.0
25670,1212,12,1212,41,12,0,7.142857142857143,81.0
25671,41568,25,41568,1588,22,3,6.25,9.56
25672,13476,3,9084,6104,2,1,33.333333333333336,99.12
25673,324,71,324,162,67,4,1.492537313432836,25.69
25674,1500,83,0,400,67,16,100.0,0.0
25675,40812,0,40812,0,0,0,100.0,100.0
25676,4246752,6185,0,1660331,3500,2685,1.0,32.15
25677,1500,15,1500,303,12,3,8.333333333333334,98.79
25678,336,4,336,138,3,1,33.333333333333336,99.91
25679,372,31,372,65,23,8,4.761904761904762,60.9
25680,4399896,11,4399896,35266,10,1,8.333333333333334,40.28
25681,9936888,1257,646608,41162,872,385,1.0,0.0
25682,933372,200,0,8974,127,73,33.333333333333336,0.0
25683,1212,7,1212,1152,5,2,6.25,83.28
25684,336,1,336,168,1,0,50.0,99.85
25685,8903340,1975,261816,67177,619,1356,2.1739130434782608,18.39
25686,32448,153,0,20175,104,49,50.0,0.0
25687,1116,41,1116,129,40,1,3.8461538461538463,73.51
25688,9816,0,9816,0,0,0,50.0,59.29
25689,33288,252,0,6141,152,100,50.0,0.0
25690,11350584,7614,4709682,1419546,4284,3330,1.0,26.55
25691,696,146,696,75,93,53,2.380952380952381,54.6
25692,9876,49,0,1680,43,6,100.0,0.0
25693,5160,70,0,1271,44,26,100.0,0.0
25694,7244772,1128,152064,55129,687,441,1.2658227848101269,0.0
25695,240,7,240,84,7,0,11.11111111111111,93.48
25696,2340,1,2340,216,1,0,100.0,99.85
25697,1596,66,492,143,56,10,1.9230769230769231,88.14
25698,156,2,0,78,1,1,100.0,0.0
25699,54768,185,0,2343,108,77,100.0,0.0
25700,3408,67,0,1301,36,31,100.0,0.0
25701,840,93,840,125,89,4,1.1363636363636365,40.46
25702,1548,54,504,295,49,5,2.083333333333333,0.0
25703,46920,18,46920,573,18,0,6.25,26.22
25704,58620,22,58620,5334,22,0,4.761904761904762,40.96
25705,2514024,199,0,17911,108,91,5.555555555555555,0.0
25706,900,61,900,212,43,18,3.8461538461538463,41.19
25707,8136,154,0,1218,116,38,100.0,0.0
25708,11520084,13690,3435561,2412643,7213,6477,1.0,0.0
25709,1068,2,1068,84,1,1,50.0,74.8
25710,972,32,972,508,32,0,3.0303030303030303,69.37
25711,11479884,3246,23148,905375,1896,1350,1.0,0.0
25712,3432,26,3432,997,24,2,4.0,78.03
25713,14208,1,14208,5628,1,0,14.285714285714286,3.34
25714,39684,16,39684,786,13,3,7.142857142857143,80.86
25715,192,6,96,54,5,1,14.285714285714286,57.74
25716,9694776,2012,2292600,91774,1006,1006,1.0,0.0
25717,1296,2,1296,792,2,0,20.0,93.08
25718,30240,13,852,2479,11,2,8.333333333333334,63.39
25719,312,18,312,158,14,4,7.142857142857143,89.21
25720,11121144,172,0,121408,79,93,6.666666666666667,0.0
25721,853020,14,0,258648,6,8,33.333333333333336,0.0
25722,5148180,320,5148180,19822,130,190,3.225806451612903,73.41
25723,46248,62,0,9002,35,27,4.545454545454546,0.0
25724,9156,8,9156,1939,8,0,11.11111111111111,73.22
25725,12696,11,12696,3712,6,5,33.333333333333336,77.09
25726,57960,116,0,1723,81,35,100.0,0.0
25727,11443548,1825,0,3614710,811,1014,1.0,0.0
25728,11500080,254,2301096,3779743,107,147,1.0,0.0
25729,432,49,432,90,35,14,4.3478260869565215,40.01
25730,540,298,0,206,170,128,1.1235955056179776,0.0
25731,7832532,198,7832532,46439,104,94,4.761904761904762,51.42
25732,14604,12,0,9564,3,9,100.0,100.0
25733,11533380,782,0,2118000,410,372,1.9230769230769231,0.0
25734,312,0,312,0,0,0,100.0,70.0
25735,10952940,1306,0,84576,738,568,1.0,5.0
25736,228,91,180,87,47,44,3.703703703703704,59.83
25737,7998144,113,3999114,1896,57,56,10.0,0.43
25738,2679180,44,2679180,1939,30,14,5.882352941176471,95.1
25739,843048,234,0,43584,134,100,5.2631578947368425,0.0
25740,322560,0,322560,0,0,0,50.0,80.0
25741,11325360,1792,0,1125917,1005,787,1.020408163265306,0.0
25742,290952,104,0,14258,79,25,14.285714285714286,0.0
25743,11402496,1272,946096,1140581,530,742,1.2345679012345678,0.0
25744,752460,700,417027,312005,695,5,2.7777777777777777,98.75
25745,11300748,229,0,125689,143,86,2.9411764705882355,0.0
25746,1848,17,228,597,11,6,100.0,100.0
25747,8536704,1567,1425580,1592381,692,875,1.0,0.0
25748,3756,25,3756,2407,23,2,7.142857142857143,0.0
25749,15012,42,0,3137,29,13,100.0,0.0
25750,10943064,715,0,152158,395,320,1.7543859649122806,0.0
25751,8796276,1092,8796012,148450,510,582,1.0,0.0
25752,10152072,2725,88440,64236,1477,1248,1.0,0.0
25753,1922292,53,1922292,719,20,33,33.333333333333336,23.57
25754,11366124,767,0,92088,420,347,1.0101010101010102,0.0
25755,408,33,408,47,28,5,14.285714285714286,78.11
25756,10907976,1090,0,1076014,544,546,1.0,0.0
25757,9130392,742,8337972,231136,453,289,1.3888888888888888,42.62
25758,192,8,192,12,8,0,10.0,46.53
25759,5652,75,5652,502,57,18,2.0408163265306123,43.57
25760,4164,34,0,616,27,7,100.0,0.0
25761,2473452,25,0,298008,21,4,5.882352941176471,0.0
25762,11295348,257,0,382133,162,95,2.631578947368421,0.0
25763,118536,15,118536,3708,14,1,11.11111111111111,99.87
25764,456,16,456,197,10,6,16.666666666666668,98.45
25765,60528,14,60528,2951,14,0,10.0,70.91
25766,49164,138,0,36063,90,48,50.0,0.0
25767,13584,22,13584,913,20,2,5.882352941176471,78.61
25768,1848,16,1848,534,13,3,25.0,0.0
25769,8700,121,8700,1308,92,29,2.702702702702702,0.0
25770,1980,17,1980,574,16,1,10.0,35.98
25771,15552,131,0,1391,81,50,50.0,0.0
25772,7861200,1,4925856,11376,1,0,100.0,100.0
25773,2706396,76,2706396,17106,51,25,4.545454545454546,95.69
25774,3540,6,3540,220,6,0,14.285714285714286,0.0
25775,21336,45,0,1117,36,9,50.0,0.0
25776,35796,18,0,2618,13,5,100.0,100.0
25777,8964,21,8964,1180,20,1,5.882352941176471,78.21
25778,14796,12,14796,2135,8,4,20.0,25.3
25779,83136,31,83136,2893,28,3,4.0,65.34
25780,88260,95,0,7422,81,14,100.0,0.0
25781,96,9,96,50,5,4,33.333333333333336,60.82
25782,1896,2,1896,120,1,1,50.0,65.05
25783,372,27,372,109,21,6,5.2631578947368425,51.25
25784,67908,61,0,8795,48,13,100.0,0.0
25785,237828,17,0,70083,12,5,20.0,4.76
25786,7128,9,7128,38,9,0,10.0,0.0
25787,9708,129,0,965,97,32,100.0,0.0
25788,2747808,245,2747808,41979,127,118,2.272727272727273,76.07
25789,336,2,336,30,2,0,25.0,86.45
25790,288,42,288,85,23,19,16.666666666666668,62.42
25791,43716,15,0,3050,10,5,100.0,100.0
25792,1896,78,0,214,50,28,100.0,0.0
25793,4320,15,0,647,12,3,100.0,100.0
25794,10480452,188,0,57741,85,103,3.8461538461538463,0.0
25795,17244,43,0,2727,38,5,100.0,0.0
25796,420,2,420,114,1,1,50.0,65.07
25797,4956,10,1092,769,10,0,14.285714285714286,87.47
25798,26928,20,0,2506,16,4,25.0,0.0
25799,11532,185,0,954,125,60,100.0,0.0
25800,2472,294,0,424,183,111,100.0,0.0
25801,984,0,984,0,0,0,50.0,64.0
25802,4704,10,4704,1056,8,2,33.333333333333336,88.74
25803,186024,38,0,8524,28,10,25.0,0.0
25804,2760,16,0,754,13,3,100.0,100.0
25805,49152,397,49152,600,259,138,1.0,9.9
25806,148716,14,148716,560,14,0,6.666666666666667,81.82
25807,3336,2,3336,240,2,0,25.0,76.93
25808,1932,26,0,513,22,4,100.0,100.0
25809,3192,3,3192,616,3,0,20.0,91.19
25810,3888,11,0,367,10,1,50.0,0.0
25811,8901708,4332,297024,184167,2441,1891,1.0,0.0
25812,57300,2,57300,30,1,1,50.0,58.69
25813,2568,41,0,575,29,12,33.333333333333336,0.0
25814,49644,23,0,4127,17,6,100.0,100.0
25815,636,2,636,222,2,0,25.0,9.73
25816,1416,25,0,441,22,3,100.0,100.0
25817,1446096,249,0,26757,138,111,3.0303030303030303,10.0
25818,1572,8,1392,682,6,2,16.666666666666668,95.28
25819,13776,45,13776,1504,38,7,4.0,63.92
25820,1956,3,1956,732,3,0,20.0,89.67
25821,978444,66,0,95007,49,17,2.702702702702702,0.0
25822,47208,0,47208,0,0,0,100.0,100.0
25823,11547696,2972,0,1892459,1649,1323,1.0,0.0
25824,264,1,264,144,1,0,33.333333333333336,79.22
25825,26472,2,26472,504,2,0,33.333333333333336,95.83
25826,192,0,192,0,0,0,12.5,2.81
25827,132,18,132,30,13,5,10.0,70.26
25828,2112,39,0,841,33,6,100.0,0.0
25829,3252,21,0,628,16,5,100.0,100.0
25830,3804,0,3804,0,0,0,100.0,100.0
25831,31236,42,31236,686,40,2,3.0303030303030303,38.22
25832,1224,33,552,243,33,0,3.0303030303030303,73.33
25833,3024,18,3024,230,18,0,5.2631578947368425,75.23
25834,372,1,372,264,1,0,33.333333333333336,72.69
25835,72,3,72,0,3,0,20.0,69.7
25836,8222448,1238,188184,166700,704,534,1.639344262295082,0.0
25837,132,13,132,32,7,6,33.333333333333336,60.56
25838,1260,23,1260,184,16,7,7.6923076923076925,50.68
25839,30336,16,30336,528,15,1,7.142857142857143,13.38
25840,95964,3,95964,72440,3,0,20.0,80.56
25841,2472,3,2472,76,3,0,33.333333333333336,0.0
25842,360,2,360,144,1,1,100.0,100.0
25843,360,21,360,198,18,3,6.25,37.04
25844,172908,330,0,4496,144,186,4.545454545454546,0.0
25845,8424,29,8424,1237,26,3,5.555555555555555,66.37
25846,3372768,42,3372768,66922,17,25,20.0,95.95
25847,312,12,312,179,11,1,9.090909090909092,44.43
25848,2112,18,2112,1961,12,6,9.090909090909092,66.84
25849,852,9,852,380,8,1,16.666666666666668,98.51
25850,156,6,156,0,6,0,12.5,50.05
25851,18684,44,0,1760,37,7,100.0,0.0
25852,39240,24,39240,1234,21,3,6.25,75.64
25853,2196,16,2196,556,15,1,8.333333333333334,81.9
25854,3660,18,0,502,15,3,100.0,100.0
25855,396,9,396,170,9,0,10.0,92.79
25856,2604,2,2604,606,2,0,50.0,16.62
25857,40488,141,40488,2640,100,41,1.851851851851852,2.46
25858,1980,79,1980,498,49,30,3.8461538461538463,73.64
25859,864,20,864,292,19,1,5.555555555555555,49.83
25860,492,17,492,245,13,4,7.6923076923076925,90.49
25861,900,7,900,133,5,2,20.0,85.0
25862,131952,121,0,15567,76,45,5.555555555555555,0.0
25863,1188,1,1188,552,1,0,100.0,100.0
25864,57396,11,57396,769,11,0,8.333333333333334,56.57
25865,40296,2,0,20244,1,1,50.0,0.0
25866,8124,16,8124,7237,14,2,6.666666666666667,84.8
25867,8016,19,8016,342,17,2,8.333333333333334,59.79
25868,3492,23,3492,424,20,3,5.882352941176471,71.1
25869,396,31,396,152,23,8,4.761904761904762,52.62
25870,157212,134,0,3565,87,47,50.0,0.0
25871,2196,42,2196,29,38,4,2.5,88.73
25872,1469100,45,3192,67707,31,14,5.882352941176471,0.0
25873,127728,60,127728,5375,48,12,2.083333333333333,28.95
25874,288,3,288,52,3,0,25.0,69.34
25875,44640,65,44640,729,59,6,2.1739130434782608,39.01
25876,256812,2,256812,24,1,1,50.0,65.05
25877,516,18,516,166,13,5,8.333333333333334,98.59
25878,11592480,8707,977856,1178569,4742,3965,1.0,0.0
25879,11601360,371,0,1709354,206,165,1.96078431372549,2.1
25880,9572304,306,7909920,109848,192,114,3.703703703703704,83.84
25881,2688792,163,2688792,46431,96,67,5.882352941176471,81.74
25882,11457288,4586,0,885726,2618,1968,1.0,0.0
25883,1476,73,1476,178,53,20,2.2222222222222223,65.96
25884,3072,97,0,853,60,37,100.0,0.0
25885,1200,77,0,105,68,9,1.5384615384615383,0.0
25886,15708,85,15708,1147,42,43,3.8461538461538463,59.58
25887,3195696,77,3195696,61124,37,40,11.11111111111111,78.29
25888,492,24,492,238,17,7,8.333333333333334,98.37
25889,1480392,27,0,164573,15,12,50.0,0.0
25890,33264,31,33264,1437,22,9,6.666666666666667,0.25
25891,1031016,6,987534,244550,6,0,14.285714285714286,78.83
25892,8470452,207,0,1007396,131,76,1.2820512820512822,0.0
25893,444,30,444,70,25,5,6.25,33.4
25894,83148,19,83148,733,19,0,5.555555555555555,36.32
25895,10488,13,10488,1132,13,0,8.333333333333334,27.33
25896,108,6,108,54,3,3,50.0,64.35
25897,198972,151,198972,177750,82,69,2.1739130434782608,67.39
25898,1416,2,1416,606,1,1,50.0,99.26
25899,732,12,732,120,11,1,8.333333333333334,87.49
25900,1584,22,1584,41,22,0,4.166666666666667,59.14
25901,698328,273,4032,6767,199,74,1.0,13.5
25902,11342280,747,0,475238,346,401,1.5384615384615383,1.9
25903,2352,9,2352,860,6,3,20.0,94.64
25904,2256,7,2256,418,4,3,50.0,99.24
25905,60312,262,60312,6889,111,151,3.0303030303030303,22.17
25906,2299944,1931,801152,36165,1766,165,1.0,34.72
25907,105744,42,105744,12029,37,5,3.333333333333333,4.45
25908,49944,90,0,14731,42,48,100.0,0.0
25909,10080,20,10080,999,19,1,5.882352941176471,75.3
25910,5263848,276,5263848,9749,108,168,1.8867924528301887,72.98
25911,2292,99,0,484,73,26,100.0,0.0
25912,216,4,216,60,4,0,16.666666666666668,96.0
25913,11608572,329,0,329647,199,130,2.631578947368421,1.0
25914,168,1,168,108,1,0,33.333333333333336,54.75
25915,7818648,111,3909714,175298,71,40,1.9230769230769231,20.52
25916,60,3,60,20,2,1,33.333333333333336,77.5
25917,1572,0,1572,0,0,0,100.0,100.0
25918,396,11,396,124,11,0,8.333333333333334,78.0
25919,11460,27,0,10116,27,0,3.8461538461538463,0.0
25920,1080,3,1080,432,2,1,50.0,99.82
25921,26652,162,0,1787,97,65,50.0,0.0
25922,792,10,792,732,10,0,8.333333333333334,87.08
25923,144,3,144,68,3,0,2.3255813953488373,0.0
25924,336,8,336,19,8,0,10.0,46.51
25925,1008,5,1008,81,3,2,50.0,99.43
25926,9792,259,9792,535,144,115,2.272727272727273,76.05
25927,11522652,2237,4289004,936445,1223,1014,1.0,0.0
25928,456,0,456,0,0,0,50.0,90.0
25929,804,1,804,300,1,0,50.0,99.6
25930,5064,33,5064,1472,23,10,9.090909090909092,90.77
25931,3708,8,3708,708,8,0,12.5,70.14
25932,4853508,506,0,35477,265,241,1.0,2.21
25933,3696,16,0,737,13,3,100.0,0.0
25934,876,22,876,362,16,6,11.11111111111111,89.73
25935,156,6,156,52,4,2,25.0,56.58
25936,4116,16,4116,319,15,1,12.5,35.0
25937,4644,7,0,1674,4,3,50.0,0.0
25938,48960,3,396,16416,3,0,25.0,96.17
25939,3228,43,3228,1157,42,1,2.272727272727273,42.18
25940,35760,11,35760,538,10,1,8.333333333333334,80.66
25941,173832,22,3396,8901,21,1,6.25,0.0
25942,636,0,636,0,0,0,50.0,85.0
25943,26688,24,26688,3944,16,8,9.090909090909092,82.84
25944,4070268,838,2379138,596250,491,347,1.0,0.0
25945,96,34,96,36,31,3,3.4482758620689653,34.0
25946,38844,230,0,24814,133,97,50.0,0.0
25947,168,1,168,0,1,0,33.333333333333336,70.73
25948,696,8,696,273,6,2,25.0,96.11
25949,1332,4,1332,636,4,0,25.0,98.37
25950,2964,38,2430,809,24,14,5.0,62.88
25951,1224,18,0,755,14,4,100.0,0.0
25952,924,197,0,298,143,54,1.0309278350515465,0.0
25953,3804,72,0,921,38,34,100.0,0.0
25954,408,66,408,30,57,9,1.7857142857142858,36.27
25955,2268,15,2268,447,15,0,5.882352941176471,70.25
25956,2148,4,0,1449,2,2,100.0,0.0
25957,13800,103,0,801,70,33,33.333333333333336,0.0
25958,9339564,442,0,298561,231,211,3.4482758620689653,5.0
25959,1068,56,0,276,33,23,50.0,0.0
25960,40932,22,0,2450,14,8,100.0,100.0
25961,192,0,192,0,0,0,100.0,100.0
25962,432,32,432,34,28,4,3.571428571428572,56.38
25963,1488,21,0,470,17,4,100.0,100.0
25964,25296,37,0,2093,33,4,100.0,0.0
25965,2760,23,0,560,19,4,50.0,0.0
25966,263400,1525,69114,11427,1115,410,1.0,0.0
25967,780,34,780,86,30,4,3.571428571428572,66.2
25968,1368,174,1368,309,113,61,1.4285714285714286,13.4
25969,1908,9,1908,1141,7,2,20.0,0.0
25970,4492992,19,4492992,2967,10,9,33.333333333333336,78.75
25971,5377860,134,139608,65229,105,29,1.1904761904761905,24.06
25972,97680,242,0,15082,122,120,100.0,0.0
25973,597252,38,2460,16499,28,10,5.555555555555555,0.0
25974,44736,49,5736,2510,38,11,16.666666666666668,0.0
25975,5892,115,0,584,81,34,100.0,0.0
25976,216,38,216,43,30,8,3.571428571428572,0.0
25977,816,22,816,196,22,0,4.166666666666667,59.87
25978,11399976,765,0,1005938,427,338,1.4705882352941178,5.0
25979,38316,88,0,1529,53,35,50.0,0.0
25980,4380,22,0,691,20,2,100.0,0.0
25981,84,13,84,0,13,0,6.666666666666667,61.5
25982,63588,16,63588,5916,13,3,7.6923076923076925,72.3
25983,29472,145,0,25583,89,56,50.0,0.0
25984,12960,4,96,3276,3,1,25.0,56.88
25985,7818564,187,0,150855,87,100,6.25,0.0
25986,10980432,1559,0,229766,856,703,1.0,0.0
25987,9768996,27,0,362649,23,4,12.5,0.0
25988,7741488,22,4598400,44349,15,7,6.25,22.58
25989,3144,12,2490,1035,6,6,25.0,59.94
25990,64980,27,64980,851,23,4,4.761904761904762,61.44
25991,7931580,574,5162622,70123,307,267,1.818181818181818,82.77
25992,3159288,1087,0,26848,618,469,1.3888888888888888,0.0
25993,9216,34,0,1576,29,5,100.0,0.0
25994,420756,89,0,5527,60,29,100.0,0.0
25995,1836,5,1836,213,4,1,33.333333333333336,85.5
25996,576,3,576,136,2,1,50.0,99.12
25997,38448,28,38448,1099,26,2,5.2631578947368425,73.56
25998,1332,4,1332,681,2,2,33.333333333333336,99.08
25999,16920,13,16920,1725,8,5,12.5,78.62
26000,108,11,108,1,11,0,7.6923076923076925,73.46
26001,71316,19,71316,908,16,3,20.0,43.44
26002,187248,61,187248,16453,59,2,1.6666666666666667,18.52
26003,132,22,132,2,22,0,4.166666666666667,45.85
26004,656244,147,42630,19423,116,31,1.1111111111111112,10.6
26005,12744,22,12744,1648,19,3,7.142857142857143,5.14
26006,144,17,144,6,16,1,5.882352941176471,56.55
26007,11592948,31351,1321696,490538,18241,13110,1.0,0.0
26008,24288,149,0,1696,91,58,33.333333333333336,0.0
26009,77760,41,0,3358,34,7,100.0,0.0
26010,11631060,9058,0,2833785,5136,3922,1.0,9.88
26011,6372,19,6372,453,17,2,5.882352941176471,0.0
26012,1968,28,1968,645,24,4,5.555555555555555,80.3
26013,108,0,108,0,0,0,100.0,100.0
26014,108744,103,108744,336,83,20,1.3888888888888888,17.49
26015,144,4,144,18,4,0,16.666666666666668,72.02
26016,3900,174,0,707,81,93,5.0,0.0
26017,72228,48,0,4241,39,9,100.0,0.0
26018,4704,12,4704,598,12,0,16.666666666666668,34.7
26019,10008564,1225,312,53195,683,542,1.0101010101010102,0.37
26020,84,19,84,7,17,2,5.882352941176471,51.73
26021,7560,23,7560,1115,22,1,5.2631578947368425,92.91
26022,276,11,240,99,6,5,25.0,98.65
26023,1488,185,0,762,140,45,1.0,0.0
26024,264,10,108,64,8,2,14.285714285714286,98.43
26025,12168,23,12168,1927,22,1,4.545454545454546,0.0
26026,30576,22,30576,1321,18,4,7.142857142857143,1.99
26027,369984,8,96,46362,6,2,16.666666666666668,53.67
26028,78480,31,78396,6902,25,6,5.0,68.5
26029,360,61,360,61,59,2,1.6666666666666667,37.51
26030,62952,22,62952,3560,21,1,7.6923076923076925,64.88
26031,1968,68,1968,508,51,17,5.2631578947368425,0.0
26032,20232,2,20232,114,2,0,33.333333333333336,96.12
26033,708,105,708,81,79,26,1.25,34.29
26034,11588256,4177,3725280,806270,2365,1812,1.0,0.0
26035,5488620,23,48372,955856,18,5,8.333333333333334,67.38
26036,108,28,108,16,19,9,8.333333333333334,53.89
26037,8496,16,8496,579,14,2,11.11111111111111,79.98
26038,7108884,59,0,363929,48,11,25.0,0.0
26039,20988,91,0,14475,66,25,50.0,0.0
26040,28692,100,0,2741,80,20,16.666666666666668,0.0
26041,71496,90,0,10858,76,14,50.0,0.0
26042,336,1,336,12,1,0,33.333333333333336,62.45
26043,17316,48,0,2875,40,8,50.0,0.0
26044,20352,25,20352,1093,23,2,5.2631578947368425,74.83
26045,5460,23,5460,986,21,2,5.882352941176471,61.43
26046,4080,14,0,563,11,3,100.0,0.0
26047,6060,22,0,665,19,3,100.0,100.0
26048,77484,25,77484,8985,16,9,8.333333333333334,92.14
26049,11521176,2318,3740280,4737004,1460,858,1.0,0.0
26050,420,8,420,277,6,2,16.666666666666668,0.0
26051,10931100,364,0,555741,195,169,2.5641025641025643,0.0
26052,1452,1,1452,636,1,0,100.0,98.54
26053,264,23,264,66,17,6,7.6923076923076925,57.94
26054,428736,49,428736,77868,44,5,2.702702702702702,41.73
26055,9612,17,9612,2797,12,5,12.5,72.63
26056,132,5,132,72,3,2,50.0,98.91
26057,6540,46,0,1455,39,7,100.0,0.0
26058,19680,29,19680,1118,26,3,4.761904761904762,69.48
26059,324,16,324,132,16,0,5.555555555555555,84.86
26060,12180,40,0,1887,32,8,100.0,0.0
26061,26016,78,0,1023,47,31,100.0,0.0
26062,33228,33,168,1041,25,8,5.0,47.01
26063,3840,52,0,1685,43,9,100.0,0.0
26064,175788,1804,39537,19273,1408,396,1.0,0.0
26065,108,0,108,0,0,0,50.0,68.88
26066,9516,26,9336,2212,20,6,100.0,0.0
26067,6024,35,0,1455,30,5,100.0,0.0
26068,648,184,648,252,121,63,1.0,30.92
26069,924,12,924,148,12,0,8.333333333333334,86.43
26070,89952,51,1284,2371,22,29,7.6923076923076925,65.27
26071,6768,17,0,773,14,3,100.0,0.0
26072,6708,24,0,1516,21,3,50.0,0.0
26073,384,69,384,210,43,26,3.225806451612903,63.59
26074,4064448,38,4040058,646614,18,20,20.0,0.0
26075,612144,46,0,18241,38,8,33.333333333333336,86.99
26076,40128,34,40128,1750,28,6,5.2631578947368425,59.73
26077,72744,3,72744,184,3,0,33.333333333333336,92.7
26078,1104,10,288,374,7,3,20.0,79.2
26079,10127280,957,7918344,81539,543,414,1.694915254237288,0.0
26080,11232,30,11232,873,29,1,4.761904761904762,37.32
26081,20808,2,20808,162,2,0,50.0,98.3
26082,36,0,36,0,0,0,50.0,64.0
26083,16896,11,16896,585,10,1,12.5,62.2
26084,10465068,931,1130948,1622393,526,405,1.0,0.0
26085,25668,15,25668,2028,15,0,9.090909090909092,71.47
26086,20592,20,20592,529,18,2,7.142857142857143,54.41
26087,276,46,276,22,36,10,3.0303030303030303,73.76
26088,156,2,156,30,1,1,50.0,60.23
26089,2964,18,2964,527,17,1,7.6923076923076925,94.11
26090,8364,16,8364,397,15,1,8.333333333333334,78.41
26091,984,4,984,420,4,0,20.0,91.29
26092,3883500,148,3883500,12298,69,79,6.25,80.16
26093,3984,12,120,376,6,6,33.333333333333336,56.03
26094,444,51,84,27,42,9,2.631578947368421,0.0
26095,63708,119,58192,16692,58,61,8.333333333333334,10.0
26096,7344,34,0,1313,28,6,100.0,0.0
26097,1800,19,1800,650,16,3,8.333333333333334,55.26
26098,42348,0,42348,0,0,0,100.0,100.0
26099,2124,6,2124,954,6,0,20.0,18.18
26100,240,59,168,93,55,4,1.7543859649122806,30.75
26101,4644,33,4644,476,26,7,5.555555555555555,54.88
26102,84,0,84,0,0,0,100.0,100.0
26103,42960,101,0,1284,88,13,100.0,0.0
26104,1356,3,1356,468,3,0,33.333333333333336,0.0
26105,350196,2268,97452,21549,1803,465,1.0,0.0
26106,780,145,780,170,118,27,1.0309278350515465,3.17
26107,1932,2,216,1464,1,1,100.0,100.0
26108,1476,13,1476,808,7,6,33.333333333333336,96.26
26109,300,11,300,34,8,3,12.5,59.26
26110,208944,194,37476,8299,137,57,1.3888888888888888,4.84
26111,528,50,528,141,47,3,2.7777777777777777,62.12
26112,600,5,600,192,4,1,25.0,99.36
26113,1152,1,1152,528,1,0,100.0,97.24
26114,228,8,228,40,4,4,50.0,63.33
26115,96,6,96,26,4,2,25.0,86.66
26116,7836,16,0,780,13,3,100.0,0.0
26117,588,5,588,175,5,0,33.333333333333336,53.9
26118,7869432,858,7860600,36996,452,406,1.3888888888888888,0.0
26119,1548,32,1548,940,26,6,3.703703703703704,70.99
26120,49968,208,0,3747,120,88,100.0,0.0
26121,44592,57,0,2963,38,19,100.0,100.0
26122,684,73,684,234,55,18,2.9411764705882355,40.47
26123,10716,11,10716,516,10,1,11.11111111111111,72.8
26124,21312,43,0,2607,34,9,100.0,0.0
26125,11448,63,11448,1382,29,34,7.6923076923076925,74.02
26126,600,8,600,237,8,0,10.0,85.7
26127,7644,31,7644,6849,19,12,6.666666666666667,89.55
26128,37416,148,37416,1854,110,38,1.0869565217391304,23.08
26129,1056,28,1056,543,25,3,4.3478260869565215,26.49
26130,192,25,192,44,19,6,5.555555555555555,62.95
26131,11460,37,0,1375,32,5,100.0,0.0
26132,211524,70,211524,1252,50,20,2.5641025641025643,40.03
26133,10923756,8325,1082256,4032647,4900,3425,1.0,0.0
26134,144,14,144,27,10,4,12.5,53.81
26135,1908,26,660,388,19,7,5.882352941176471,0.0
26136,2280,10,2280,571,9,1,14.285714285714286,87.75
26137,36,6,36,2,6,0,12.5,81.91
26138,10476,26,4092,1893,21,5,6.666666666666667,62.16
26139,324,80,324,89,72,8,1.4705882352941178,40.05
26140,7068,226,0,2986,153,73,100.0,0.0
26141,27408,265,0,10693,159,106,50.0,0.0
26142,86460,25,86460,492,17,8,16.666666666666668,94.07
26143,276,1,276,60,1,0,33.333333333333336,99.02
26144,9385260,420,0,114977,206,214,2.631578947368421,0.0
26145,11280924,894,0,950318,421,473,1.0,0.0
26146,924,7,924,399,5,2,33.333333333333336,93.18
26147,9414348,256,0,41507,127,129,3.225806451612903,4.0
26148,888,2,888,150,1,1,50.0,60.23
26149,11042688,1160,0,50394,651,509,1.1494252873563218,0.0
26150,13116,114,312,557,74,40,1.7241379310344829,42.42
26151,2988,9,2988,708,9,0,12.5,69.21
26152,9415344,249,0,109080,127,122,4.761904761904762,0.0
26153,348,44,348,123,40,4,2.5,63.54
26154,30264,14,30264,1398,14,0,4.3478260869565215,2.4
26155,288,7,288,51,5,2,25.0,94.05
26156,2536440,98,0,53756,40,58,7.6923076923076925,0.0
26157,4800,1,4800,4440,1,0,33.333333333333336,80.2
26158,2536752,74,0,69465,34,40,7.6923076923076925,0.0
26159,1279296,200,0,7155,96,104,5.555555555555555,0.0
26160,11531280,1199,0,33492,673,526,1.1904761904761905,5.0
26161,3228,21,3228,977,20,1,6.25,62.37
26162,3528,88,0,954,71,17,100.0,0.0
26163,768,13,516,258,11,2,11.11111111111111,94.39
26164,121248,22,0,5940,17,5,100.0,100.0
26165,5271912,19,84408,305392,18,1,6.25,93.58
26166,65568,22,65568,7844,12,10,11.11111111111111,85.57
26167,10204752,948,0,346505,402,546,1.5151515151515151,0.76
26168,4440,3,4440,104,3,0,25.0,49.01
26169,312,14,144,28,12,2,8.333333333333334,64.45
26170,2508,4,2328,1107,4,0,25.0,80.37
26171,2846184,158,2846172,18507,111,47,1.4492753623188406,0.0
26172,3432,24,3432,1193,23,1,6.25,60.6
26173,192,2,192,72,2,0,25.0,60.43
26174,36060,25,0,2037,20,5,50.0,0.0
26175,9186960,76,0,781947,50,26,1.6666666666666667,0.0
26176,44868,108,0,4015,86,22,25.0,0.0
26177,2544468,102,0,54359,69,33,3.4482758620689653,0.0
26178,168,19,168,43,13,6,8.333333333333334,48.22
26179,62556,294,0,4576,170,124,20.0,0.0
26180,11681232,477,5978220,3754093,287,190,2.4390243902439024,0.02
26181,1512,30,0,326,24,6,100.0,0.0
26182,2772,22,2772,1807,22,0,4.3478260869565215,83.75
26183,22860,35,0,2366,31,4,100.0,0.0
26184,780,11,768,226,6,5,25.0,42.67
26185,269040,121,0,3377,83,38,100.0,0.0
26186,75300,189,0,6978,118,71,33.333333333333336,0.0
26187,11637528,1157,1519160,932695,700,457,4.166666666666667,0.0
26188,7931748,294,7931748,87686,147,147,2.702702702702702,75.78
26189,5384880,653,5384796,86530,326,327,1.851851851851852,41.18
26190,43932,303,0,21557,173,130,50.0,0.0
26191,228,32,228,28,24,8,5.555555555555555,53.6
26192,420,10,420,234,6,4,16.666666666666668,82.03
26193,144,0,144,0,0,0,50.0,80.0
26194,9888,7,9888,356,7,0,16.666666666666668,77.5
26195,8508,21,8508,883,19,2,5.882352941176471,74.22
26196,6732,16,6732,435,13,3,10.0,66.88
26197,36120,14,36120,534,14,0,7.6923076923076925,63.01
26198,200376,9,11316,44676,5,4,20.0,46.49
26199,264,1,264,24,1,0,33.333333333333336,71.43
26200,9792,105,0,2457,82,23,25.0,0.0
26201,11623968,222,0,424032,129,93,2.857142857142857,0.0
26202,612,7,612,222,6,1,10.0,83.84
26203,240,31,240,22,28,3,3.703703703703704,40.74
26204,142824,73,0,13592,54,19,3.225806451612903,0.0
26205,646548,24,646548,436,18,6,6.25,97.09
26206,11988,53,0,724,35,18,100.0,0.0
26207,11227800,1134,0,318799,623,511,1.0526315789473684,0.0
26208,144,45,144,30,39,6,2.5641025641025643,31.25
26209,5916,22,5916,994,22,0,6.25,60.9
26210,43932,58,43932,2808,56,2,1.7857142857142858,17.31
26211,64404,27,64404,4441,20,7,6.666666666666667,0.88
26212,1134396,124,1134396,529,84,40,1.5384615384615383,25.12
26213,7572,11,7572,1528,11,0,10.0,69.35
26214,74472,12,74472,439,10,2,14.285714285714286,60.27
26215,4188,22,4188,662,18,4,9.090909090909092,70.12
26216,11784,61,0,1439,44,17,100.0,0.0
26217,73968,57,0,2344,48,9,100.0,0.0
26218,12444,33,0,1699,28,5,100.0,0.0
26219,1524,17,1524,827,16,1,7.142857142857143,65.18
26220,11988,60,0,2807,50,10,100.0,0.0
26221,38268,0,38268,0,0,0,100.0,100.0
26222,5266668,14,5266668,230,9,5,16.666666666666668,99.48
26223,1816008,48,927834,431974,48,0,2.702702702702702,58.78
26224,8964,4,8964,621,4,0,16.666666666666668,98.81
26225,11728764,11932,0,1026450,6971,4961,1.0,0.0
26226,5460,12,5460,500,11,1,14.285714285714286,77.74
26227,337080,49,337080,14975,23,26,2.0,0.0
26228,1224,6,1224,226,6,0,9.090909090909092,80.17
26229,65364,38,65364,7140,21,17,10.0,72.63
26230,5268,13,5268,874,13,0,10.0,0.0
26231,8304,4,8304,8253,2,2,33.333333333333336,64.35
26232,105840,28,105840,246,25,3,3.703703703703704,42.23
26233,7644,91,7644,230,75,16,1.492537313432836,21.08
26234,7272,16,7272,623,15,1,8.333333333333334,30.93
26235,41484,27,20292,2542,25,2,4.761904761904762,71.85
26236,4248,33,4248,1368,29,4,5.555555555555555,63.98
26237,19800,113,0,2785,87,26,25.0,0.0
26238,7865316,390,7865316,1994,224,166,1.0,73.2
26239,2184,14,0,754,10,4,100.0,0.0
26240,9000,31,0,1508,25,6,100.0,0.0
26241,14868,18,14868,829,17,1,7.142857142857143,82.74
26242,540,12,540,216,10,2,14.285714285714286,0.0
26243,6336,22,6336,874,20,2,5.882352941176471,64.52
26244,1589532,72,0,460027,38,34,5.555555555555555,0.0
26245,25512,155,0,14867,95,60,50.0,0.0
26246,13152,40,0,1269,34,6,100.0,0.0
26247,108084,8,108084,35436,5,3,33.333333333333336,4.17
26248,2628,17,2628,40,17,0,5.555555555555555,0.0
26249,3684,19,0,717,16,3,100.0,0.0
26250,144,2,144,30,1,1,50.0,63.42
26251,9875712,521,0,162535,275,246,3.0303030303030303,0.0
26252,6648,165,6648,312,116,49,1.2820512820512822,26.79
26253,6096,17,6096,500,15,2,7.142857142857143,59.74
26254,20868,1,20868,972,1,0,50.0,91.84
26255,132,5,132,72,3,2,50.0,99.93
26256,648252,1497,648252,422778,1226,271,1.0,62.86
26257,168,23,168,15,19,4,5.882352941176471,48.04
26258,701316,25,529998,30966,22,3,5.0,61.01
26259,1248,23,0,378,18,5,100.0,0.0
26260,5160,21,5160,681,19,2,7.142857142857143,92.96
26261,10269888,993,0,38445,550,443,1.1363636363636365,4.75
26262,5282352,25,5282352,2347,13,12,33.333333333333336,99.65
26263,336,22,336,12,22,0,4.166666666666667,42.29
26264,1464,24,0,372,20,4,50.0,0.0
26265,1045176,1112,0,9593,602,510,1.3333333333333333,4.0
26266,13140,97,13140,246,43,54,5.555555555555555,78.12
26267,2342568,246,0,21226,121,125,6.666666666666667,0.0
26268,324,21,144,76,13,8,14.285714285714286,55.86
26269,156,3,0,124,2,1,50.0,0.0
26270,11442588,5692,0,135343,3242,2450,1.0,0.0
26271,36048,60,1008,1249,46,14,2.380952380952381,48.55
26272,4836,31,0,1072,25,6,100.0,0.0
26273,852,9,852,270,9,0,11.11111111111111,84.16
26274,2484,12,2484,400,11,1,10.0,47.91
26275,3216,18,0,480,15,3,100.0,0.0
26276,6756,49,0,1825,38,11,100.0,0.0
26277,12000,85,0,2149,72,13,100.0,0.0
26278,2616,21,2616,856,20,1,6.25,93.4
26279,9983016,36,9983016,296899,23,13,5.0,76.76
26280,1308,19,0,415,15,4,100.0,0.0
26281,1164,21,1164,494,16,5,14.285714285714286,94.89
26282,3048,1,3048,1392,1,0,100.0,100.0
26283,6636,37,0,1105,29,8,100.0,0.0
26284,4800,21,4800,617,20,1,7.142857142857143,57.43
26285,3756,23,0,742,16,7,100.0,100.0
26286,13020,116,0,2976,92,24,25.0,0.0
26287,528,34,528,232,25,9,5.0,75.36
26288,1404,29,360,199,15,14,11.11111111111111,85.85
26289,1464,31,0,442,25,6,100.0,0.0
26290,3216,3,3216,936,2,1,100.0,100.0
26291,468,38,468,177,37,1,2.7777777777777777,65.66
26292,9888,23,9888,612,21,2,7.6923076923076925,36.36
26293,11665656,1286,0,213704,675,611,1.0,0.0
26294,1716,6,1716,758,4,2,20.0,96.52
26295,329796,18,329796,110870,16,2,100.0,99.99
26296,1132716,23,1132716,11833,19,4,7.142857142857143,57.11
26297,3864,33,3864,891,30,3,5.2631578947368425,45.35
26298,81756,13,81756,330,12,1,11.11111111111111,73.6
26299,3036,6,3036,732,6,0,16.666666666666668,0.0
26300,6144,45,0,1193,35,10,100.0,0.0
26301,1608,15,1608,480,15,0,7.142857142857143,83.99
26302,3048,70,0,971,59,11,33.333333333333336,87.0
26303,8496,38,8496,1345,34,4,7.142857142857143,45.48
26304,600,28,540,198,28,0,3.703703703703704,67.19
26305,1860,4,1860,504,3,1,20.0,92.15
26306,4668,34,4668,1002,30,4,5.555555555555555,32.14
26307,11688,38,11688,93,28,10,4.0,68.8
26308,2052,17,2052,693,16,1,7.6923076923076925,50.65
26309,1668,7,1668,474,6,1,20.0,19.12
26310,2628,17,2448,615,15,2,7.6923076923076925,59.58
26311,29148,14,29148,548,13,1,10.0,34.25
26312,3324,29,3324,1038,27,2,8.333333333333334,58.95
26313,120,4,120,27,3,1,33.333333333333336,96.31
26314,288,66,288,68,54,12,2.0,58.68
26315,2316,6,2316,692,4,2,33.333333333333336,99.77
26316,732,92,552,183,55,37,4.0,67.32
26317,2786712,340,2786712,234756,134,206,1.0,76.81
26318,2460,27,2460,606,25,2,6.25,53.38
26319,6248628,1482,97482,21597,1122,360,1.0,0.0
26320,468,7,468,308,7,0,11.11111111111111,83.95
26321,182748,16,0,13324,9,7,100.0,100.0
26322,87024,91,348,1051,83,8,1.36986301369863,30.25
26323,192,10,192,51,8,2,12.5,53.56
26324,348,42,348,17,42,0,2.272727272727273,59.87
26325,3552,16,3552,801,14,2,9.090909090909092,65.37
26326,11964,48,0,1772,41,7,100.0,0.0
26327,176976,5,176976,158006,3,2,12.5,9.94
26328,672,43,672,12,43,0,2.2222222222222223,57.8
26329,32796,83,0,868,58,25,50.0,0.0
26330,89184,73,0,1394,54,19,100.0,100.0
26331,19608,87,0,990,58,29,100.0,0.0
26332,63960,5,63960,532,2,3,33.333333333333336,0.0
26333,276,6,276,70,4,2,25.0,89.04
26334,298908,83,298908,10865,66,17,1.6129032258064515,12.88
26335,3732,20,0,476,16,4,100.0,0.0
26336,8235264,84,0,1868889,48,36,1.0,0.59
26337,11102880,521,0,1907396,248,273,1.0,1.86
26338,36780,184,0,2198,130,54,50.0,0.0
26339,4536,29,4536,1672,26,3,6.25,63.12
26340,384,82,384,132,39,43,7.142857142857143,82.37
26341,468,10,468,132,7,3,16.666666666666668,84.09
26342,71280,147,0,3204,113,34,100.0,0.0
26343,103476,13,52914,604,11,2,9.090909090909092,94.34
26344,24372,314,0,7500,172,142,50.0,0.0
26345,900,15,900,134,13,2,7.142857142857143,68.88
26346,9348,25,0,1624,21,4,100.0,0.0
26347,98328,381,0,11962,186,195,5.0,0.0
26348,696,227,672,219,124,103,2.7777777777777777,52.03
26349,2304,43,0,422,39,4,100.0,0.0
26350,6192,55,0,2110,33,22,100.0,0.0
26351,7512,25,7512,1363,22,3,7.142857142857143,57.1
26352,78876,17,0,5141,12,5,100.0,100.0
26353,180,6,180,48,4,2,25.0,64.3
26354,600,47,600,41,36,11,6.25,56.74
26355,8256,1,8256,480,1,0,50.0,96.2
26356,612,39,612,12,39,0,2.4390243902439024,61.43
26357,48972,50,48972,2674,42,8,2.5,35.27
26358,10018836,78,5612376,3438,56,22,1.818181818181818,0.32
26359,3636,27,2724,614,27,0,4.166666666666667,64.24
26360,48492,87,35196,717,73,14,1.6666666666666667,24.06
26361,5381760,1522,5381760,70063,785,737,1.0,85.36
26362,240,0,240,0,0,0,50.0,98.0
26363,1212,4,204,330,4,0,20.0,94.15
26364,2124,38,0,1247,35,3,100.0,0.0
26365,50364,197,0,2508,137,60,25.0,0.0
26366,83124,8,0,10795,6,2,100.0,100.0
26367,10746336,5347,0,701047,3032,2315,1.0,4.9
26368,11787864,18391,0,2943411,10311,8080,1.0,0.0
26369,624,40,0,150,24,16,50.0,0.0
26370,14916,75,0,834,53,22,100.0,0.0
26371,53232,125,53232,149,101,24,1.1904761904761905,22.33
26372,3852,38,3852,486,27,11,5.2631578947368425,66.21
26373,8158860,299,8081739,25906,117,182,3.333333333333333,82.18
26374,193164,23,0,11286,18,5,33.333333333333336,0.0
26375,792,12,780,383,9,3,11.11111111111111,44.8
26376,2376,69,2376,1307,28,41,5.2631578947368425,27.55
26377,1536,51,0,419,45,6,100.0,0.0
26378,42228,28,0,1956,23,5,100.0,0.0
26379,91776,32,0,4636,24,8,50.0,0.0
26380,368580,545,0,60595,248,297,6.25,0.0
26381,4152,56,0,1860,36,20,100.0,0.0
26382,99636,134,9276,7215,106,28,16.666666666666668,0.0
26383,1326324,160,138048,33383,126,34,1.0,19.3
26384,55368,183,0,4185,120,63,50.0,0.0
26385,60720,142,60720,109,96,46,1.4285714285714286,17.75
26386,7897776,387,7897776,3538,175,212,2.5,82.89
26387,10620,10,10620,2679,7,3,25.0,0.0
26388,11707596,1413,0,1822064,682,731,1.0,0.04
26389,1940388,193,1940244,483528,159,34,1.0,23.03
26390,4584,30,0,745,25,5,33.333333333333336,0.0
26391,19128,38,0,1669,33,5,100.0,0.0
26392,76776,54,76776,2576,50,4,2.0408163265306123,21.31
26393,36048,25,36048,1042,23,2,5.882352941176471,51.68
26394,3274800,57,0,659261,35,22,14.285714285714286,56.5
26395,83448,24,14664,4331,21,3,5.2631578947368425,71.54
26396,2851824,7,2851824,5638,4,3,20.0,97.92
26397,11652,59,0,680,43,16,100.0,0.0
26398,384,9,120,86,5,4,50.0,77.12
26399,5228448,12,5228448,176,8,4,16.666666666666668,94.82
26400,7596,4,7596,1734,4,0,25.0,99.36
26401,432,48,432,55,48,0,2.0408163265306123,41.16
26402,17916,19,17916,1063,19,0,6.25,64.9
26403,11663928,1296,5851590,1851011,728,568,1.0,0.0
26404,71892,127,71892,4090,96,31,1.162790697674419,21.63
26405,364560,155,0,5289,79,76,5.555555555555555,0.0
26406,5388,3,5388,348,3,0,100.0,0.0
26407,1332,6,0,684,2,4,25.0,0.0
26408,10363584,2829,146676,174059,1603,1226,1.0,0.0
26409,190992,9,190992,20784,6,3,25.0,98.13
26410,13872,11,13872,5374,4,7,14.285714285714286,69.29
26411,3107292,36,0,87962,31,5,50.0,0.0
26412,2643624,271,2643624,2234,134,137,5.555555555555555,84.39
26413,67128,48,67128,7775,36,12,5.882352941176471,0.33
26414,7760820,732,0,1217432,395,337,1.0638297872340423,0.0
26415,29484,226,0,10390,135,91,50.0,0.0
26416,818364,18,0,46778,6,12,16.666666666666668,0.13
26417,480,0,480,0,0,0,100.0,0.0
26418,8124,21,8124,1653,20,1,7.142857142857143,74.72
26419,6720,20,6720,970,19,1,6.25,65.83
26420,184704,124,184704,21656,84,40,2.9411764705882355,42.15
26421,363264,47,0,9905,32,15,100.0,0.0
26422,20316,77,0,714,56,21,100.0,0.0
26423,14436,85,0,772,58,27,25.0,0.0
26424,15888,5,15888,1960,4,1,33.333333333333336,0.0
26425,11821116,29681,0,5678142,16619,13062,1.0,0.0
26426,42084,167,0,10534,101,66,100.0,0.0
26427,129204,36,129204,450,34,2,3.703703703703704,57.82
26428,11813736,1277,0,4045652,769,508,1.0,0.0
26429,884820,40,0,24018,36,4,100.0,0.0
26430,36732,148,0,1169,84,64,33.333333333333336,0.0
26431,9312,3,9312,3092,2,1,50.0,98.96
26432,7164,20,7164,730,19,1,6.666666666666667,64.84
26433,29160,107,29160,3931,84,23,14.285714285714286,0.0
26434,12744,24,12744,1344,22,2,5.882352941176471,75.8
26435,10836,25,10836,376,20,5,5.0,36.31
26436,61944,105,61944,1392,71,34,4.166666666666667,77.36
26437,2662944,67,0,158182,29,38,7.6923076923076925,0.0
26438,1508328,675,710146,166326,592,83,1.0,2.98
26439,8448,37,0,1323,32,5,100.0,0.0
26440,17520,101,17520,463,88,13,2.857142857142857,70.7
26441,49080,300,0,12301,170,130,50.0,0.0
26442,1608,7,0,798,5,2,50.0,99.99
26443,864,18,864,276,16,2,7.142857142857143,69.49
26444,26520,14,0,2589,11,3,100.0,0.0
26445,24156,23,0,1575,20,3,100.0,0.0
26446,3360,21,3360,693,20,1,5.2631578947368425,66.71
26447,18696,18,18696,968,17,1,7.142857142857143,60.73
26448,1080,0,1080,0,0,0,50.0,67.24
26449,1272,2,1272,1200,0,2,100.0,100.0
26450,363624,74,0,11386,51,23,100.0,0.0
26451,732,7,0,224,4,3,25.0,0.0
26452,1348896,26,163464,131812,17,9,5.555555555555555,67.03
26453,4884,38,0,1197,33,5,100.0,0.0
26454,13020,15,13020,1420,10,5,20.0,83.27
26455,96708,83,96708,128,61,22,2.0408163265306123,36.42
26456,69576,23,69576,1581,22,1,11.11111111111111,62.59
26457,998340,1222,255144,63518,977,245,1.0,18.38
26458,70332,16,70332,2927,14,2,14.285714285714286,36.35
26459,95724,83,95724,111,55,28,2.3255813953488373,27.97
26460,276000,1077,276000,188534,864,213,1.0,38.61
26461,9410076,34,0,821344,29,5,50.0,0.0
26462,449124,111,0,17084,93,18,50.0,0.0
26463,99852,32,99852,10620,27,5,4.3478260869565215,32.93
26464,347820,19,347820,242,8,11,20.0,52.61
26465,8880,21,8880,1001,18,3,7.142857142857143,95.03
26466,5676,5,5676,1656,4,1,16.666666666666668,81.75
26467,11339028,1973,168,176965,1103,870,1.0,0.13
26468,11664,65,11664,540,54,11,3.571428571428572,71.93
26469,216,0,216,0,0,0,50.0,64.0
26470,43008,42,0,2968,34,8,100.0,0.0
26471,21048,131,0,3889,103,28,25.0,0.0
26472,3708,22,3708,1078,19,3,8.333333333333334,58.45
26473,2424,3,0,932,3,0,20.0,0.0
26474,984,18,984,154,16,2,5.882352941176471,71.89
26475,56688,8,56688,78,7,1,12.5,66.56
26476,14496,27,14496,660,22,5,7.142857142857143,55.21
26477,5946372,237,896688,287577,183,54,1.0,20.87
26478,7548,36,0,1584,31,5,100.0,0.0
26479,452124,110,0,139575,69,41,3.703703703703704,0.0
26480,303708,20,303708,54486,12,8,33.333333333333336,0.0
26481,4644,33,4644,1708,29,4,5.2631578947368425,48.95
26482,159744,52,159744,1780,49,3,2.5,38.08
26483,1992,60,0,716,46,14,33.333333333333336,96.9
26484,3072,31,0,1028,28,3,100.0,0.0
26485,2856,21,2856,817,20,1,7.6923076923076925,79.82
26486,14796,13,14796,882,12,1,16.666666666666668,56.1
26487,2508,6,2508,550,5,1,25.0,20.38
26488,15516,2,15516,894,2,0,25.0,97.03
26489,6528,29,6528,585,26,3,6.666666666666667,21.07
26490,363012,44,0,14837,27,17,100.0,0.0
26491,3504,14,3504,206,12,2,10.0,78.78
26492,4416,31,0,915,27,4,100.0,0.0
26493,8712,28,3180,1368,23,5,4.545454545454546,59.89
26494,4632,3,4632,1608,2,1,33.333333333333336,69.36
26495,1596,3,1596,648,3,0,33.333333333333336,22.17
26496,432,20,432,210,18,2,6.25,61.49
26497,228,6,228,46,3,3,50.0,77.84
26498,40800,86,40800,27,84,2,2.2222222222222223,60.32
26499,1122108,17,0,66468,13,4,50.0,0.0
26500,2004,23,2004,473,21,2,7.142857142857143,57.52
26501,38112,152,0,1427,102,50,100.0,0.0
26502,1140,40,600,408,33,7,4.3478260869565215,0.0
26503,1632,3,1632,768,3,0,33.333333333333336,24.66
26504,1692,0,1692,0,0,0,50.0,64.0
26505,150984,36,0,6313,29,7,100.0,100.0
26506,114312,26,114312,151,26,0,3.703703703703704,94.16
26507,10802148,68,10802148,18517,27,41,3.703703703703704,67.55
26508,7728,11,7728,577,11,0,16.666666666666668,34.71
26509,732,52,732,36,52,0,1.851851851851852,45.18
26510,4458336,7,4458336,140425,5,2,20.0,4.15
26511,37056,151,0,2023,98,53,33.333333333333336,0.0
26512,11392848,362,0,1300357,234,128,1.639344262295082,0.0
26513,3624,17,3624,586,16,1,8.333333333333334,66.68
26514,3528,0,3528,0,0,0,50.0,65.61
26515,4296,41,0,1286,35,6,100.0,0.0
26516,59868,147,59868,3874,114,33,1.5384615384615383,1.21
26517,5668260,36,0,473173,30,6,50.0,0.0
26518,0,0,0,0,0,0,33.333333333333336,5.0
26519,1188,69,1188,21,51,18,2.272727272727273,41.09
26520,2748,36,1500,185,28,8,3.703703703703704,50.17
26521,2436,22,2436,879,20,2,7.6923076923076925,64.43
26522,44064,106,0,2067,84,22,50.0,0.0
26523,16008,0,16008,0,0,0,100.0,0.0
26524,3516,0,3516,0,0,0,50.0,81.0
26525,480,20,480,90,14,6,8.333333333333334,90.47
26526,11501148,1123,8168472,79554,685,438,1.162790697674419,68.47
26527,132,14,132,44,8,6,20.0,54.71
26528,2112,20,2112,738,19,1,7.6923076923076925,66.98
26529,636,15,636,96,13,2,7.6923076923076925,82.34
26530,1092,25,1092,168,21,4,5.2631578947368425,44.95
26531,9516,5,9516,8556,5,0,14.285714285714286,97.49
26532,58344,1,58344,2268,1,0,50.0,95.47
26533,6960,15,6960,507,14,1,20.0,71.73
26534,10129704,527,0,198610,258,269,1.408450704225352,0.98
26535,3919488,9,3919488,524618,6,3,14.285714285714286,0.0
26536,2904,25,2904,920,24,1,6.666666666666667,58.34
26537,71100,33,0,2795,28,5,25.0,0.0
26538,21324,6,21324,5190,5,1,16.666666666666668,0.0
26539,336,11,336,146,10,1,10.0,52.3
26540,132,4,132,45,4,0,16.666666666666668,58.53
26541,9672,4,9672,54,3,1,25.0,65.22
26542,35100,123,0,11709,69,54,50.0,0.0
26543,55440,44,0,2207,29,15,100.0,0.0
26544,348,80,300,175,76,4,3.571428571428572,51.58
26545,236196,40,0,28190,31,9,50.0,0.0
26546,336,11,336,290,8,3,20.0,92.82
26547,624,0,624,0,0,0,50.0,64.0
26548,89892,0,89892,0,0,0,100.0,100.0
26549,1104,46,0,454,40,6,16.666666666666668,0.0
26550,168,34,168,22,34,0,10.0,81.05
26551,108,2,108,12,1,1,50.0,66.67
26552,8378124,356,8378124,69471,201,155,4.166666666666667,89.22
26553,4596,25,0,474,22,3,25.0,0.0
26554,3804,29,3804,971,26,3,6.25,56.83
26555,7632,6,7632,890,6,0,12.5,89.98
26556,2018112,43,2018112,30235,26,17,14.285714285714286,99.68
26557,864,18,0,216,16,2,100.0,0.0
26558,51936,122,51936,254,89,33,1.5151515151515151,35.73
26559,139212,88,139212,392,75,13,1.4285714285714286,16.76
26560,984,2,984,534,2,0,25.0,76.06
26561,11789904,153,1039932,2933913,97,56,2.4390243902439024,0.0
26562,137376,135,137376,197,77,58,2.272727272727273,48.34
26563,1128,81,300,95,49,32,14.285714285714286,86.01
26564,11507052,28043,1703300,2259061,16073,11970,1.0,0.0
26565,130080,170,0,3279,101,69,4.0,0.0
26566,138888,188,138888,924,125,63,1.1235955056179776,20.57
26567,250344,62,250344,45514,42,20,5.0,42.74
26568,34152,28,5268,2326,25,3,6.25,64.26
26569,6096,24,6096,1068,23,1,4.545454545454546,0.0
26570,8327064,121,0,137753,106,15,1.0,0.0
26571,4728,41,0,1408,28,13,100.0,0.0
26572,5736,148,0,699,97,51,100.0,0.0
26573,3600,2,3600,432,2,0,50.0,0.0
26574,48144,274,0,11122,161,113,50.0,0.0
26575,1032,70,1032,448,50,20,5.0,55.02
26576,2208,47,2208,1050,42,5,4.3478260869565215,0.0
26577,10511484,1580,35088,35310,884,696,1.0,0.0
26578,4957416,599,0,231246,296,303,1.0,0.0
26579,11093700,46,0,1994794,39,7,25.0,0.0
26580,5892,26,5892,1026,24,2,6.25,56.92
26581,17376,23,0,1619,20,3,100.0,0.0
26582,2760,25,0,742,21,4,100.0,0.0
26583,132,3,132,0,3,0,20.0,57.65
26584,7596,3,7596,2860,3,0,25.0,97.85
26585,45984,63,168,1573,37,26,3.8461538461538463,0.0
26586,68364,71,68364,5937,68,3,1.4705882352941178,16.4
26587,2820216,604,2820216,16703,361,243,1.0,37.52
26588,69588,94,69588,6186,76,18,1.36986301369863,31.54
26589,492,5,492,194,3,2,25.0,97.34
26590,22692,23,22692,21937,18,5,5.555555555555555,81.68
26591,4836,23,4836,661,21,2,6.666666666666667,56.6
26592,18384,26,18384,1440,25,1,4.761904761904762,70.04
26593,41784,245,22818,2225,201,44,1.2987012987012987,0.0
26594,55212,30,43116,10694,27,3,5.882352941176471,49.32
26595,2916,16,0,486,14,2,100.0,0.0
26596,9072,39,0,1378,34,5,100.0,0.0
26597,1416,10,1416,574,7,3,11.11111111111111,0.0
26598,132276,705,82448,16431,478,227,1.0,0.0
26599,68688,18,68688,1896,14,4,100.0,100.0
26600,3840,22,3840,579,20,2,7.6923076923076925,68.91
26601,252,0,252,0,0,0,100.0,0.0
26602,1920,21,0,543,17,4,100.0,0.0
26603,196620,437,0,7877,228,209,2.5,0.0
26604,69660,75,0,3323,52,23,100.0,0.0
26605,2844,21,2844,588,19,2,8.333333333333334,94.21
26606,8016,15,8016,376,13,2,8.333333333333334,84.19
26607,2124,28,2124,626,23,5,8.333333333333334,68.94
26608,1860,31,0,431,23,8,100.0,0.0
26609,55956,90,612,808,88,2,2.083333333333333,58.9
26610,171948,101,171948,34496,86,15,1.5384615384615383,3.83
26611,1908,18,1908,563,17,1,10.0,66.31
26612,2556,10,2556,888,10,0,10.0,12.02
26613,432,13,240,136,9,4,25.0,99.42
26614,6492,41,0,1401,36,5,100.0,0.0
26615,102612,60,102612,20241,44,16,4.545454545454546,0.49
26616,1728,32,0,387,24,8,100.0,0.0
26617,1140,8,1140,321,5,3,100.0,100.0
26618,11709804,1124,0,2637282,665,459,1.0,0.0
26619,15744,23,15744,195,21,2,4.3478260869565215,55.28
26620,5580,20,5580,783,20,0,7.142857142857143,67.71
26621,3516,49,3516,312,47,2,3.8461538461538463,80.89
26622,588,3,588,92,3,0,25.0,95.86
26623,10982172,1146,0,37919,664,482,1.2195121951219512,1.3
26624,16884,26,16884,6153,18,8,16.666666666666668,0.0
26625,1640724,36,0,165527,31,5,33.333333333333336,0.0
26626,2232,11,2232,488,10,1,16.666666666666668,84.19
26627,9372,25,9372,912,22,3,7.6923076923076925,63.6
26628,57204,124,0,5124,96,28,100.0,0.0
26629,8040,32,8040,2121,24,8,12.5,34.81
26630,5064,25,5064,853,23,2,6.25,65.89
26631,11259732,55,0,826734,38,17,50.0,0.0
26632,22476,0,14916,0,0,0,100.0,100.0
26633,2328,20,2328,622,18,2,7.6923076923076925,56.76
26634,3144,26,3144,1184,13,13,16.666666666666668,92.56
26635,1332,11,0,802,9,2,100.0,0.0
26636,11824188,2381,1044612,1101639,1162,1219,1.0,0.0
26637,2208,23,2208,838,21,2,8.333333333333334,61.92
26638,1980,22,0,413,17,5,100.0,0.0
26639,6876,38,0,1324,32,6,100.0,0.0
26640,3900,43,0,707,33,10,50.0,0.0
26641,5124,19,5124,754,18,1,6.25,96.58
26642,10769124,213,5384982,60099,127,86,20.0,0.57
26643,2940,18,2940,480,16,2,8.333333333333334,69.0
26644,2244,29,0,604,22,7,100.0,0.0
26645,10428,31,10428,2268,24,7,6.25,0.18
26646,79992,0,79992,0,0,0,33.333333333333336,90.0
26647,31356,47,0,2210,30,17,100.0,0.0
26648,312,8,312,73,7,1,12.5,69.95
26649,2412,13,2340,992,12,1,12.5,0.0
26650,288,2,288,18,2,0,25.0,77.15
26651,4104,26,0,1015,21,5,100.0,0.0
26652,360,20,360,120,13,7,12.5,49.15
26653,71268,16,71268,295,14,2,12.5,65.58
26654,7524,30,0,1349,26,4,100.0,0.0
26655,2507472,70,527646,107711,58,12,2.272727272727273,19.1
26656,348,91,348,85,53,38,2.7777777777777777,55.74
26657,456,26,456,25,22,4,4.545454545454546,71.5
26658,240,0,240,0,0,0,100.0,100.0
26659,4200,46,1356,143,37,9,2.857142857142857,56.49
26660,7091508,33,0,653278,25,8,20.0,0.0
26661,141552,161,300,1004,116,45,1.1363636363636365,17.35
26662,1092,34,912,427,29,5,4.3478260869565215,32.55
26663,29520,77,0,2901,56,21,100.0,0.0
26664,780,30,624,371,26,4,4.545454545454546,38.65
26665,960,13,960,98,13,0,9.090909090909092,87.44
26666,981216,34,5916,32146,25,9,5.882352941176471,0.0
26667,11883264,1979,0,120222,1108,871,1.0,1.0
26668,108,2,108,24,1,1,50.0,79.28
26669,13008,27,13008,920,23,4,10.0,58.49
26670,1320,2,1320,450,2,0,50.0,0.0
26671,265212,71,265212,13756,60,11,2.1739130434782608,50.34
26672,5021400,341,0,24694,190,151,3.225806451612903,0.0
26673,20580,12,20580,226,12,0,7.6923076923076925,88.07
26674,2100,63,0,775,52,11,50.0,96.0
26675,21972,27,3660,4018,22,5,7.6923076923076925,47.79
26676,2448,49,1224,468,31,18,6.666666666666667,74.88
26677,11460,19,11460,596,18,1,10.0,68.89
26678,2678784,83,1428000,112910,76,7,1.7857142857142858,29.5
26679,25656,54,0,1740,38,16,100.0,0.0
26680,2460,22,2460,688,19,3,6.666666666666667,65.4
26681,11166996,25,20556,447326,21,4,7.142857142857143,59.61
26682,120,0,120,0,0,0,50.0,68.89
26683,14220,50,14220,277,40,10,2.7777777777777777,50.94
26684,2424,6,0,1054,4,2,100.0,0.0
26685,83340,61,83340,2547,53,8,2.4390243902439024,46.46
26686,744,70,744,55,68,2,1.4285714285714286,38.8
26687,2472,27,2472,688,23,4,9.090909090909092,59.07
26688,696,44,564,134,40,4,3.8461538461538463,75.61
26689,3156,8,3156,817,8,0,16.666666666666668,0.0
26690,7068,8,7068,252,8,0,20.0,81.94
26691,4692,32,4692,927,26,6,6.666666666666667,67.22
26692,271164,268,0,3132,137,131,3.8461538461538463,0.0
26693,35928,2,35928,588,2,0,25.0,40.35
26694,444,0,444,0,0,0,50.0,95.0
26695,1632,61,612,276,42,19,3.571428571428572,52.66
26696,19476,8,1716,3528,8,0,25.0,0.0
26697,1572,22,1572,700,20,2,11.11111111111111,48.31
26698,9792,38,0,1222,31,7,100.0,0.0
26699,49140,150,45504,3542,112,38,1.5384615384615383,10.24
26700,648,72,456,168,54,18,2.3255813953488373,35.62
26701,2004,44,2004,67,44,0,2.1739130434782608,57.22
26702,144,0,144,0,0,0,50.0,58.87
26703,65976,10,65976,3321,10,0,5.882352941176471,2.96
26704,192,0,192,0,0,0,50.0,67.24
26705,120,0,120,0,0,0,50.0,80.0
26706,9336,24,9336,1054,22,2,7.142857142857143,67.41
26707,2016,21,0,978,17,4,33.333333333333336,37.5
26708,1632,30,0,451,25,5,100.0,0.0
26709,1380,2,1380,84,1,1,100.0,100.0
26710,3128232,113,3128232,67142,46,67,4.3478260869565215,0.0
26711,145908,147,145908,7260,113,34,1.0,28.83
26712,360,2,360,216,2,0,33.333333333333336,98.07
26713,348,52,348,108,29,23,5.882352941176471,71.67
26714,10285704,475,0,141235,247,228,2.127659574468085,0.0
26715,11718432,1878,0,811080,1022,856,1.0416666666666667,0.0
26716,2952,0,2952,0,0,0,100.0,100.0
26717,180,9,60,84,6,3,25.0,60.01
26718,252,3,0,136,2,1,50.0,0.0
26719,192,23,132,25,19,4,5.555555555555555,42.62
26720,636,6,132,284,4,2,50.0,98.0
26721,14268,37,14268,1160,34,3,11.11111111111111,44.34
26722,48636,61,48636,5034,49,12,100.0,0.0
26723,11373024,144,7199982,3907438,78,66,2.631578947368421,0.0
26724,876,15,756,467,15,0,6.25,87.08
26725,8468520,555,8468484,32955,320,235,1.6666666666666667,0.0
26726,39336,59,0,1552,41,18,100.0,0.0
26727,2746164,31,2746164,2130,17,14,20.0,71.53
26728,120,4,120,12,3,1,33.333333333333336,96.38
26729,8892,34,8892,1057,28,6,5.882352941176471,66.82
26730,372,3,372,16,3,0,20.0,97.49
26731,8264796,501,8264796,42925,314,187,3.125,82.05
26732,7976760,13,2747952,614467,10,3,10.0,60.6
26733,2658360,29,2658360,19637,18,11,10.0,63.71
26734,148128,66,148128,18128,61,5,1.7241379310344829,19.71
26735,4596,12,4596,957,9,3,14.285714285714286,0.0
26736,408,19,408,162,10,9,16.666666666666668,98.23
26737,11909844,899,0,840471,501,398,2.0408163265306123,17.27
26738,828,3,0,328,2,1,100.0,0.0
26739,5228988,22,5228988,6398,15,7,10.0,99.06
26740,1416,7,1416,392,5,2,16.666666666666668,98.19
26741,1128,85,1032,286,69,16,1.694915254237288,7.33
26742,4728,99,4616,3509,56,43,3.333333333333333,50.88
26743,924,21,924,173,20,1,5.2631578947368425,40.06
26744,100884,155,0,3453,108,47,50.0,0.0
26745,11808156,862,2055516,934549,503,359,1.5384615384615383,0.0
26746,34968,173,0,1070,106,67,50.0,0.0
26747,83208,209,0,31939,127,82,50.0,0.0
26748,96192,263,0,7633,165,98,100.0,0.0
26749,24708,117,0,7984,64,53,100.0,0.0
26750,844020,13,844020,6047,7,6,50.0,0.0
26751,120,0,120,0,0,0,50.0,67.24
26752,768,24,768,388,18,6,11.11111111111111,38.22
26753,2340,1,2340,1596,1,0,33.333333333333336,84.89
26754,348,54,348,59,40,14,2.7777777777777777,39.03
26755,44304,20,0,3120,15,5,100.0,0.0
26756,11964,22,11964,796,20,2,6.666666666666667,67.8
26757,11025000,873,0,132913,483,390,1.351351351351351,0.0
26758,412644,176,412644,30031,120,56,1.0,62.76
26759,14988,91,0,1122,62,29,33.333333333333336,0.0
26760,144,39,144,37,31,8,3.333333333333333,36.75
26761,2468652,293,0,45455,175,118,50.0,0.0
26762,23280,28,23280,673,26,2,4.166666666666667,61.55
26763,83796,3,83796,264,3,0,20.0,99.47
26764,41748,28,41748,1404,25,3,5.882352941176471,60.63
26765,600,48,600,24,42,6,2.4390243902439024,46.96
26766,39180,33,39180,1001,27,6,5.882352941176471,38.33
26767,6960,83,0,592,58,25,50.0,0.0
26768,108204,11,108204,39606,7,4,16.666666666666668,0.0
26769,9735684,356,2725188,310315,167,189,2.083333333333333,0.36
26770,1896,20,0,415,16,4,100.0,0.0
26771,1344,13,1344,357,12,1,10.0,93.91
26772,141168,7,141168,57521,7,0,14.285714285714286,9.45
26773,6900,31,6900,863,24,7,4.761904761904762,62.79
26774,2352,8,2352,780,5,3,25.0,86.86
26775,5352,26,5352,777,23,3,6.25,68.06
26776,8251164,190,1815672,1163244,101,89,3.125,1.7
26777,421848,1919,421848,199222,1602,317,1.0,39.12
26778,1332,87,408,35,87,0,2.083333333333333,57.72
26779,24072,28,24072,2166,25,3,4.545454545454546,72.19
26780,6938640,11,0,630967,7,4,100.0,0.0
26781,4476,106,0,1053,74,32,100.0,0.0
26782,1284,31,0,457,28,3,33.333333333333336,49.75
26783,5316,134,0,971,88,46,100.0,0.0
26784,14064,0,8526,0,0,0,100.0,0.0
26785,49200,58,0,1680,42,16,100.0,0.0
26786,1037640,30,319728,67944,26,4,1.2658227848101269,71.84
26787,10408248,434,4743768,2433478,127,307,1.4492753623188406,0.84
26788,10997772,281,0,138248,136,145,4.545454545454546,0.0
26789,6936,27,6936,1125,24,3,6.25,69.71
26790,6996,38,6996,64,38,0,2.5641025641025643,65.55
26791,41976,37,35460,34584,23,14,5.555555555555555,78.71
26792,7973460,93,7973460,27543,77,16,1.408450704225352,74.98
26793,18708,41,18708,1120,30,11,5.0,0.0
26794,151032,104,0,5921,87,17,100.0,0.0
26795,300,0,300,0,0,0,50.0,64.0
26796,8516652,95,0,2656377,41,54,5.882352941176471,0.0
26797,26328,4,26328,609,4,0,16.666666666666668,93.72
26798,21996,23,2100,2186,20,3,6.666666666666667,0.0
26799,32436,36,32436,394,32,4,3.333333333333333,33.32
26800,13188,22,13188,712,20,2,7.142857142857143,49.77
26801,159864,30,13836,31922,26,4,5.0,73.7
26802,46644,12,46644,75,8,4,16.666666666666668,93.84
26803,500748,216,0,6073,105,111,4.761904761904762,0.0
26804,15540,99,0,976,66,33,33.333333333333336,0.0
26805,11987964,1931,0,641587,1129,802,1.0,0.0
26806,7320,25,7320,989,21,4,6.25,68.39
26807,66600,62,55344,7376,53,9,2.5,29.38
26808,9721572,49,1020,198574,26,23,5.555555555555555,56.73
26809,69204,67,0,2721,54,13,14.285714285714286,0.0
26810,192,33,120,28,27,6,4.0,43.33
26811,9575004,25,3696,385836,23,2,4.761904761904762,0.0
26812,9356940,545,0,220067,295,250,1.7241379310344829,0.0
26813,312,2,312,66,2,0,33.333333333333336,0.0
26814,1992,17,0,522,14,3,100.0,100.0
26815,2176032,75,0,38008,51,24,50.0,0.0
26816,6900,17,0,957,14,3,100.0,0.0
26817,3103284,60,3103284,30207,55,5,2.4390243902439024,37.79
26818,576,4,576,153,2,2,50.0,62.85
26819,610872,14,610872,32117,13,1,9.090909090909092,50.32
26820,240,74,240,40,54,20,2.1739130434782608,29.96
26821,192,2,192,54,2,0,25.0,61.68
26822,6288,20,6288,660,17,3,8.333333333333334,67.56
26823,924,2,0,918,2,0,25.0,0.0
26824,660,60,660,77,56,4,1.7543859649122806,46.34
26825,22536,13,22536,1512,12,1,11.11111111111111,75.33
26826,2536812,1197,0,13961,646,551,1.2195121951219512,0.0
26827,7992,28,1572,1024,24,4,5.0,0.0
26828,0,0,0,0,0,0,100.0,0.0
26829,697632,204,0,6861,98,106,3.703703703703704,0.0
26830,900,63,900,61,59,4,1.694915254237288,39.55
26831,420,0,420,0,0,0,50.0,64.0
26832,81264,27,0,6164,24,3,100.0,0.0
26833,8028,30,8028,1021,26,4,6.666666666666667,71.08
26834,456,7,456,37,5,2,20.0,73.8
26835,10448520,605,0,200139,315,290,1.408450704225352,0.0
26836,111432,34,111432,45756,25,9,11.11111111111111,6.16
26837,34572,55,0,1907,40,15,100.0,0.0
26838,336,53,336,24,41,12,2.5641025641025643,33.12
26839,156,0,156,0,0,0,50.0,59.29
26840,3672,21,0,751,17,4,100.0,0.0
26841,8400,19,8400,620,17,2,11.11111111111111,74.36
26842,528,24,528,96,18,6,7.6923076923076925,35.66
26843,4212,21,0,1029,19,2,100.0,0.0
26844,76824,27,76824,3387,19,8,8.333333333333334,6.18
26845,624,7,624,291,6,1,16.666666666666668,85.82
26846,2004,5,2004,556,5,0,20.0,0.0
26847,10364796,31,0,1984620,26,5,25.0,0.0
26848,1560,16,0,405,12,4,100.0,0.0
26849,10385796,378,613920,37036,285,93,1.492537313432836,64.67
26850,4141716,88,4141716,12825,67,21,4.166666666666667,56.36
26851,708,53,324,71,48,5,2.127659574468085,50.37
26852,149820,345,149820,2054,110,235,4.761904761904762,71.26
26853,30600,50,0,1514,33,17,100.0,0.0
26854,14868,27,14868,616,26,1,9.090909090909092,53.63
26855,240,0,240,0,0,0,50.0,90.8
26856,2172,57,0,889,49,8,50.0,80.0
26857,362916,47,0,34575,35,12,3.571428571428572,0.0
26858,96,0,96,0,0,0,50.0,68.89
26859,9258492,1023,9258492,24806,493,530,1.1363636363636365,63.76
26860,840,3,312,332,3,0,25.0,97.02
26861,816,18,792,175,16,2,6.666666666666667,40.62
26862,792,15,696,204,15,0,6.25,60.92
26863,78492,66,0,1381,38,28,10.0,2.0
26864,60,1,60,0,1,0,33.333333333333336,78.0
26865,9732912,257,0,70181,130,127,4.3478260869565215,2.0
26866,280824,312,280824,654,204,108,1.0,25.19
26867,696,2,240,384,2,0,50.0,68.0
26868,9313224,137,0,86970,65,72,4.761904761904762,5.0
26869,732,4,96,282,3,1,33.333333333333336,96.12
26870,1188,101,1188,92,72,29,1.7857142857142858,39.65
26871,2724,6,2724,844,6,0,16.666666666666668,27.94
26872,816,20,660,354,10,10,16.666666666666668,96.64
26873,1776,5,1776,648,4,1,20.0,59.94
26874,269940,233,269940,209,118,115,1.6129032258064515,15.96
26875,960,50,504,228,40,10,3.333333333333333,70.86
26876,3669300,45,0,164818,36,9,100.0,0.0
26877,216,6,72,210,4,2,50.0,80.0
26878,9084,43,0,1400,33,10,100.0,0.0
26879,12019260,9857,1313730,2988082,5594,4263,1.0,0.0
26880,468,18,444,274,18,0,5.555555555555555,83.12
26881,348,30,348,16,29,1,4.0,0.0
26882,177948,139,177948,1021,100,39,1.25,19.0
26883,10473384,542,2789064,124990,284,258,1.7241379310344829,4.0
26884,11556,36,0,1573,32,4,100.0,0.0
26885,204,20,204,44,20,0,4.761904761904762,66.31
26886,408,15,408,136,14,1,7.142857142857143,88.8
26887,1980,30,1980,55,26,4,3.8461538461538463,0.0
26888,720,19,720,271,12,7,16.666666666666668,58.1
26889,180828,191,180828,381,120,71,1.2820512820512822,26.8
26890,1008,87,1008,26,87,0,2.0408163265306123,54.99
26891,516,2,516,414,2,0,25.0,62.02
26892,1356,65,1356,140,57,8,1.818181818181818,55.86
26893,384,3,384,140,3,0,20.0,89.25
26894,456,26,456,124,23,3,4.761904761904762,83.57
26895,7772856,163,35124,49703,117,46,1.492537313432836,6.25
26896,34140,62,34140,807,49,13,2.2222222222222223,27.03
26897,26040,33,26040,725,26,7,8.333333333333334,63.94
26898,996,61,612,62,58,3,1.694915254237288,46.23
26899,360,14,360,219,10,4,10.0,66.55
26900,73596,125,0,1456,64,61,5.555555555555555,1.0
26901,1306248,973,0,13711,553,420,1.0,0.0
26902,182568,114,0,19094,75,39,2.0,0.0
26903,2988,117,516,81,104,13,1.694915254237288,0.0
26904,432,43,432,161,25,18,5.555555555555555,76.96
26905,9528,17,0,1892,12,5,1.6129032258064515,0.0
26906,336,10,336,4,10,0,8.333333333333334,80.0
26907,404928,184,0,5121,98,86,3.703703703703704,1.0
26908,360,28,360,51,24,4,4.3478260869565215,69.82
26909,660,82,312,153,48,34,3.125,71.15
26910,4206552,36,0,542100,32,4,50.0,0.0
26911,9761088,46,600,345634,45,1,2.127659574468085,57.12
26912,8990940,771,8990940,75246,442,329,1.3888888888888888,58.98
26913,244860,68,244860,4771,34,34,5.882352941176471,66.33
26914,5052,51,0,1265,30,21,100.0,100.0
26915,149568,219,0,9575,148,71,100.0,0.0
26916,22644,251,0,4090,149,102,50.0,0.0
26917,4452,79,4384,1333,39,40,4.761904761904762,67.96
26918,864,19,864,200,9,10,20.0,96.02
26919,12031332,8395,3936912,3054100,4667,3728,1.0,10.1
26920,78660,82,78660,8239,63,19,1.5625,35.59
26921,912,195,0,101,149,46,1.0,0.0
26922,5004,8,5004,222,5,3,25.0,72.23
26923,152100,98,148560,31824,79,19,1.4492753623188406,30.85
26924,1608,29,0,395,24,5,33.333333333333336,0.0
26925,10982352,554,10982256,32741,284,270,2.3255813953488373,80.94
26926,1116,139,996,133,86,53,1.851851851851852,42.3
26927,1632,15,1572,386,10,5,10.0,46.64
26928,132,12,132,13,12,0,7.142857142857143,46.66
26929,3744,6,3192,1690,4,2,20.0,68.78
26930,26388,74,0,823,49,25,50.0,0.0
26931,4140,290,2220,437,170,120,1.0,39.41
26932,77820,0,77820,0,0,0,100.0,100.0
26933,28260,96,0,765,62,34,33.333333333333336,0.0
26934,30960,7,30960,243,7,0,12.5,72.41
26935,2596692,179,2596596,35049,99,80,3.703703703703704,0.0
26936,12046608,11814,3524184,1603702,6611,5203,1.0,0.0
26937,344616,15,344616,763,15,0,6.666666666666667,41.48
26938,5136,24,5136,4978,22,2,4.3478260869565215,62.03
26939,2671092,283,1335912,15990,158,125,4.0,87.42
26940,7826556,227,7826556,7315,90,137,2.4390243902439024,71.74
26941,32784,186,0,4269,121,65,50.0,0.0
26942,3504,57,0,439,44,13,50.0,0.0
26943,9424344,211,0,267104,100,111,6.25,0.0
26944,30336,0,30336,0,0,0,100.0,100.0
26945,12050568,15529,2528442,5486287,9438,6091,1.0,3.63
26946,9998736,1252,0,170720,682,570,1.0,0.0
26947,957444,349,0,18306,197,152,1.2658227848101269,0.0
26948,7194876,178,4102830,26487,96,82,7.6923076923076925,96.43
26949,1956,219,1956,1142,123,96,1.351351351351351,10.63
26950,1308,26,1308,183,18,8,8.333333333333334,38.18
26951,5040,0,5040,0,0,0,33.333333333333336,64.16
26952,39768,83,0,1518,57,26,50.0,0.0
26953,55548,63,55548,2145,29,34,11.11111111111111,83.05
26954,12030216,5942,0,509133,3295,2647,1.0,0.0
26955,45288,26,25482,5391,15,11,1.0,1.59
26956,420,43,156,53,38,5,2.7777777777777777,26.11
26957,180,3,180,44,3,0,20.0,61.69
26958,109680,135,0,2432,95,40,20.0,0.0
26959,10839468,1252,0,40966,671,581,1.0638297872340423,0.0
26960,4164,100,0,216,44,56,11.11111111111111,0.0
26961,3820152,1258,0,18495,725,533,1.0638297872340423,0.0
26962,225864,1119,172164,142199,900,219,1.0,19.65
26963,2572932,356,0,16816,146,210,3.4482758620689653,0.0
26964,204,34,96,28,26,8,5.0,53.9
26965,9055644,341,0,58505,188,153,1.9230769230769231,5.0
26966,360,27,360,68,27,0,3.4482758620689653,52.55
26967,5186640,466,0,48064,237,229,2.083333333333333,6.65
26968,10715136,1473,1119060,635370,769,704,1.0,0.0
26969,234984,29,42888,38081,25,4,5.2631578947368425,0.0
26970,156,37,156,16,33,4,3.125,28.43
26971,440736,154,0,10410,71,83,6.25,4.95
26972,1788,94,552,227,60,34,2.2222222222222223,26.76
26973,5532624,147,5532624,1309,70,77,5.2631578947368425,90.14
26974,12067704,9711,86052,986379,5154,4557,1.0,2.25
26975,9885132,283,0,138367,141,142,3.703703703703704,0.0
26976,14628,22,14628,815,21,1,5.555555555555555,74.77
26977,4116732,143,0,456625,101,42,9.090909090909092,0.0
26978,28956,93,28956,1178,70,23,1.492537313432836,29.21
26979,19008,9,19008,422,9,0,10.0,51.14
26980,5023236,56,4440,100938,45,11,3.333333333333333,0.0
26981,162996,42,162996,21723,35,7,3.703703703703704,4.03
26982,11219892,661,0,91600,371,290,1.694915254237288,0.0
26983,19788,71,0,706,52,19,100.0,0.0
26984,744,37,744,478,26,11,5.555555555555555,83.8
26985,53508,19,53508,5249,14,5,9.090909090909092,1.74
26986,39480,21,0,2338,17,4,100.0,0.0
26987,84144,259,0,6219,170,89,25.0,0.0
26988,33012,29,0,2517,27,2,100.0,0.0
26989,245772,71,245772,30257,60,11,1.7241379310344829,30.3
26990,84672,51,84672,1565,49,2,2.0,22.26
26991,524556,53,516,10081,42,11,2.631578947368421,0.0
26992,156,4,156,30,2,2,50.0,78.56
26993,119664,58,1200,2150,50,8,2.702702702702702,24.43
26994,2679612,67,2679612,96688,24,43,10.0,95.34
26995,10352556,537,0,164934,281,256,3.8461538461538463,0.0
26996,6912,72,0,743,51,21,50.0,0.0
26997,2628,93,0,665,64,29,100.0,0.0
26998,40836,47,40836,1929,40,7,100.0,0.0
26999,2686608,91,2686608,13453,37,54,7.6923076923076925,78.53
27000,8472,86,0,681,61,25,33.333333333333336,0.0
27001,504,14,504,141,11,3,9.090909090909092,91.88
27002,32388,116,0,1443,80,36,100.0,0.0
27003,73560,11,72408,14583,10,1,10.0,91.39
27004,216,31,216,61,25,6,10.0,77.25
27005,5172,41,0,925,31,10,3.225806451612903,0.0
27006,4716,24,4668,716,20,4,5.555555555555555,73.59
27007,44916,16,44916,536,14,2,10.0,60.79
27008,6144,215,0,2040,130,85,50.0,0.0
27009,10077612,59,0,1291355,47,12,50.0,0.0
27010,2280,1,2280,1884,1,0,33.333333333333336,99.02
27011,523896,25,341520,28440,23,2,4.3478260869565215,54.61
27012,7548,25,7548,935,23,2,5.2631578947368425,71.08
27013,3366396,28,9336,121667,22,6,6.25,1.94
27014,39444,88,39444,1516,75,13,1.36986301369863,29.56
27015,10536,41,10536,1782,35,6,3.333333333333333,0.0
27016,12064416,1876,0,1100758,1019,857,1.2195121951219512,0.0
27017,73476,19,73476,807,18,1,7.6923076923076925,58.54
27018,180,3,180,88,3,0,33.333333333333336,0.0
27019,176484,14,88380,463,7,7,20.0,97.52
27020,70740,24,0,4092,17,7,33.333333333333336,0.0
27021,11896488,1610,1434528,602443,879,731,1.2048192771084338,0.0
27022,970620,202,0,31723,124,78,100.0,0.0
27023,4500,1,4500,4104,1,0,33.333333333333336,89.1
27024,552,13,552,386,5,8,33.333333333333336,98.64
27025,2172,21,0,583,17,4,100.0,100.0
27026,10260,0,10260,0,0,0,100.0,100.0
27027,157404,4,157404,381,4,0,20.0,90.58
27028,204,10,204,24,6,4,25.0,59.71
27029,12011064,139,0,1264531,122,17,50.0,0.0
27030,2785512,179,2785512,23596,97,82,3.225806451612903,68.82
27031,7983240,44,0,184027,29,15,50.0,0.0
27032,7188,15,7188,668,13,2,9.090909090909092,0.0
27033,468,46,0,108,41,5,2.702702702702702,1.5
27034,9565344,537,0,112662,303,234,1.7857142857142858,4.0
27035,68268,49,0,6980,39,10,100.0,0.0
27036,2208,5,2208,703,4,1,25.0,99.9
27037,9381372,60,0,2637611,53,7,25.0,0.0
27038,21636,49,0,737,34,15,100.0,0.0
27039,2136,21,0,574,17,4,100.0,100.0
27040,27216,97,0,1109,71,26,20.0,0.0
27041,196356,23,2628,9181,19,4,6.666666666666667,0.0
27042,4092,38,2352,1521,29,9,10.0,0.0
27043,1669116,60,0,100110,39,21,25.0,0.0
27044,220176,55,0,10390,45,10,100.0,0.0
27045,223692,6,223692,66118,5,1,25.0,0.0
27046,13356,35,0,2173,27,8,3.8461538461538463,0.02
27047,128892,20,492,19479,17,3,6.25,76.88
27048,2781564,591,2731998,59391,392,199,2.1739130434782608,0.0
27049,69300,6,69300,854,5,1,16.666666666666668,48.5
27050,180,0,180,0,0,0,50.0,65.61
27051,2028,70,2028,676,44,26,5.882352941176471,0.0
27052,1153032,117,720432,203447,94,23,1.5873015873015872,31.08
27053,3303576,29,5196,115799,26,3,4.545454545454546,0.0
27054,828780,286,0,12054,142,144,4.0,0.0
27055,552,43,552,138,19,24,11.11111111111111,94.69
27056,12104256,5115,0,2761469,2932,2183,1.0,0.0
27057,264,9,264,40,6,3,20.0,71.34
27058,226644,6,226644,12422,4,2,25.0,49.92
27059,2400,107,780,278,80,27,2.3255813953488373,0.0
27060,8098980,41,2605638,3404230,26,15,2.702702702702702,55.02
27061,12101772,1735,339172,640771,992,743,1.0,0.0
27062,279996,204,279996,382,159,45,1.0,22.73
27063,19644,24,2892,1771,20,4,6.666666666666667,0.0
27064,119292,4,119292,165,2,2,33.333333333333336,79.37
27065,612,0,612,0,0,0,50.0,80.0
27066,2160,68,0,227,47,21,100.0,0.0
27067,1920,87,1920,265,69,18,1.639344262295082,55.45
27068,7392,0,7392,0,0,0,100.0,100.0
27069,12106068,6206,1841352,3870485,2633,3573,1.0,0.0
27070,577740,63,0,15099,50,13,100.0,0.0
27071,1278348,24,2100,53720,12,12,1.8867924528301887,85.5
27072,2206872,415,0,14301,212,203,2.3255813953488373,0.91
27073,5790888,3,156,5790888,2,1,50.0,59.29
27074,792,27,624,485,21,6,5.2631578947368425,68.18
27075,336,39,336,95,27,12,4.3478260869565215,61.62
27076,192,6,144,68,4,2,20.0,64.41
27077,120,16,120,21,12,4,8.333333333333334,87.29
27078,240,5,240,33,5,0,14.285714285714286,54.07
27079,6384984,50,6384936,293850,31,19,9.090909090909092,0.0
27080,996,25,792,771,24,1,4.0,0.0
27081,84,2,84,30,1,1,100.0,99.28
27082,695664,374,0,6676,196,178,2.5,2.0
27083,35052,11,35052,722,9,2,14.285714285714286,89.6
27084,11752668,465,0,84745,241,224,3.571428571428572,0.0
27085,6912,8,6912,480,8,0,12.5,0.0
27086,444,32,444,108,25,7,4.3478260869565215,48.32
27087,312,37,312,130,19,18,8.333333333333334,69.09
27088,1680,80,0,244,72,8,100.0,0.0
27089,1752,4,1752,336,4,0,16.666666666666668,0.0
27090,3360,6,0,1100,3,3,25.0,0.0
27091,7764,72,0,762,53,19,100.0,0.0
27092,11596920,4220,34260,50398,2423,1797,1.0,0.0
27093,1596,21,1596,1341,21,0,4.3478260869565215,60.9
27094,1380,13,348,186,8,5,25.0,91.58
27095,2208,50,2208,270,50,0,1.96078431372549,52.96
27096,170496,21,170496,86,21,0,4.0,55.75
27097,38964,160,0,1549,100,60,100.0,0.0
27098,5178864,234,5178864,4777,120,114,4.166666666666667,91.89
27099,1872,42,0,230,31,11,100.0,0.0
27100,1392,34,636,156,32,2,3.4482758620689653,65.0
27101,1596,39,1128,88,30,9,4.0,40.41
27102,11707260,178,0,344612,89,89,4.761904761904762,0.0
27103,1752,96,1488,107,58,38,2.4390243902439024,29.25
27104,9566424,150,9566424,765448,58,92,4.166666666666667,0.0
27105,19128,17,19128,2997,17,0,100.0,100.0
27106,16224,104,0,1022,74,30,100.0,0.0
27107,1872,33,468,179,31,2,4.3478260869565215,72.34
27108,2750760,9,2750760,7526,7,2,12.5,46.05
27109,9686004,192,384,51374,137,55,1.0,0.0
27110,1404,34,0,555,26,8,100.0,0.0
27111,235068,113,47196,4195,90,23,1.639344262295082,2.67
27112,1284,24,372,214,11,13,20.0,57.83
27113,7835124,298,7835124,8034,160,138,2.9411764705882355,83.31
27114,2567772,725,34463,22813,272,453,100.0,100.0
27115,2292,0,2292,0,0,0,100.0,100.0
27116,1764,76,0,150,54,22,100.0,0.0
27117,336,91,336,71,55,36,2.5641025641025643,62.12
27118,852,33,660,384,27,6,4.545454545454546,66.66
27119,10873836,479,0,77768,282,197,1.0,0.0
27120,2760,76,0,351,68,8,100.0,0.0
27121,204,31,204,17,26,5,4.3478260869565215,41.67
27122,648,9,648,220,7,2,5.555555555555555,49.65
27123,132,18,132,10,17,1,5.555555555555555,42.38
27124,7959768,884,7872204,92910,487,397,1.639344262295082,0.0
27125,942708,185,942708,32107,83,102,2.9411764705882355,58.26
27126,2667660,147,2667588,95837,67,80,3.571428571428572,0.0
27127,11593992,282,3634728,229277,153,129,2.702702702702702,81.9
27128,25044,60,0,826,44,16,33.333333333333336,0.0
27129,53616,49,53616,888,47,2,2.127659574468085,21.38
27130,10974768,170,0,212213,96,74,5.2631578947368425,5.0
27131,1140,16,1140,726,14,2,7.6923076923076925,82.13
27132,3364104,1017,2013528,95697,574,443,1.3157894736842106,60.05
27133,11195748,2986,2080435,1193410,1807,1179,1.0,0.0
27134,8640,92,0,3795,63,29,50.0,0.0
27135,2712,51,2712,2602,49,2,2.0,32.1
27136,9608940,587,0,72647,313,274,1.3333333333333333,0.0
27137,166932,66,166932,6695,59,7,1.818181818181818,22.65
27138,12135768,20801,4733908,5612912,12442,8359,1.0,0.23
27139,2818428,350,0,16443,194,156,2.2222222222222223,0.0
27140,5390568,150,5390568,13148,61,89,6.25,81.22
27141,11903844,697,9401016,952951,338,359,1.2820512820512822,0.0
27142,7863096,152,7863096,60432,65,87,5.2631578947368425,80.84
27143,7150152,293,7150152,53524,161,132,2.0408163265306123,70.55
27144,11975772,3138,348846,732871,1361,1777,1.0,0.0
27145,132,14,120,37,9,5,14.285714285714286,50.98
27146,4964052,353,0,22316,190,163,2.0,2.33
27147,33300,165,0,910,105,60,100.0,0.0
27148,288,12,0,89,7,5,50.0,0.0
27149,924,28,384,145,18,10,11.11111111111111,67.98
27150,2016,4,2016,1380,4,0,20.0,96.0
27151,432,100,396,105,80,20,1.5151515151515151,45.94
27152,17412,29,144,642,16,13,16.666666666666668,44.75
27153,7826628,935,7826628,685748,468,467,1.2820512820512822,45.14
27154,420,95,420,85,40,55,7.142857142857143,88.81
27155,264,9,204,92,9,0,10.0,84.37
27156,9450348,158,0,2057379,72,86,5.2631578947368425,0.0
27157,11438220,1864,0,75042,1052,812,1.0,0.0
27158,107328,312,107328,141,167,145,1.0416666666666667,24.47
27159,276,10,252,104,7,3,20.0,91.55
27160,2383104,97,2383104,25741,42,55,12.5,93.74
27161,8369556,361,8369556,50309,171,190,3.225806451612903,75.98
27162,14640,45,0,5989,14,31,6.666666666666667,0.0
27163,4847784,312,4847784,19313,128,184,2.702702702702702,61.4
27164,8854752,1322,0,68819,709,613,1.0,8.38
27165,1572,101,1572,138,86,15,1.2820512820512822,23.87
27166,313752,125,313752,851,91,34,1.492537313432836,44.63
27167,2643672,71,2643672,111175,23,48,2.857142857142857,73.58
27168,9564528,620,5180616,29811,280,340,1.6129032258064515,0.0
27169,4131180,132,0,119010,77,55,7.142857142857143,6.25
27170,2508,5,2172,1533,3,2,33.333333333333336,90.46
27171,276,99,240,60,77,22,1.492537313432836,35.22
27172,384,18,372,127,13,5,10.0,93.23
27173,156,1,0,156,1,0,33.333333333333336,0.0
27174,9054480,295,36072,100807,143,152,2.4390243902439024,0.0
27175,98976,6,98976,1338,6,0,12.5,86.86
27176,98724,11,84,9045,7,4,20.0,82.72
27177,114876,119,114876,260,87,32,1.408450704225352,27.06
27178,2671956,31,2671956,203193,17,14,7.6923076923076925,57.49
27179,10412736,488,0,152824,260,228,2.127659574468085,0.41
27180,1128,13,876,291,10,3,11.11111111111111,85.62
27181,1230492,11,3360,326385,10,1,16.666666666666668,0.0
27182,3203028,234,276420,108942,223,11,4.761904761904762,99.57
27183,624,104,624,380,86,18,1.2658227848101269,38.6
27184,168,0,168,0,0,0,50.0,84.0
27185,610356,71,0,170683,56,15,14.285714285714286,0.0
27186,4642464,78,0,61906,39,39,7.142857142857143,0.0
27187,17844,53,0,623,37,16,33.333333333333336,0.0
27188,1375608,103,0,14511,79,24,100.0,0.0
27189,11338728,811,384,434764,460,351,1.1764705882352942,2.01
27190,121884,44,0,6061,35,9,100.0,0.0
27191,2667096,123,2667096,8979,57,66,4.0,77.15
27192,20412,84,0,1434,63,21,100.0,0.0
27193,10344,24,10344,877,23,1,5.2631578947368425,76.69
27194,57828,23,57828,1621,15,8,11.11111111111111,88.34
27195,21348,127,0,1335,89,38,33.333333333333336,0.0
27196,6893544,57,0,1257871,31,26,4.0,0.0
27197,5328864,116,0,108293,72,44,3.0303030303030303,0.0
27198,9650772,271,0,906563,165,106,1.2658227848101269,0.0
27199,365244,57,82008,16768,44,13,3.225806451612903,4.33
27200,6708,97,0,759,65,32,100.0,0.0
27201,8472,4,1392,8346,2,2,33.333333333333336,48.13
27202,11531484,1131,0,66378,644,487,1.25,0.0
27203,1032,84,1032,707,55,29,2.7777777777777777,70.65
27204,4776,52,0,474,43,9,100.0,0.0
27205,3948576,1831,728724,514856,1643,188,1.0,15.11
27206,11852196,4320,0,113777,2510,1810,1.0,1.63
27207,71100,3,71100,400,1,2,50.0,99.49
27208,9984,51,0,779,42,9,100.0,0.0
27209,10906008,839,0,251603,463,376,1.162790697674419,0.0
27210,2280,27,0,811,22,5,100.0,0.0
27211,27312,82,7212,900,73,9,1.492537313432836,34.93
27212,39912,54,17220,4910,40,14,4.761904761904762,88.19
27213,71268,49,0,4131,35,14,100.0,0.0
27214,205488,9,202416,84468,4,5,20.0,91.93
27215,132,2,132,24,2,0,25.0,66.58
27216,25404,29,9300,3426,23,6,7.142857142857143,0.0
27217,1296,13,1296,419,12,1,8.333333333333334,0.0
27218,19548,16,19548,1413,16,0,4.3478260869565215,6.44
27219,103680,30,80688,7815,26,4,6.25,1.38
27220,32772,3,32772,32676,3,0,16.666666666666668,79.0
27221,165264,0,165264,0,0,0,50.0,86.67
27222,83796,62,0,3334,42,20,100.0,0.0
27223,2756856,46,2756856,576,40,6,4.545454545454546,53.43
27224,3056880,535,0,53623,353,182,50.0,0.0
27225,252,0,252,0,0,0,50.0,95.0
27226,1248,375,1248,375,371,4,1.0,0.0
27227,22128,56,0,1614,44,12,100.0,0.0
27228,1145112,33,1104,35244,28,5,4.761904761904762,0.0
27229,19380,25,19380,1153,24,1,5.0,72.0
27230,11017248,383,0,89257,200,183,2.7777777777777777,0.0
27231,24936,147,0,1470,100,47,50.0,0.0
27232,120,25,120,25,21,4,4.761904761904762,43.95
27233,336,5,336,60,4,1,20.0,58.67
27234,52320,6,52320,1064,2,4,100.0,0.0
27235,1524,8,1524,99,8,0,10.0,84.81
27236,1344,7,1344,246,6,1,33.333333333333336,0.0
27237,25512,6,25512,10502,4,2,100.0,0.0
27238,2436,17,0,632,14,3,100.0,0.0
27239,5591604,15,2112,374190,14,1,8.333333333333334,0.0
27240,7747200,138,0,70108,112,26,50.0,0.0
27241,600,2,600,318,2,0,33.333333333333336,99.27
27242,82260,47,0,3772,34,13,100.0,0.0
27243,181752,25,0,7825,17,8,100.0,0.0
27244,15924,66,0,1209,48,18,100.0,0.0
27245,11752368,55,0,717163,38,17,25.0,0.0
27246,7032,23,7032,1179,18,5,8.333333333333334,1.58
27247,1992,29,0,475,24,5,100.0,0.0
27248,2904,4,2196,1038,4,0,50.0,0.0
27249,14868,0,14868,0,0,0,50.0,85.0
27250,141192,159,141192,28128,125,34,1.0,27.26
27251,5153184,20,6648,259282,13,7,16.666666666666668,88.06
27252,9190332,4,0,3851775,4,0,20.0,0.0
27253,1795272,19,2880,95012,13,6,11.11111111111111,0.0
27254,2568,0,2568,0,0,0,50.0,72.03
27255,9288,101,0,703,77,24,50.0,0.0
27256,1032,6,1032,186,6,0,16.666666666666668,46.88
27257,1512,21,1512,574,19,2,6.666666666666667,0.0
27258,11752200,608,0,77810,341,267,1.7543859649122806,0.0
27259,6084,49,6084,235,43,6,2.4390243902439024,27.91
27260,528,33,0,129,23,10,50.0,0.0
27261,2851536,192,2851536,62188,84,108,4.545454545454546,0.0
27262,11559096,1240,1916106,39873,616,624,1.0,0.0
27263,120,1,120,0,1,0,50.0,98.0
27264,8446716,68,0,375328,53,15,100.0,0.0
27265,9911160,102,83868,98749,60,42,2.2222222222222223,79.05
27266,180,26,180,60,12,14,14.285714285714286,57.68
27267,96,0,96,0,0,0,50.0,64.0
27268,7785708,56,0,423726,42,14,100.0,0.0
27269,4464,42,0,888,31,11,100.0,0.0
27270,12111168,1177,7495036,3894718,652,525,1.0,9.97
27271,4644,3,4644,112,3,0,20.0,63.46
27272,6900,62,6900,974,60,2,1.7857142857142858,44.88
27273,948,108,774,417,71,37,1.9230769230769231,61.84
27274,108,8,108,43,5,3,25.0,65.18
27275,408,13,108,47,11,2,9.090909090909092,16.02
27276,1353756,38,960,37758,29,9,4.166666666666667,40.7
27277,384,45,384,123,36,9,3.8461538461538463,0.78
27278,144,45,144,51,27,18,5.0,47.43
27279,444,104,420,115,62,42,2.272727272727273,51.95
27280,6247164,224,6247164,2968,89,135,2.9411764705882355,61.18
27281,2661564,274,2661432,245453,149,125,2.5641025641025643,0.0
27282,636,20,636,146,13,7,12.5,62.63
27283,500820,822,0,10187,467,355,1.0,0.0
27284,4449132,50,4449132,85126,24,26,14.285714285714286,85.57
27285,984588,404,0,5759,211,193,2.631578947368421,0.0
27286,70872,67,0,1580,59,8,100.0,0.0
27287,8505408,110,8505408,12880,71,39,5.0,83.0
27288,87564,93,87504,1679,80,13,1.3157894736842106,0.0
27289,10495884,184,0,164620,105,79,3.125,0.0
27290,3124416,130,33876,26763,102,28,1.4285714285714286,3.63
27291,18144,52,18144,17103,46,6,2.2222222222222223,44.21
27292,7874328,1380,3969642,80403,791,589,1.0,89.96
27293,2627832,482,0,72717,258,224,2.380952380952381,6.92
27294,1255248,364,0,257544,207,157,1.8867924528301887,0.0
27295,624,30,624,84,26,4,3.8461538461538463,46.47
27296,22584,3,22584,444,2,1,50.0,99.18
27297,2400,5,2400,1116,3,2,33.333333333333336,71.92
27298,1332,13,0,552,9,4,100.0,0.0
27299,312,83,312,89,39,44,5.2631578947368425,74.95
27300,576,5,576,477,5,0,16.666666666666668,90.34
27301,8914764,606,0,390181,327,279,1.96078431372549,0.0
27302,180,16,180,58,8,8,50.0,74.24
27303,540,32,0,302,23,9,50.0,0.0
27304,2484,53,0,748,27,26,100.0,0.0
27305,192,3,192,76,3,0,20.0,60.74
27306,1764,92,420,109,63,29,2.127659574468085,42.45
27307,765216,36,0,43530,23,13,10.0,0.0
27308,2724564,162,2724564,41787,94,68,5.0,65.8
27309,780,47,0,149,29,18,7.142857142857143,0.0
27310,576,1,576,0,1,0,33.333333333333336,57.08
27311,841212,18,0,54498,10,8,16.666666666666668,0.9
27312,2725668,190,0,26499,100,90,3.703703703703704,0.0
27313,285864,173,0,21104,89,84,2.127659574468085,0.0
27314,4710312,781,0,41732,455,326,1.3333333333333333,0.0
27315,1896,53,0,664,36,17,50.0,0.0
27316,384,1,384,168,1,0,50.0,76.96
27317,2388,44,0,436,34,10,100.0,0.0
27318,4020,7,4020,481,5,2,33.333333333333336,95.39
27319,228,15,228,72,11,4,7.142857142857143,39.98
27320,636,38,636,102,36,2,3.225806451612903,20.59
27321,9933000,490,0,33111,280,210,1.5384615384615383,1.0
27322,11898108,282,0,348568,178,104,2.9411764705882355,0.0
27323,9012,18,9012,2041,18,0,5.555555555555555,58.6
27324,1044,22,1032,111,16,6,7.6923076923076925,46.0
27325,1680,65,792,631,48,17,2.380952380952381,61.37
27326,264,8,264,70,4,4,25.0,81.89
27327,219732,35,219732,3774,19,16,7.6923076923076925,41.68
27328,2741076,160,2741076,69931,72,88,3.125,53.96
27329,6420,23,6420,796,20,3,5.2631578947368425,41.9
27330,228,2,228,12,2,0,33.333333333333336,96.0
27331,264,42,264,140,26,16,5.2631578947368425,58.12
27332,1284,102,1284,412,50,52,3.8461538461538463,54.09
27333,204,10,204,30,6,4,25.0,81.02
27334,35988,69,0,1445,44,25,100.0,0.0
27335,11265492,173,11265492,146033,75,98,2.631578947368421,81.35
27336,10770336,1760,10770336,207334,979,781,1.0,56.38
27337,9478236,38,0,499672,24,14,5.2631578947368425,0.0
27338,192,37,192,38,25,12,4.761904761904762,53.37
27339,312,17,312,127,11,6,16.666666666666668,53.45
27340,4128,222,660,174,149,73,1.0,4.75
27341,742584,262,0,7122,139,123,2.9411764705882355,5.0
27342,2328060,78,660,29945,59,19,1.818181818181818,29.4
27343,11022444,239,0,231288,181,58,2.272727272727273,0.0
27344,288,69,288,133,39,30,3.8461538461538463,71.22
27345,49404,91,49404,5208,30,61,3.225806451612903,70.48
27346,3460560,306,3460560,3001,168,138,1.6129032258064515,58.82
27347,12100164,1348,2985720,395374,761,587,1.0,4.96
27348,1884,38,0,738,35,3,100.0,0.0
27349,540,32,528,227,21,11,7.6923076923076925,74.45
27350,12223452,1292,0,6553322,726,566,1.639344262295082,0.0
27351,47616,53,47616,120,52,1,1.851851851851852,42.81
27352,4788,9,4788,3673,9,0,11.11111111111111,53.4
27353,140724,115,0,3799,73,42,33.333333333333336,0.0
27354,10484664,245,0,118876,107,138,2.083333333333333,0.0
27355,624,4,624,21,4,0,20.0,92.01
27356,243756,85,0,13466,43,42,4.761904761904762,0.0
27357,480,36,396,349,34,2,3.125,55.88
27358,240,2,240,24,2,0,25.0,60.8
27359,42888,33,0,2680,28,5,50.0,0.0
27360,204,1,204,12,1,0,33.333333333333336,67.23
27361,281352,180,0,3523,88,92,3.333333333333333,0.0
27362,564,9,564,34,6,3,20.0,57.47
27363,168,0,168,0,0,0,50.0,68.89
27364,792,1,792,24,1,0,33.333333333333336,98.05
27365,9838356,501,0,84492,274,227,1.818181818181818,5.5
27366,120,24,108,32,18,6,6.666666666666667,45.56
27367,540,9,540,97,7,2,16.666666666666668,89.51
27368,11957340,432,0,333871,162,270,2.857142857142857,0.0
27369,1296,1,1296,12,1,0,20.0,38.65
27370,7822596,529,7822596,83154,289,240,1.492537313432836,47.34
27371,9861168,338,0,512329,201,137,1.694915254237288,0.0
27372,11922168,13909,153744,209924,7893,6016,1.0,0.0
27373,3204,3,0,1384,1,2,50.0,0.56
27374,12095196,485,0,733098,257,228,1.0638297872340423,0.0
27375,54096,286,54096,52706,277,9,1.0,0.0
27376,5820936,342,0,27896,176,166,2.0408163265306123,2.07
27377,5416872,127,5416788,98894,57,70,16.666666666666668,0.0
27378,50652,26,50652,178,20,6,6.666666666666667,52.43
27379,18216,1,18216,1332,1,0,20.0,76.72
27380,115140,114,0,18066,83,31,100.0,0.0
27381,12235176,46261,0,5174516,30279,15982,1.0,0.0
27382,11891760,2021,1188348,1151508,1052,969,1.0,3.76
27383,11862336,874,0,58374,489,385,1.0638297872340423,0.0
27384,2220,3,2220,984,2,1,33.333333333333336,89.26
27385,365880,91,0,32653,71,20,100.0,0.0
27386,1047756,0,1047756,0,0,0,50.0,57.76
27387,4740780,134,4740780,24303,52,82,11.11111111111111,86.96
27388,205536,103,205536,304,81,22,1.408450704225352,21.35
27389,540,13,468,221,7,6,25.0,99.55
27390,13728,63,0,583,46,17,100.0,0.0
27391,22428,65,0,1251,42,23,100.0,0.0
27392,192,5,192,31,5,0,14.285714285714286,65.21
27393,260184,13,1992,20440,11,2,11.11111111111111,0.0
27394,21564,1,21564,14052,1,0,33.333333333333336,97.81
27395,9478140,1441,5071968,1650854,655,786,1.0,0.0
27396,11937564,457,0,258943,259,198,1.851851851851852,4.96
27397,312,0,312,0,0,0,100.0,100.0
27398,11086428,447,0,98279,245,202,1.6666666666666667,4.0
27399,88380,62,88380,1712,58,4,1.818181818181818,17.62
27400,1589712,35,0,214496,28,7,100.0,0.0
27401,480,0,480,0,0,0,50.0,60.8
27402,1574892,135,0,40751,47,88,14.285714285714286,0.0
27403,18192,51,0,675,37,14,100.0,0.0
27404,23940,105,0,1238,71,34,100.0,0.0
27405,651336,32,2580,85919,26,6,5.882352941176471,0.0
27406,5222820,727,5220564,68644,367,360,1.2195121951219512,0.0
27407,168,15,168,44,9,6,12.5,82.96
27408,8700,68,0,1134,58,10,100.0,0.0
27409,701676,663,684480,232314,449,214,1.162790697674419,24.72
27410,15096,128,0,1052,87,41,50.0,0.0
27411,108,0,108,0,0,0,50.0,68.89
27412,1731720,40,1731720,33,38,2,2.5641025641025643,20.58
27413,1608,167,1608,969,111,56,1.25,42.73
27414,8971656,85,0,710150,66,19,100.0,0.0
27415,8176680,587,0,118338,262,325,1.5625,0.0
27416,179184,34,2604,8387,27,7,4.761904761904762,0.0
27417,57168,62,0,2857,51,11,100.0,0.0
27418,48336,2,48336,5466,2,0,25.0,88.41
27419,2304,18,2304,848,16,2,6.666666666666667,0.0
27420,9996,36,0,995,30,6,50.0,0.0
27421,5520,2,0,2802,1,1,100.0,0.0
27422,7987884,29,251388,643922,25,4,4.761904761904762,41.41
27423,9041868,921,0,58824,553,368,1.0416666666666667,0.0
27424,159840,11,159840,2787,10,1,12.5,79.98
27425,25476,55,2088,595,47,8,2.272727272727273,27.28
27426,23004,156,5976,412,102,54,1.3333333333333333,0.44
27427,157836,34,2904,6297,29,5,4.0,0.0
27428,22200,2,552,11118,2,0,50.0,33.4
27429,688764,126,0,8759,67,59,5.0,0.0
27430,165060,23,165060,40654,13,10,25.0,99.61
27431,7886064,197,7840194,1246,147,50,1.0,36.17
27432,11169540,989,56052,60371,579,410,1.0,10.0
27433,17856,84,0,1059,58,26,100.0,0.0
27434,13692,51,3216,1392,41,10,3.333333333333333,0.0
27435,14004,20,14004,1595,14,6,12.5,13.03
27436,655464,48,0,17435,32,16,100.0,0.0
27437,25260,29,24876,2837,26,3,4.3478260869565215,59.25
27438,8376,2,1056,4194,2,0,33.333333333333336,0.0
27439,4344,2,516,2220,2,0,50.0,65.03
27440,1568184,56,1568184,5208,50,6,2.1739130434782608,16.54
27441,104832,124,3468,5664,95,29,1.5625,0.0
27442,319176,237,0,4282,127,110,3.333333333333333,1.0
27443,10534116,243,0,53649,140,103,3.4482758620689653,0.0
27444,5636892,151,0,328111,110,41,12.5,0.0
27445,25476,88,0,3591,73,15,100.0,0.0
27446,564,6,564,18,3,3,50.0,64.07
27447,4388436,159,4388436,8162,97,62,2.702702702702702,69.3
27448,9911904,1632,0,96477,904,728,1.0,0.43
27449,9823656,256,926184,492661,100,156,6.666666666666667,0.0
27450,98556,285,98556,1787,232,53,1.162790697674419,27.27
27451,39960,55,39948,10756,38,17,5.0,74.21
27452,12241200,2578,0,1053146,1463,1115,1.0,0.0
27453,1596,63,0,305,50,13,2.702702702702702,0.01
27454,1656,14,1656,648,12,2,11.11111111111111,50.22
27455,1656,12,1656,614,10,2,11.11111111111111,55.09
27456,8184,41,240,278,23,18,6.666666666666667,61.35
27457,11064,2,11064,48,2,0,33.333333333333336,99.74
27458,10313952,815,0,182943,426,389,1.36986301369863,0.0
27459,972,30,972,418,28,2,4.0,75.4
27460,5748,118,216,164,72,46,2.3255813953488373,65.59
27461,228,17,216,39,13,4,8.333333333333334,10.81
27462,4368,15,4368,892,11,4,14.285714285714286,0.0
27463,8721900,175,0,410883,99,76,4.3478260869565215,0.0
27464,420,7,420,10,5,2,25.0,73.56
27465,1140,56,1080,759,50,6,2.127659574468085,52.97
27466,20880,15,0,3911,13,2,100.0,0.0
27467,8261904,569,0,77443,308,261,2.0408163265306123,0.0
27468,2869404,1344,2583504,415721,833,511,1.0,7.02
27469,6000,12,0,772,10,2,100.0,0.0
27470,2584692,1259,2584692,395621,785,474,1.0,7.02
27471,2742276,124,2742276,67821,56,68,8.333333333333334,88.57
27472,8293512,316,4553352,2224,192,124,1.075268817204301,35.4
27473,180,26,132,43,22,4,5.555555555555555,39.59
27474,1860,0,1860,0,0,0,100.0,100.0
27475,408,96,408,243,82,14,1.2987012987012987,33.77
27476,780,26,780,85,26,0,3.703703703703704,33.86
27477,2016,18,2016,828,14,4,7.6923076923076925,5.0
27478,8267748,393,0,38518,218,175,2.3255813953488373,0.0
27479,228,12,228,128,10,2,9.090909090909092,81.23
27480,432,43,0,65,31,12,100.0,0.0
27481,408,86,408,13,82,4,1.2048192771084338,40.22
27482,5991672,45,0,137374,32,13,100.0,0.0
27483,84,43,72,16,35,8,3.225806451612903,30.74
27484,11731464,2567,0,362913,1458,1109,1.0,0.0
27485,288,12,288,62,10,2,11.11111111111111,93.22
27486,288,0,288,0,0,0,100.0,100.0
27487,2340792,296,0,22277,151,145,1.818181818181818,0.0
27488,10857480,641,10857480,1267114,397,244,1.1494252873563218,38.27
27489,4527564,90,4527564,452,46,44,6.25,0.84
27490,204,35,204,77,13,22,12.5,82.95
27491,192,11,192,102,6,5,25.0,95.05
27492,312,6,312,14,5,1,16.666666666666668,73.24
27493,348,10,348,111,9,1,7.6923076923076925,47.65
27494,8217732,2,8217732,37212,1,1,50.0,98.78
27495,204,33,180,72,18,15,16.666666666666668,53.7
27496,4836,97,4836,4287,82,15,1.694915254237288,9.93
27497,8224752,132,8224752,5820,88,44,1.5625,55.76
27498,3024,4,3024,207,2,2,33.333333333333336,0.0
27499,228,8,228,36,6,2,16.666666666666668,56.53
27500,267480,1,259727,12,1,0,33.333333333333336,0.0
27501,1189332,3,1189332,400516,1,2,50.0,1.0
27502,1608,31,1608,1434,27,4,3.703703703703704,78.89
27503,11844408,740,0,113652,360,380,1.25,0.0
27504,37764,12,37764,480,4,8,33.333333333333336,89.77
27505,1596,7,1596,553,5,2,20.0,0.0
27506,659160,554,0,4143,340,214,1.0,0.0
27507,3060,112,0,1066,72,40,100.0,0.0
27508,444,34,444,90,26,8,4.166666666666667,61.39
27509,300,18,300,37,16,2,6.25,52.55
27510,228,7,228,73,5,2,25.0,0.0
27511,828,32,828,171,26,6,4.0,68.09
27512,312,46,312,79,32,14,3.703703703703704,40.01
27513,159972,62,159972,4341,59,3,1.7543859649122806,22.59
27514,1368,41,1368,154,29,12,4.0,67.01
27515,468,50,468,125,41,9,3.571428571428572,74.52
27516,648,1,648,180,1,0,50.0,99.18
27517,231984,241,0,3932,106,135,3.703703703703704,3.0
27518,1260,107,1260,994,59,48,2.631578947368421,54.3
27519,216,194,216,62,128,66,1.0,37.41
27520,192,3,192,36,3,0,20.0,59.61
27521,348,95,348,80,49,46,3.8461538461538463,54.49
27522,12054564,762,0,1362961,425,337,1.2195121951219512,0.0
27523,162000,180,528,2169,84,96,2.9411764705882355,40.76
27524,1332,48,0,307,31,17,100.0,100.0
27525,8372016,172,0,881174,75,97,1.8867924528301887,0.0
27526,1212,12,1104,423,10,2,20.0,26.48
27527,5656704,20,312,282898,20,0,4.761904761904762,63.8
27528,65868,10,65868,4316,9,1,11.11111111111111,82.08
27529,42720,108,42720,3649,93,15,1.408450704225352,5.1
27530,83772,15,456,5747,13,2,9.090909090909092,1.0
27531,348,112,336,58,58,54,3.8461538461538463,61.6
27532,1752,96,0,591,78,18,100.0,0.0
27533,17616,132,0,1239,91,41,100.0,0.0
27534,5066232,290,0,115560,157,133,1.2987012987012987,0.0
27535,144,5,144,33,3,2,33.333333333333336,66.73
27536,564,22,564,48,18,4,1.8867924528301887,56.8
27537,816,89,816,531,51,38,3.125,67.43
27538,12282036,25828,573108,654116,14445,11383,1.0,0.0
27539,1614108,145,0,33853,77,68,7.6923076923076925,0.0
27540,116244,77,116244,7463,70,7,1.4705882352941178,17.82
27541,372,79,360,220,68,11,1.694915254237288,42.33
27542,1992,53,0,429,40,13,2.9411764705882355,0.0
27543,10692192,842,0,194307,473,369,1.0,4.97
27544,11540352,4542,1256616,612429,2872,1670,1.0,0.0
27545,168,5,168,91,3,2,33.333333333333336,66.2
27546,384,60,384,69,58,2,1.7543859649122806,58.57
27547,31344,62,0,1319,52,10,33.333333333333336,0.0
27548,180,6,180,18,3,3,50.0,62.27
27549,408,0,408,0,0,0,50.0,64.0
27550,9303324,448,0,337052,250,198,1.408450704225352,0.0
27551,9022692,1045,0,214695,514,531,1.0,0.0
27552,240,7,240,144,3,4,33.333333333333336,83.61
27553,2859696,126,2859696,46946,56,70,11.11111111111111,88.88
27554,228,2,228,30,1,1,50.0,63.42
27555,12044652,517,0,117090,267,250,2.272727272727273,4.69
27556,7824,87,0,2071,44,43,33.333333333333336,0.0
27557,1632,49,1632,1439,39,10,2.7777777777777777,49.68
27558,432,50,204,90,25,25,6.666666666666667,74.2
27559,936,37,936,120,27,10,4.166666666666667,66.44
27560,3743436,187,0,38139,95,92,6.666666666666667,4.93
27561,168,3,168,16,3,0,20.0,64.96
27562,80700,356,75108,45607,169,187,1.5873015873015872,44.9
27563,192,28,180,44,23,5,4.761904761904762,47.95
27564,4308,21,4068,2857,21,0,4.761904761904762,80.09
27565,504,104,492,291,66,38,2.0408163265306123,28.95
27566,636,20,636,240,17,3,6.666666666666667,87.4
27567,11468256,6840,0,247324,3857,2983,1.0,0.0
27568,4800996,142,0,45109,68,74,6.666666666666667,0.0
27569,648,30,648,119,22,8,5.2631578947368425,68.29
27570,2640,96,636,298,64,32,2.0408163265306123,0.0
27571,2028,38,0,591,31,7,100.0,0.0
27572,8296764,231,8296764,11309,121,110,4.545454545454546,81.8
27573,276,12,276,92,8,4,12.5,91.08
27574,360,88,360,67,63,25,2.380952380952381,39.36
27575,5568,48,5568,1040,44,4,2.272727272727273,62.04
27576,63372,4,63372,1899,4,0,16.666666666666668,85.83
27577,2673252,150,2673252,26768,76,74,4.166666666666667,75.23
27578,37128,70,0,1210,49,21,50.0,0.0
27579,672,27,672,444,25,2,4.3478260869565215,71.79
27580,9902844,497,0,74754,425,72,1.0,0.0
27581,1548,44,1548,174,41,3,3.125,78.23
27582,1853436,166,0,17335,91,75,3.225806451612903,2.0
27583,7056744,57,165204,315032,25,32,1.0,0.0
27584,203172,335,384,940,148,187,2.272727272727273,13.79
27585,276,34,276,74,28,6,4.166666666666667,80.45
27586,336,26,336,144,24,2,4.0,78.69
27587,64092,138,2088,1793,86,52,2.0408163265306123,25.35
27588,4128,9,4128,92,5,4,20.0,85.88
27589,2496,16,2496,96,10,6,11.11111111111111,74.62
27590,9711804,187,552,52140,119,68,1.1111111111111112,23.57
27591,8002728,232,8002728,44553,121,111,2.127659574468085,83.78
27592,11158608,209,0,113110,103,106,4.0,0.0
27593,12134376,1348,245388,128989,697,651,1.0,0.0
27594,804,91,576,336,64,27,2.2222222222222223,27.66
27595,852,59,852,131,52,7,1.96078431372549,31.51
27596,336,2,336,228,1,1,100.0,0.0
27597,396,8,396,24,4,4,50.0,58.4
27598,11161920,103,2559792,126738,48,55,16.666666666666668,96.65
27599,4812,60,4812,284,56,4,2.5,20.45
27600,132,0,132,0,0,0,100.0,80.0
27601,7565304,302,7565304,36939,141,161,2.127659574468085,74.06
27602,356712,116,136716,3340,88,28,1.5873015873015872,43.87
27603,11545812,2664,506148,3293811,1495,1169,1.0,0.0
27604,12408,44,0,640,37,7,100.0,0.0
27605,41832,101,41832,105,77,24,1.6666666666666667,18.07
27606,1863384,115,0,22750,56,59,4.545454545454546,0.0
27607,204,2,204,12,2,0,33.333333333333336,65.06
27608,0,0,0,0,0,0,100.0,0.0
27609,40092,23,40092,4312,16,7,10.0,0.0
27610,18264,56,0,657,41,15,33.333333333333336,0.0
27611,2689296,31,2689296,9617,12,19,16.666666666666668,0.0
27612,7260,36,2796,1707,27,9,25.0,0.0
27613,3036,7,0,1606,5,2,50.0,0.0
27614,11171880,142,5792328,145192,71,71,3.703703703703704,82.39
27615,12310416,1376,0,4920086,672,704,1.0,17.45
27616,122916,13,0,26220,8,5,16.666666666666668,0.0
27617,62376,22,62376,1045,21,1,5.555555555555555,69.74
27618,16428,18,0,2048,17,1,5.555555555555555,0.0
27619,4830852,3,0,3219672,3,0,20.0,2.17
27620,23244,64,0,752,49,15,100.0,0.0
27621,12243972,3651,0,483511,2108,1543,1.0,0.0
27622,10038492,190,0,116129,97,93,4.3478260869565215,0.0
27623,10950648,271,0,3412568,139,132,4.0,0.0
27624,88560,206,0,27214,129,77,100.0,0.0
27625,86964,69,86964,8287,45,24,14.285714285714286,99.8
27626,9962112,170,0,133621,107,63,1.0,0.0
27627,72,8,72,7,6,2,14.285714285714286,92.04
27628,1224,9,1224,58,6,3,20.0,77.33
27629,30720,118,0,684,76,42,100.0,0.0
27630,3252,15,3252,384,13,2,10.0,56.89
27631,26628,2,26628,42,1,1,50.0,55.59
27632,12260268,2082,0,736116,1210,872,1.0,2.75
27633,12268560,399,0,77559,211,188,2.7777777777777777,0.0
27634,22116,108,0,741,81,27,33.333333333333336,0.0
27635,11724,7,168,1758,6,1,20.0,94.57
27636,9622368,368,0,39405,189,179,2.4390243902439024,0.0
27637,10416,54,0,1056,43,11,2.702702702702702,0.0
27638,4572,26,252,666,16,10,12.5,78.0
27639,4836,12,1416,430,12,0,7.6923076923076925,84.6
27640,2362380,5,0,680172,4,1,20.0,3.01
27641,12313920,3843,10560,197403,2186,1657,1.0,4.35
27642,12324,65,0,604,46,19,50.0,0.0
27643,248064,32,0,45393,18,14,6.25,0.0
27644,87732,71,0,7961,57,14,100.0,0.0
27645,255924,10,1692,26235,7,3,20.0,95.72
27646,2220,5,636,1531,4,1,33.333333333333336,90.14
27647,12096,16,0,1432,13,3,100.0,0.0
27648,175752,682,175752,158386,534,148,1.0,29.2
27649,13752,116,0,1001,89,27,50.0,0.0
27650,1144620,450,0,7039,256,194,2.0408163265306123,0.0
27651,285216,7,285216,285075,7,0,11.11111111111111,86.0
27652,7260,62,0,602,45,17,100.0,0.0
27653,80376,48,0,2788,39,9,100.0,0.0
27654,168,0,168,0,0,0,50.0,64.9
27655,1644,9,1644,686,7,2,16.666666666666668,93.44
27656,504,47,504,67,41,6,2.5,59.28
27657,10068,23,0,1277,19,4,100.0,0.0
27658,17232,21,17232,804,20,1,5.2631578947368425,70.89
27659,89868,26,89868,8483,23,3,6.25,0.81
27660,111312,98,0,5093,85,13,100.0,0.0
27661,20604,20,20604,1317,20,0,5.882352941176471,74.99
27662,254280,61,0,5585,43,18,100.0,0.0
27663,36012,124,0,1126,65,59,5.2631578947368425,0.0
27664,14892,78,0,1721,58,20,2.4390243902439024,0.0
27665,420,0,420,0,0,0,100.0,100.0
27666,756,158,684,365,78,80,2.7777777777777777,56.03
27667,379272,193,0,5768,103,90,4.0,0.0
27668,49308,128,49308,9508,88,40,1.2195121951219512,20.14
27669,1236,21,1236,312,17,4,5.882352941176471,4.14
27670,11434860,0,11434860,0,0,0,100.0,100.0
27671,11272284,977,0,96890,515,462,1.2345679012345678,0.0
27672,8232,23,0,3464,18,5,50.0,0.0
27673,11854500,3444,0,331531,1882,1562,1.0,1.8
27674,12040104,1080,0,452979,604,476,1.1764705882352942,0.0
27675,2294196,492,35460,111098,305,187,2.1739130434782608,0.0
27676,11101392,142,0,632938,105,37,16.666666666666668,0.0
27677,96,21,96,41,14,7,11.11111111111111,70.62
27678,12312960,1805,0,8379355,1018,787,1.0,4.0
27679,2256,2,2256,570,2,0,50.0,28.51
27680,156,14,144,48,11,3,9.090909090909092,50.72
27681,180552,478,101712,33013,287,191,11.11111111111111,19.74
27682,83904,43,83904,1690,39,4,7.6923076923076925,91.24
27683,588,44,168,95,23,21,6.25,62.93
27684,2280,41,0,812,30,11,4.0,0.0
27685,12264504,3634,3134172,1825161,2006,1628,1.0,0.0
27686,2943720,196,1583382,745,160,36,1.0,28.34
27687,3084,5,3084,734,4,1,50.0,0.0
27688,24120,117,24120,481,92,25,1.3157894736842106,17.61
27689,264,37,264,133,27,10,4.166666666666667,39.19
27690,24360,53,0,2393,40,13,25.0,0.0
27691,1776,66,0,706,50,16,2.5,0.0
27692,10997652,95,5630676,2033150,54,41,1.2987012987012987,0.0
27693,4272,23,4272,3030,9,14,20.0,97.61
27694,888,59,888,189,35,24,4.0,68.4
27695,46800,59,648,1168,53,6,2.272727272727273,60.52
27696,5184,34,0,1009,29,5,3.703703703703704,0.0
27697,2520,0,1458,0,0,0,100.0,0.0
27698,28020,118,0,1730,74,44,100.0,0.0
27699,1140,1,1140,492,1,0,100.0,97.09
27700,432,75,432,163,71,4,2.083333333333333,58.22
27701,26304,129,26304,563,94,35,1.4285714285714286,44.56
27702,1248,5,1248,292,4,1,25.0,98.88
27703,174036,8,174036,369,7,1,20.0,88.03
27704,11206404,362,0,89021,188,174,2.3255813953488373,0.0
27705,12214920,917,0,2619848,533,384,1.0,0.0
27706,3384,5,3384,180,5,0,14.285714285714286,81.98
27707,1164,16,1164,732,12,4,9.090909090909092,89.13
27708,250464,5,0,142857,4,1,100.0,0.0
27709,216,2,216,78,1,1,50.0,88.53
27710,924,94,924,610,62,32,2.083333333333333,64.73
27711,8818824,430,0,51651,220,210,1.8867924528301887,4.49
27712,372,55,372,125,27,28,6.666666666666667,0.0
27713,372900,106,0,8454,44,62,7.6923076923076925,0.0
27714,408,44,0,112,30,14,100.0,0.0
27715,16980,50,16980,712,38,12,2.857142857142857,52.66
27716,178596,1,178596,84,1,0,33.333333333333336,71.4
27717,501636,9,501636,97,5,4,50.0,99.16
27718,1368,2,1368,774,2,0,50.0,92.9
27719,336,7,336,161,7,0,11.11111111111111,93.01
27720,264,44,204,92,40,4,2.5,24.43
27721,1548408,99,1104,16465,63,36,2.127659574468085,67.96
27722,87048,224,540,655,183,41,1.0,0.0
27723,194532,44,0,7964,30,14,100.0,0.0
27724,12380676,11213,7569212,5975905,6198,5015,1.0,0.0
27725,468,104,468,220,51,53,5.0,83.84
27726,132,2,120,108,2,0,33.333333333333336,59.28
27727,12648,7,0,4815,6,1,33.333333333333336,0.0
27728,4332,9,2508,880,6,3,16.666666666666668,0.0
27729,204,4,204,84,3,1,25.0,60.12
27730,136332,71,136332,20764,31,40,11.11111111111111,78.29
27731,12372504,2299,0,1215740,1202,1097,1.0,0.0
27732,434856,49,0,230677,37,12,8.333333333333334,0.0
27733,2160,67,0,658,48,19,100.0,0.0
27734,144,3,144,24,3,0,20.0,59.2
27735,120,0,120,0,0,0,50.0,68.89
27736,2184,8,2184,268,8,0,16.666666666666668,91.15
27737,996,53,996,55,46,7,2.272727272727273,37.93
27738,7161372,46,1519368,2445706,38,8,2.127659574468085,35.13
27739,708,2,708,360,2,0,50.0,99.12
27740,10916676,546,0,82791,231,315,1.6666666666666667,0.0
27741,1440,54,0,1005,48,6,100.0,0.0
27742,28536,96,28536,318,84,12,1.25,28.08
27743,13944,44,0,542,33,11,100.0,0.0
27744,1968,33,1968,71,21,12,5.882352941176471,73.48
27745,8184,14,8184,539,12,2,20.0,61.15
27746,1308,42,0,388,35,7,3.4482758620689653,0.0
27747,11167632,787,0,77147,449,338,1.1764705882352942,0.0
27748,360,28,288,188,17,11,8.333333333333334,63.14
27749,420,1,420,60,1,0,50.0,98.25
27750,204,5,204,88,3,2,33.333333333333336,79.53
27751,156,8,108,52,6,2,14.285714285714286,57.02
27752,540,30,540,55,24,6,4.3478260869565215,67.95
27753,975348,94,0,21772,39,55,9.090909090909092,0.0
27754,11667360,834,0,94068,358,476,1.0,0.0
27755,7626216,1226,0,64181,755,471,1.0,0.0
27756,600,56,600,63,44,12,2.5,67.47
27757,872352,3,872352,1820,2,1,50.0,99.01
27758,3912,26,1776,657,20,6,5.555555555555555,51.29
27759,231144,99,231144,7174,79,20,100.0,0.0
27760,2100,34,2100,182,26,8,4.166666666666667,67.01
27761,295464,15,295464,3852,5,10,50.0,99.71
27762,540,24,540,318,20,4,5.0,81.89
27763,2868,4,2868,1323,2,2,33.333333333333336,98.92
27764,7365096,129,7365000,136494,47,82,8.333333333333334,0.0
27765,74964,78,0,4410,69,9,100.0,0.0
27766,132,15,132,36,11,4,11.11111111111111,47.48
27767,3347328,42,972,80974,30,12,4.3478260869565215,75.99
27768,2897652,311,2897652,9735,146,165,3.4482758620689653,74.18
27769,2376,182,2376,884,115,67,1.1235955056179776,36.78
27770,2628,33,2628,474,13,20,20.0,93.05
27771,12242244,1266,0,5939558,670,596,1.0,0.0
27772,7290684,511,0,84908,260,251,1.0,0.0
27773,6948,143,6936,5550,109,34,1.2345679012345678,0.0
27774,1812,9,1812,673,8,1,14.285714285714286,86.5
27775,1055088,222,659088,285909,192,30,1.0,0.0
27776,12378336,866,2471244,4665902,519,347,1.0,0.99
27777,180,5,180,67,4,1,20.0,58.83
27778,108,0,108,0,0,0,50.0,60.84
27779,1320,34,1320,1057,24,10,4.761904761904762,83.42
27780,180,69,180,51,53,16,2.702702702702702,31.49
27781,492,14,492,93,9,5,16.666666666666668,0.0
27782,2576856,242,2576856,22153,133,109,3.703703703703704,81.76
27783,10388616,2549,4777368,504471,1487,1062,1.0,0.0
27784,300,14,300,32,6,8,25.0,67.42
27785,576252,39,576252,6486,16,23,20.0,97.31
27786,96,5,96,24,4,1,20.0,55.55
27787,2671104,280,2671104,35541,124,156,3.0303030303030303,80.15
27788,92556,77,696,2735,49,28,2.7777777777777777,74.1
27789,608628,320,0,6761,180,140,3.225806451612903,0.0
27790,180,0,180,0,0,0,100.0,80.0
27791,981312,177,0,7220,86,91,4.761904761904762,3.85
27792,888,10,864,396,10,0,10.0,87.8
27793,72,0,72,0,0,0,50.0,68.89
27794,10260,9,10260,100,5,4,33.333333333333336,60.12
27795,252,9,0,86,5,4,50.0,0.0
27796,12207732,1319,0,528109,698,621,1.1111111111111112,7.73
27797,144,0,144,0,0,0,50.0,68.89
27798,10750116,279,10750116,4253,151,128,2.9411764705882355,82.17
27799,432,38,432,100,26,12,4.545454545454546,82.87
27800,1368,7,1368,1157,7,0,11.11111111111111,81.96
27801,276,220,240,119,134,86,1.3333333333333333,43.64
27802,456,75,456,119,57,18,2.1739130434782608,37.74
27803,2678688,39,2678688,106658,19,20,7.6923076923076925,0.0
27804,11907432,84,564,141962,37,47,6.25,0.0
27805,11483292,772,0,1062713,499,273,1.1494252873563218,0.0
27806,768,37,768,635,27,10,4.166666666666667,72.39
27807,532452,72,383802,54820,60,12,2.083333333333333,4.07
27808,1380,137,0,140,118,19,1.0,0.0
27809,196008,32,360,8116,23,9,11.11111111111111,76.49
27810,414948,158,0,13438,119,39,100.0,0.0
27811,156,5,156,40,5,0,14.285714285714286,91.9
27812,16044,3,16044,4832,3,0,20.0,84.14
27813,324,25,252,104,16,9,8.333333333333334,55.55
27814,12179448,966,0,106528,549,417,1.098901098901099,0.0
27815,19632,108,0,1308,45,63,25.0,0.0
27816,780,214,780,231,121,93,2.380952380952381,56.45
27817,54804,108,54804,531,93,15,1.2345679012345678,31.99
27818,4292472,93,683180,333036,44,49,3.571428571428572,0.0
27819,5124,20,0,702,16,4,100.0,0.0
27820,30276,177,0,1720,120,57,50.0,0.0
27821,5570484,20,0,395492,10,10,7.6923076923076925,0.48
27822,11412,156,11412,6815,67,89,3.125,68.13
27823,4421052,0,4421052,0,0,0,6.666666666666667,33.55
27824,492,105,480,147,76,29,1.6129032258064515,44.04
27825,8426832,1059,476976,72141,1007,52,1.075268817204301,95.44
27826,11353332,150,0,81455,113,37,4.166666666666667,0.0
27827,18516,116,0,1317,74,42,33.333333333333336,0.0
27828,115872,63,115872,27815,61,2,1.639344262295082,19.85
27829,12216420,3101,11480808,658814,1627,1474,1.0,0.0
27830,10704,0,10704,0,0,0,12.5,4.0
27831,4128,10,0,950,7,3,100.0,0.0
27832,8787984,949,0,262705,516,433,1.0526315789473684,0.0
27833,7464,0,7464,0,0,0,3.125,50.0
27834,5187120,89,0,224308,71,18,100.0,0.0
27835,16992,19,16992,861,19,0,6.666666666666667,80.94
27836,252,49,252,39,39,10,2.7777777777777777,34.28
27837,2770224,150,2770224,10869,83,67,4.0,0.0
27838,242292,91,0,63027,60,31,2.380952380952381,0.0
27839,24432,65,0,3099,51,14,100.0,0.0
27840,11705640,3461,265428,368144,1615,1846,1.0,5.0
27841,12417180,3587,0,5027484,2133,1454,1.0,0.0
27842,13368,92,0,1836,66,26,100.0,0.0
27843,4608,23,4608,4283,22,1,5.882352941176471,74.65
27844,324,6,324,12,5,1,16.666666666666668,71.28
27845,21744,4,21744,516,2,2,50.0,62.59
27846,11934384,1769,2233014,1715989,1011,758,1.0,0.0
27847,2675640,84,2675640,1734,37,47,9.090909090909092,92.34
27848,3900,27,3900,80,23,4,4.3478260869565215,69.11
27849,7524,60,0,520,45,15,50.0,0.0
27850,4464,24,4464,228,22,2,4.3478260869565215,63.27
27851,12171912,431,0,157921,220,211,2.4390243902439024,3.94
27852,3720,21,3720,456,17,4,12.5,43.28
27853,432,20,432,172,12,8,11.11111111111111,58.58
27854,139824,452,98528,70280,291,161,1.0,21.82
27855,57612,46,0,4502,30,16,100.0,0.0
27856,481104,96,0,7655,54,42,6.25,0.0
27857,10284,4,10284,10197,3,1,33.333333333333336,3.99
27858,3000240,138,3000228,23659,93,45,1.3888888888888888,0.0
27859,8552160,23,342660,392071,20,3,7.142857142857143,72.26
27860,12888,213,0,2653,153,60,100.0,0.0
27861,288,0,288,0,0,0,100.0,100.0
27862,669672,13,669672,8180,9,4,25.0,78.64
27863,164796,119,164796,34396,93,26,100.0,0.0
27864,12660,8,12660,1147,7,1,8.333333333333334,43.21
27865,635568,56,635568,15089,45,11,2.3255813953488373,15.85
27866,6756,10,6756,2840,6,4,16.666666666666668,95.56
27867,456,2,456,78,1,1,50.0,75.22
27868,19908,22,19908,828,20,2,5.882352941176471,74.73
27869,1764,1,1764,0,1,0,33.333333333333336,98.0
27870,399408,235,192216,73810,118,117,5.882352941176471,3.96
27871,353364,38,283680,18966,29,9,100.0,0.0
27872,3432,458,3432,1263,272,186,1.1904761904761905,0.0
27873,143928,63,0,4906,50,13,100.0,0.0
27874,12528,69,0,728,47,22,25.0,0.0
27875,6012,71,0,946,51,20,100.0,0.0
27876,972,0,972,0,0,0,50.0,90.0
27877,12047172,1065,11936148,406401,593,472,1.0869565217391304,1.95
27878,8076,8,4440,3159,5,3,33.333333333333336,62.73
27879,12348,48,552,584,41,7,2.631578947368421,36.55
27880,93372,50,0,2940,43,7,100.0,0.0
27881,1141968,112,0,15078,95,17,100.0,0.0
27882,5568,20,0,1181,16,4,50.0,0.0
27883,1463652,3,0,493160,2,1,100.0,0.0
27884,4776,151,0,153,122,29,1.0,0.0
27885,108,5,108,12,4,1,20.0,68.87
27886,11951844,318,5276196,952821,170,148,2.272727272727273,46.32
27887,13872,17,0,1629,14,3,100.0,0.0
27888,55896,36,55896,49481,22,14,5.882352941176471,34.28
27889,7908,0,7908,0,0,0,100.0,100.0
27890,3024,8,0,1579,5,3,50.0,0.0
27891,12108,23,12108,893,20,3,6.25,72.79
27892,9168432,382,9168432,2812,183,199,3.703703703703704,82.9
27893,52668,23,52668,2443,18,5,5.882352941176471,73.01
27894,12036288,2446,24528,64138,1372,1074,1.0,0.48
27895,1704,38,1704,126,34,4,4.761904761904762,67.75
27896,4164,40,0,964,29,11,100.0,0.0
27897,27612,18,27612,578,16,2,7.6923076923076925,63.79
27898,352716,17,352716,813,16,1,9.090909090909092,65.84
27899,10890396,645,10472611,540949,349,296,1.4285714285714286,0.0
27900,2685708,156,2685708,70556,79,77,3.703703703703704,78.88
27901,32364,63,0,1971,41,22,100.0,0.0
27902,11519292,814,0,139303,444,370,1.818181818181818,0.0
27903,4596444,81,4596444,7952,37,44,6.666666666666667,84.77
27904,7667724,122,0,141349,93,29,12.5,0.0
27905,6283416,113,0,144614,96,17,100.0,0.0
27906,11645232,58,0,214938,55,3,100.0,0.0
27907,363108,47,0,9007,32,15,100.0,0.0
27908,2376,56,0,785,43,13,2.631578947368421,0.0
27909,5616,2,5616,546,2,0,50.0,0.0
27910,12396,122,12396,210,100,22,1.1494252873563218,21.89
27911,83940,1488,83778,8560,964,524,1.0,0.0
27912,138696,29,948,4818,24,5,4.3478260869565215,55.16
27913,1248468,39,0,32501,25,14,6.666666666666667,0.0
27914,5187768,44,5186948,6697,17,27,11.11111111111111,0.0
27915,10393188,575,10393188,25446,245,330,1.96078431372549,71.95
27916,2084604,283,1249686,24710,179,104,5.882352941176471,60.45
27917,2100,18,0,518,14,4,100.0,0.0
27918,206508,46,0,6797,41,5,100.0,0.0
27919,30852,23,30852,829,21,2,7.6923076923076925,69.72
27920,8112,3,8112,8016,3,0,20.0,77.44
27921,1932,3,1932,836,3,0,33.333333333333336,0.0
27922,22020,54,0,1641,51,3,100.0,0.0
27923,588,6,588,226,4,2,25.0,69.52
27924,10762332,266,3875832,1641470,150,116,1.075268817204301,0.0
27925,420,14,420,138,12,2,7.6923076923076925,88.72
27926,1860636,7,1860636,53070,4,3,33.333333333333336,91.92
27927,1716,4,1716,738,4,0,25.0,16.62
27928,38256,51,0,2144,36,15,100.0,0.0
27929,192,4,192,3,4,0,16.666666666666668,57.6
27930,12397440,7812,0,1730621,4723,3089,1.0,0.0
27931,2100,6,2100,670,5,1,16.666666666666668,62.34
27932,180,7,180,58,4,3,33.333333333333336,62.34
27933,10380,5,10380,1123,4,1,50.0,98.79
27934,10800096,1193,0,90733,680,513,1.020408163265306,0.0
27935,720,63,720,399,42,21,3.333333333333333,73.52
27936,5511780,75,5511780,14884,38,37,5.555555555555555,43.68
27937,39276,15,0,3358,13,2,100.0,0.0
27938,84,2,84,30,1,1,50.0,48.29
27939,1848168,114,0,17717,80,34,100.0,0.0
27940,43380,21,0,12124,14,7,100.0,0.0
27941,552,88,552,37,86,2,2.127659574468085,59.05
27942,9348348,923,0,26217,500,423,1.075268817204301,0.0
27943,5156928,1251,3250980,135087,747,504,1.1764705882352942,77.59
27944,48168,139,48168,2678,103,36,1.492537313432836,4.28
27945,2057508,24,0,150794,17,7,12.5,0.0
27946,12017196,250,0,122007,137,113,3.333333333333333,0.01
27947,768,2,768,240,2,0,25.0,94.24
27948,792,112,0,171,87,25,100.0,100.0
27949,1080,3,1080,0,3,0,20.0,94.0
27950,12416400,4468,669144,1275381,2476,1992,1.0,8.6
27951,480,82,480,120,64,18,1.7543859649122806,53.7
27952,1260,53,1260,179,49,4,3.333333333333333,31.36
27953,252,49,252,93,33,16,5.2631578947368425,24.4
27954,72,9,72,6,9,0,10.0,0.0
27955,4008,81,0,904,54,27,50.0,0.0
27956,2508,50,2508,55,47,3,2.127659574468085,56.86
27957,216,10,216,24,10,0,8.333333333333334,64.15
27958,2855772,63,2855772,3186,55,8,1.851851851851852,0.0
27959,3720,177,3720,2244,107,70,1.7241379310344829,48.64
27960,408,51,408,59,49,2,2.0,56.25
27961,382440,0,382440,0,0,0,100.0,100.0
27962,832860,137,416508,1371,80,57,3.333333333333333,82.38
27963,8771688,596,8771688,15653,368,228,1.5384615384615383,78.56
27964,10884,7,10884,2588,4,3,100.0,100.0
27965,240,108,240,45,92,16,1.162790697674419,33.75
27966,9290700,3025,0,45588,1678,1347,1.0,0.5
27967,420,21,420,49,15,6,8.333333333333334,80.85
27968,148464,80,204,1912,46,34,7.6923076923076925,83.3
27969,8918148,58,2721096,201263,30,28,11.11111111111111,91.55
27970,924,14,0,571,11,3,100.0,0.0
27971,8695560,69,8695560,324,33,36,16.666666666666668,0.0
27972,47580,38,47580,1277,29,9,100.0,0.0
27973,4458960,20,4458960,3499,10,10,14.285714285714286,24.85
27974,5285448,397,0,57288,229,168,1.6129032258064515,0.0
27975,12092712,292,8697288,85112,149,143,3.8461538461538463,0.0
27976,11191320,261,3629688,47745,136,125,3.571428571428572,82.41
27977,17148,111,11844,971,82,29,1.36986301369863,25.95
27978,2547972,46,2547972,6658,30,16,5.0,77.39
27979,168,4,168,54,2,2,33.333333333333336,49.84
27980,86172,9,86172,12604,7,2,14.285714285714286,86.06
27981,8699256,66,8699256,4587,34,32,5.555555555555555,0.0
27982,55428,95,55428,3118,71,24,1.8867924528301887,6.4
27983,132,11,132,70,8,3,14.285714285714286,87.03
27984,30108,136,0,2353,92,44,33.333333333333336,0.0
27985,4056360,80,4056120,1063008,74,6,1.0,0.0
27986,1644,3,1644,1344,3,0,20.0,94.0
27987,2731368,102,2731368,9889,40,62,14.285714285714286,0.0
27988,57720,79,57720,2591,63,16,1.639344262295082,34.38
27989,2907144,170,2907144,29705,82,88,6.25,0.0
27990,138960,120,138960,529,82,38,1.639344262295082,29.27
27991,456,31,456,262,20,11,8.333333333333334,0.0
27992,444,127,420,217,77,50,1.851851851851852,0.0
27993,4039332,5,4039332,463,3,2,50.0,78.89
27994,2668536,77,2668536,4739,45,32,4.0,43.63
27995,3771660,121,0,34499,81,40,25.0,0.0
27996,7380,28,672,421,26,2,4.0,76.63
27997,313428,72,313428,60687,44,28,4.761904761904762,89.67
27998,9044076,346,1544664,1752831,110,236,4.3478260869565215,0.0
27999,10045980,173,0,59149,109,64,1.1904761904761905,5.0
28000,1267068,190,0,13077,96,94,11.11111111111111,0.0
28001,9520788,1398,0,239218,784,614,1.0638297872340423,0.0
28002,325980,19,0,36678,13,6,50.0,0.0
28003,2928,6,2928,98,3,3,100.0,0.0
28004,12325848,963,408,307770,519,444,1.639344262295082,0.0
28005,84,0,84,0,0,0,100.0,100.0
28006,1104,15,1104,237,9,6,14.285714285714286,0.0
28007,360,2,360,108,1,1,100.0,100.0
28008,624,53,624,62,35,18,3.4482758620689653,60.67
28009,4116,10,4116,625,10,0,10.0,85.5
28010,12421164,9273,4244196,330074,5319,3954,1.0,0.0
28011,1992,123,1992,353,99,24,1.1235955056179776,22.51
28012,156,38,156,48,32,6,3.333333333333333,0.61
28013,40572,113,0,965,87,26,50.0,0.0
28014,876,17,876,31,12,5,11.11111111111111,62.8
28015,9144,347,0,597,237,110,100.0,0.0
28016,39684,275,0,6951,196,79,100.0,0.0
28017,2460,69,0,606,41,28,100.0,100.0
28018,3723180,899,0,85868,476,423,1.0,0.0
28019,44004,126,0,5261,93,33,4.166666666666667,0.0
28020,8024292,229,5476596,522908,112,117,1.9230769230769231,35.12
28021,41556,46,0,1340,36,10,50.0,0.0
28022,2004,12,1080,497,9,3,12.5,58.35
28023,2725944,309,2725944,28593,207,102,1.4705882352941178,43.52
28024,9598344,77,0,125240,57,20,25.0,0.0
28025,23256,122,23256,2121,97,25,1.492537313432836,6.06
28026,46200,39,0,2269,35,4,100.0,0.0
28027,828,8,828,84,5,3,33.333333333333336,77.69
28028,109392,8,0,21264,6,2,33.333333333333336,0.0
28029,10952472,1280,0,74279,732,548,1.0,0.0
28030,49392,44,0,3298,36,8,100.0,0.0
28031,7841940,67,5163168,251092,18,49,1.0,58.84
28032,576,46,576,57,34,12,3.333333333333333,53.71
28033,11830836,3071,0,253345,1737,1334,1.0,0.0
28034,143688,47,0,9880,42,5,100.0,0.0
28035,360,75,360,102,45,30,3.333333333333333,57.66
28036,11515200,248,0,327913,104,144,2.5,2.42
28037,372,2,372,0,2,0,25.0,78.24
28038,11606424,70,11606424,18092,32,38,7.142857142857143,82.56
28039,39504,32,39504,1522,28,4,3.571428571428572,58.67
28040,37068,133,0,1274,91,42,33.333333333333336,0.0
28041,72816,86,72816,1765,72,14,1.4285714285714286,20.33
28042,1812,67,1812,414,55,12,6.666666666666667,35.51
28043,3072,22,0,1092,17,5,100.0,0.0
28044,36984,41,0,1099,30,11,100.0,0.0
28045,432,52,432,135,48,4,2.5,68.79
28046,11160888,135,859084,649226,52,83,10.0,0.0
28047,1140,20,756,469,17,3,7.142857142857143,80.74
28048,11155116,167,950828,601621,68,99,5.555555555555555,0.0
28049,86268,121,0,9477,96,25,16.666666666666668,0.0
28050,276,68,276,98,54,14,2.083333333333333,58.05
28051,1056,1,1056,264,1,0,50.0,98.9
28052,5901864,364,0,18171,195,169,2.3255813953488373,0.0
28053,42696,136,0,1562,97,39,100.0,0.0
28054,40728,12,40728,2687,9,3,25.0,95.51
28055,288,36,288,51,24,12,5.0,73.61
28056,312,41,312,85,37,4,2.7777777777777777,62.88
28057,12488100,5184,0,3300684,3022,2162,1.0,0.0
28058,1212,106,1212,177,81,25,1.408450704225352,47.82
28059,1704,33,0,592,28,5,4.166666666666667,0.0
28060,1560,1,1560,0,1,0,33.333333333333336,73.5
28061,948,8,828,346,6,2,14.285714285714286,60.79
28062,37404,40,684,997,36,4,2.702702702702702,48.45
28063,33168,26,1020,1704,23,3,5.2631578947368425,45.82
28064,90540,48,0,3169,33,15,100.0,0.0
28065,528,18,432,78,15,3,6.666666666666667,47.01
28066,4560,40,0,975,31,9,3.8461538461538463,0.0
28067,39432,15,39432,952,14,1,8.333333333333334,67.79
28068,360,3,360,92,3,0,20.0,84.47
28069,10689984,229,0,503183,119,110,7.6923076923076925,0.0
28070,1428,6,1428,556,4,2,25.0,96.61
28071,1404,1,1404,0,1,0,33.333333333333336,78.8
28072,1080,16,1080,406,16,0,5.882352941176471,67.82
28073,8004,34,8004,511,26,8,4.166666666666667,66.25
28074,228,46,228,66,28,18,5.555555555555555,55.75
28075,264,22,228,99,14,8,9.090909090909092,74.03
28076,3000,7,3000,459,6,1,20.0,0.0
28077,1752,40,1752,717,37,3,3.703703703703704,44.23
28078,276,2,276,96,2,0,25.0,65.47
28079,468,5,468,160,5,0,14.285714285714286,90.01
28080,516,93,516,31,91,2,1.9230769230769231,55.96
28081,816,12,816,220,10,2,10.0,70.22
28082,1500,3,1188,812,3,0,50.0,0.0
28083,1692,24,1692,745,24,0,11.11111111111111,59.71
28084,168,17,168,48,9,8,33.333333333333336,62.24
28085,132,3,132,12,3,0,8.333333333333334,3.98
28086,11670300,3711,0,144952,2117,1594,1.0,0.0
28087,5001924,859,3817152,92483,417,442,1.2987012987012987,3.47
28088,12144,52,0,516,36,16,50.0,0.0
28089,12996,128,0,1171,84,44,100.0,100.0
28090,1944,29,1944,888,28,1,11.11111111111111,55.75
28091,780,133,612,226,82,51,1.96078431372549,64.49
28092,74112,17,936,263,14,3,7.6923076923076925,42.61
28093,4956,2,4956,114,2,0,25.0,54.69
28094,660,48,660,124,45,3,3.0303030303030303,28.43
28095,120,8,120,55,4,4,50.0,76.8
28096,8673636,467,1347696,370621,300,167,1.0,0.0
28097,744,49,744,49,47,2,2.083333333333333,56.54
28098,11637636,607,0,613471,339,268,1.851851851851852,0.0
28099,2832,25,2832,816,24,1,16.666666666666668,36.15
28100,180,17,180,64,17,0,5.2631578947368425,83.02
28101,871932,333,0,14604,190,143,2.1739130434782608,5.96
28102,9396,377,9396,202,198,179,2.3255813953488373,73.6
28103,1260,35,1260,570,35,0,2.7777777777777777,66.12
28104,8640,26,8640,666,22,4,5.882352941176471,72.05
28105,144984,65,0,2666,50,15,2.0,0.76
28106,2388,13,2388,615,12,1,16.666666666666668,82.13
28107,2807760,228,1616472,105692,118,110,1.7241379310344829,63.68
28108,1236,94,1236,61,92,2,1.96078431372549,52.11
28109,504,17,504,111,11,6,14.285714285714286,47.44
28110,564,42,528,165,36,6,3.0303030303030303,46.44
28111,912,1,0,912,0,1,100.0,0.0
28112,372,14,372,305,14,0,5.882352941176471,72.65
28113,4500,141,2736,1485,106,35,1.7543859649122806,46.01
28114,1384008,172,49296,10733,131,41,1.25,3.42
28115,336,11,240,106,8,3,12.5,0.0
28116,348,130,348,135,68,62,3.8461538461538463,72.21
28117,52032,7,52032,1690,5,2,25.0,75.79
28118,3444,29,3444,693,28,1,11.11111111111111,44.0
28119,1248,142,1068,200,115,27,1.162790697674419,26.87
28120,1068,89,978,595,60,29,2.2222222222222223,52.61
28121,26016,51,26016,809,39,12,2.7777777777777777,47.78
28122,10905348,859,0,25033,464,395,1.5873015873015872,0.0
28123,154200,58,154200,43535,50,8,3.225806451612903,3.12
28124,480,69,480,142,57,12,1.8867924528301887,58.58
28125,11016276,219,0,121104,111,108,3.703703703703704,0.0
28126,26364,102,0,769,71,31,100.0,0.0
28127,23628,518,23628,1761,265,253,3.225806451612903,84.0
28128,1692,51,1692,1347,31,20,4.3478260869565215,78.54
28129,3744,32,3744,557,31,1,9.090909090909092,47.57
28130,2174580,45,0,83320,29,16,100.0,0.0
28131,13020,69,0,1524,45,24,50.0,0.0
28132,384,26,384,54,24,2,4.0,46.81
28133,132,0,132,0,0,0,50.0,67.24
28134,2917980,10,2917980,78691,8,2,16.666666666666668,78.37
28135,4836,201,0,1147,135,66,100.0,0.0
28136,81792,86,81792,5568,69,17,100.0,0.0
28137,12466104,7116,0,545326,3950,3166,1.0,1.0
28138,19476,153,19476,2613,92,61,1.3333333333333333,39.08
28139,15516,52,924,407,49,3,2.0408163265306123,0.0
28140,2940,47,2940,148,33,14,3.571428571428572,59.11
28141,2640,121,0,1229,83,38,100.0,0.0
28142,3984,2,3984,108,1,1,50.0,63.42
28143,227904,70,0,7111,47,23,100.0,0.0
28144,11960376,814,11960376,53333,442,372,1.098901098901099,60.64
28145,11106996,160,3331464,579960,66,94,5.2631578947368425,0.0
28146,12481620,6482,0,1649264,4835,1647,1.0,0.0
28147,306564,4,306564,45,3,1,25.0,95.89
28148,83160,22,83160,5047,14,8,16.666666666666668,76.71
28149,46092,19,15228,3165,16,3,7.142857142857143,77.01
28150,1034496,111,876,9473,96,15,1.1494252873563218,42.68
28151,41172,137,0,4123,104,33,12.5,0.0
28152,12336768,1062,0,115804,567,495,1.5625,0.0
28153,180,5,180,36,4,1,20.0,56.41
28154,113556,26,107184,16739,19,7,14.285714285714286,81.17
28155,110508,13,0,25970,10,3,50.0,0.0
28156,2796,81,0,873,59,22,100.0,0.0
28157,126384,265,0,10868,188,77,100.0,0.0
28158,90492,38,0,7924,27,11,33.333333333333336,0.0
28159,2713740,722,216996,167390,549,173,1.0,52.04
28160,420,45,252,98,37,8,2.9411764705882355,47.14
28161,41364,185,0,3056,124,61,50.0,0.0
28162,74148,33,6816,2946,32,1,10.0,47.68
28163,597036,32,597036,2775,25,7,4.545454545454546,56.51
28164,261660,32,0,20069,23,9,50.0,0.0
28165,3000,76,0,893,56,20,100.0,0.0
28166,127812,239,126408,4263,183,56,1.2658227848101269,64.01
28167,5547912,67,0,89094,45,22,50.0,0.0
28168,170268,2,170268,22878,2,0,25.0,49.47
28169,11688480,2780,327156,122092,1580,1200,1.0,0.0
28170,33816,34,4128,1676,32,2,9.090909090909092,46.01
28171,13272,42,13272,10239,42,0,5.2631578947368425,66.65
28172,47316,108,0,1741,73,35,50.0,0.0
28173,9022260,490,0,60308,285,205,2.2222222222222223,0.0
28174,15504,0,15504,0,0,0,100.0,100.0
28175,5201196,321,5201196,3597,134,187,1.8867924528301887,61.32
28176,143748,48,143748,37082,41,7,4.0,0.57
28177,108,0,108,0,0,0,50.0,64.0
28178,480,0,480,0,0,0,50.0,75.0
28179,18504,6,348,9282,5,1,20.0,63.3
28180,7716,62,7716,150,52,10,2.083333333333333,60.6
28181,1656,84,0,550,61,23,100.0,0.0
28182,9040776,24,146988,513069,19,5,8.333333333333334,61.46
28183,4320,41,3372,957,39,2,9.090909090909092,31.47
28184,872988,4,0,645606,2,2,5.2631578947368425,0.0
28185,11124,151,0,1023,106,45,100.0,0.0
28186,6207588,549,0,34910,299,250,2.0,0.0
28187,39912,124,0,1595,81,43,100.0,0.0
28188,8490660,209,0,1400226,180,29,16.666666666666668,0.0
28189,3360,52,3360,712,51,1,10.0,35.45
28190,26856,21,26856,984,20,1,5.555555555555555,78.76
28191,744,91,744,32,88,3,2.0408163265306123,58.16
28192,6543492,63,0,612263,43,20,100.0,0.0
28193,408,0,408,0,0,0,100.0,100.0
28194,540120,1488,391676,124169,1395,93,10.0,61.81
28195,20160,80,0,2245,65,15,14.285714285714286,0.0
28196,154356,18,154356,7649,18,0,11.11111111111111,68.53
28197,1152,49,432,52,48,1,2.0408163265306123,58.28
28198,816,90,816,50,89,1,1.96078431372549,56.04
28199,9772860,216,1452,46614,177,39,1.0,25.41
28200,5160,43,5160,297,19,24,100.0,100.0
28201,17076,32,16904,9835,22,10,5.882352941176471,13.37
28202,5693760,52,0,223875,33,19,8.333333333333334,0.0
28203,5390472,126,0,108928,56,70,6.25,0.0
28204,31512,109,31512,462,46,63,12.5,95.48
28205,12471672,6875,0,470311,3769,3106,1.0,0.0
28206,150240,16,150240,575,14,2,9.090909090909092,72.53
28207,13596,106,0,2612,87,19,100.0,0.0
28208,7728,11,0,1048,9,2,100.0,0.0
28209,576,98,576,277,78,20,2.272727272727273,65.46
28210,2390988,57,0,147171,38,19,33.333333333333336,0.0
28211,79788,84,79788,2910,80,4,2.2222222222222223,23.66
28212,12240,28,12240,1913,24,4,6.25,1.36
28213,804,11,804,211,9,2,10.0,0.0
28214,20148,24,20148,1010,23,1,5.2631578947368425,76.25
28215,804,38,804,11,38,0,2.5,43.1
28216,660,14,468,264,13,1,8.333333333333334,77.7
28217,13176,18,13176,648,17,1,10.0,66.5
28218,11823636,1663,1994580,957659,872,791,1.0,0.0
28219,348,32,348,22,26,6,3.8461538461538463,48.1
28220,2388,17,0,570,14,3,100.0,0.0
28221,204,4,204,42,3,1,25.0,74.63
28222,18864,106,17616,1200,106,0,33.333333333333336,4.22
28223,480,10,480,37,10,0,8.333333333333334,54.21
28224,2876088,67,0,1095509,31,36,5.555555555555555,0.0
28225,21396,53,0,1684,38,15,100.0,0.0
28226,11793996,7499,0,4420784,4053,3446,1.0,0.72
28227,11332800,179,0,131799,144,35,12.5,0.0
28228,27636,44,27636,1375,38,6,9.090909090909092,34.13
28229,324,6,324,30,3,3,50.0,62.27
28230,3036,4,1560,1464,4,0,33.333333333333336,0.0
28231,1248,34,1248,375,33,1,9.090909090909092,32.21
28232,17052,53,0,1468,37,16,100.0,0.0
28233,6672,2,6672,6468,1,1,50.0,98.68
28234,1992,33,1992,529,32,1,10.0,49.01
28235,95532,51,95532,540,45,6,5.555555555555555,75.26
28236,1992,36,1992,600,35,1,9.090909090909092,32.55
28237,4170612,7,0,730026,4,3,16.666666666666668,0.0
28238,2088,122,2088,897,71,51,3.0303030303030303,64.63
28239,409896,31,167736,73803,24,7,6.666666666666667,38.53
28240,684,1,684,228,0,1,100.0,100.0
28241,2268,49,0,780,35,14,3.125,0.0
28242,1812,4,1812,987,4,0,12.5,76.25
28243,169716,13,169716,8125,7,6,16.666666666666668,11.91
28244,336,61,336,144,41,20,2.702702702702702,44.15
28245,9050292,188,0,81106,93,95,3.0303030303030303,4.81
28246,41892,29,41622,21198,29,0,6.25,54.35
28247,4077732,91,4077732,389865,54,37,2.5,2.0
28248,1992,4,1992,1017,4,0,33.333333333333336,88.0
28249,142032,11,142032,123,10,1,11.11111111111111,96.87
28250,2316,3,2316,512,3,0,33.333333333333336,0.0
28251,7200,26,7200,714,24,2,50.0,46.79
28252,28716,0,28716,0,0,0,100.0,100.0
28253,13728,8,13728,0,8,0,10.0,64.0
28254,11711676,21,11711676,33989,11,10,12.5,90.61
28255,10560,51,0,1306,37,14,100.0,0.0
28256,456744,107,0,23713,87,20,1.7241379310344829,0.0
28257,456,4,456,141,4,0,16.666666666666668,73.01
28258,2928,3,2928,1764,3,0,50.0,80.0
28259,936,27,936,67,17,10,11.11111111111111,50.49
28260,1512,31,1512,1111,25,6,4.0,78.46
28261,12644028,1407,4137004,5154373,865,542,1.0,0.0
28262,10326660,2833,0,120441,1573,1260,1.0,0.0
28263,366528,142,0,8535,78,64,7.142857142857143,0.0
28264,348,1,348,216,1,0,50.0,98.61
28265,2686392,159,2686392,7352,84,75,7.6923076923076925,0.0
28266,168,7,168,66,5,2,20.0,62.88
28267,8095992,485,8095992,9548,230,255,1.6129032258064515,66.98
28268,182568,68,1104,7425,50,18,2.380952380952381,1.05
28269,4764,8,4764,577,8,0,14.285714285714286,1.81
28270,2664696,95,2664696,81657,40,55,7.6923076923076925,86.44
28271,976104,187,0,21573,117,70,1.2345679012345678,0.0
28272,90300,67,0,4544,45,22,100.0,0.0
28273,528,0,528,0,0,0,16.666666666666668,63.94
28274,15576,8,15576,37,4,4,50.0,53.62
28275,11720364,11,11720364,139,7,4,14.285714285714286,90.56
28276,2016,45,2016,34,45,0,2.127659574468085,77.44
28277,2736,25,2736,748,24,1,20.0,43.48
28278,10463676,2425,1600428,278299,1420,1005,1.0,0.12
28279,58008,2,58008,1152,2,0,33.333333333333336,91.84
28280,1068,8,1068,649,8,0,10.0,92.11
28281,168,4,168,30,2,2,50.0,67.86
28282,972,6,972,112,5,1,33.333333333333336,7.1
28283,12638028,1648,3448178,2498855,649,999,1.2195121951219512,0.0
28284,396,11,396,55,11,0,8.333333333333334,70.6
28285,723156,1475,417660,18070,733,742,1.0,0.0
28286,19116,140,0,1868,99,41,100.0,0.0
28287,147000,56,2892,4188,54,2,1.851851851851852,23.66
28288,58392,73,0,1300,57,16,100.0,0.0
28289,9110928,2314,0,179538,1367,947,1.0,0.0
28290,7052484,1233,7052484,21432,670,563,1.162790697674419,69.32
28291,12462480,1412,7862448,628504,583,829,1.0526315789473684,0.0
28292,2832,16,0,1311,11,5,100.0,0.0
28293,2196,4,2196,426,3,1,25.0,33.43
28294,7860456,327,7860456,34460,150,177,2.1739130434782608,78.46
28295,540,15,480,136,9,6,16.666666666666668,55.52
28296,8988,30,8988,702,26,4,4.0,65.76
28297,516,12,516,404,6,6,20.0,95.23
28298,48852,133,48852,1744,100,33,1.6129032258064515,3.99
28299,696564,0,696564,0,0,0,100.0,100.0
28300,12635220,7879,517680,2565682,4448,3431,1.0,0.0
28301,57120,54,0,8229,41,13,100.0,0.0
28302,1389720,117,0,30649,51,66,5.2631578947368425,5.39
28303,6648,19,6648,541,18,1,14.285714285714286,51.9
28304,2664,81,0,873,64,17,100.0,0.0
28305,108,4,108,27,4,0,20.0,73.73
28306,10216644,82,1152,124957,69,13,1.639344262295082,47.65
28307,43068,90,43068,1685,90,0,1.25,36.14
28308,5117232,391,5117232,18913,162,229,1.96078431372549,77.06
28309,2910552,230,2910396,16423,97,133,3.8461538461538463,90.7
28310,9438828,294,9438828,77312,128,166,3.4482758620689653,79.45
28311,2292,25,0,733,20,5,100.0,0.0
28312,2412,3,2412,1120,1,2,25.0,0.0
28313,254328,1,254328,12156,1,0,50.0,94.69
28314,1152,10,1152,850,8,2,11.11111111111111,89.31
28315,11477172,667,0,121938,319,348,1.0,0.0
28316,43884,9,43884,901,9,0,14.285714285714286,56.68
28317,10344,4,10344,1647,4,0,20.0,87.18
28318,684,6,684,214,3,3,33.333333333333336,53.35
28319,2928,0,2928,0,0,0,100.0,100.0
28320,12642540,537,0,1473228,285,252,1.851851851851852,6.43
28321,1404,20,1404,95,14,6,7.6923076923076925,54.49
28322,14880,153,4332,2068,148,5,1.0,9.69
28323,588,17,588,213,17,0,5.2631578947368425,66.45
28324,4764,5,4764,14,3,2,50.0,99.9
28325,43920,13,43920,1,13,0,6.666666666666667,54.18
28326,12324384,2011,0,93884,1090,921,1.0,0.0
28327,95736,63,95736,3533,53,10,100.0,0.0
28328,29184,19,29184,1152,17,2,7.142857142857143,75.96
28329,101088,22,101088,5885,20,2,6.25,5.16
28330,97272,25,0,9579,17,8,100.0,100.0
28331,3504,88,0,861,64,24,100.0,0.0
28332,88440,47,88440,1539,38,9,3.225806451612903,49.21
28333,25320,202,0,1648,140,62,100.0,0.0
28334,3552,15,0,752,12,3,100.0,0.0
28335,4884,26,4884,729,24,2,10.0,23.3
28336,8751708,33,0,598992,3,30,3.225806451612903,0.0
28337,540,9,540,60,8,1,11.11111111111111,55.15
28338,30924,72,30924,1095,72,0,33.333333333333336,45.17
28339,10720308,851,0,106590,503,348,1.5625,0.0
28340,6229716,59,6229716,26690,25,34,20.0,97.2
28341,324,3,324,224,1,2,50.0,0.0
28342,27900,49,27900,24,45,4,2.2222222222222223,63.22
28343,47544,7,47544,644,6,1,16.666666666666668,84.23
28344,9165240,14,9165240,799907,5,9,5.2631578947368425,0.0
28345,120,0,120,0,0,0,50.0,68.89
28346,204,28,204,42,22,6,5.2631578947368425,50.64
28347,19872,21,19872,865,20,1,5.882352941176471,77.52
28348,360,10,360,43,10,0,9.090909090909092,84.7
28349,105492,18,0,6117,13,5,100.0,100.0
28350,1981272,43,1981272,100,40,3,2.4390243902439024,23.9
28351,11833020,958,0,61286,536,422,1.2345679012345678,0.0
28352,1464,8,0,1066,6,2,100.0,0.0
28353,96564,23,96564,387,21,2,6.666666666666667,54.12
28354,10236,14,10236,911,12,2,9.090909090909092,9.79
28355,741024,44,741024,158851,38,6,4.0,38.03
28356,1967640,100,197580,39555,80,20,100.0,0.0
28357,62664,28,62664,14201,23,5,8.333333333333334,1.14
28358,95904,14,0,7454,11,3,100.0,0.0
28359,11588496,1447,0,567567,821,626,1.0,0.56
28360,6156,23,6156,824,21,2,11.11111111111111,29.54
28361,16116,77,16116,1646,62,15,100.0,0.0
28362,1500,0,1500,0,0,0,14.285714285714286,20.0
28363,606240,32,606240,22851,27,5,5.2631578947368425,85.79
28364,2784,26,2784,479,25,1,10.0,55.15
28365,31728,1,31728,31680,1,0,33.333333333333336,69.54
28366,1120668,38,0,411802,36,2,7.142857142857143,0.0
28367,2184,4,2184,327,2,2,33.333333333333336,65.04
28368,6432,136,0,1098,95,41,100.0,0.0
28369,1668,22,1668,675,21,1,12.5,44.49
28370,12494556,188,0,5465730,99,89,1.0,0.0
28371,39228,63,0,1523,47,16,100.0,0.0
28372,65796,16,65796,1620,15,1,14.285714285714286,65.24
28373,59520,26,59520,1903,22,4,5.882352941176471,83.98
28374,2683704,234,2683704,10439,122,112,3.4482758620689653,77.45
28375,277548,23,277548,5371,22,1,4.761904761904762,44.35
28376,61416,26,61416,300,22,4,5.2631578947368425,81.74
28377,2832864,148,0,25368,73,75,5.555555555555555,0.0
28378,4944,11,4944,2996,10,1,100.0,100.0
28379,3828,176,0,1739,124,52,100.0,0.0
28380,2520,20,0,663,16,4,100.0,0.0
28381,25824,25,25824,1075,23,2,5.0,75.29
28382,19368,43,19368,507,42,1,2.380952380952381,77.45
28383,8538912,160,0,429004,136,24,50.0,50.0
28384,13800,70,0,563,44,26,33.333333333333336,0.0
28385,2184,25,0,816,20,5,100.0,100.0
28386,12558684,1132,0,1317668,703,429,1.0,0.0
28387,17652,24,17652,878,22,2,5.882352941176471,72.41
28388,2700,120,0,1129,80,40,100.0,0.0
28389,2340,1,2340,1896,1,0,50.0,99.92
28390,69768,69,69768,392,58,11,3.8461538461538463,45.69
28391,17316,98,0,1008,69,29,50.0,0.0
28392,12542520,677,0,1139894,416,261,1.0,0.0
28393,71280,22,71280,1650,18,4,6.25,78.53
28394,823872,6,823872,1778,5,1,20.0,51.28
28395,191040,45,0,12071,42,3,100.0,0.0
28396,1932,105,0,888,75,30,100.0,0.0
28397,3888,26,0,752,19,7,100.0,0.0
28398,12471888,109,0,1519711,73,36,5.882352941176471,0.0
28399,6336,56,6336,1069,54,2,4.761904761904762,65.19
28400,542976,63,542976,234070,42,21,14.285714285714286,0.0
28401,75972,238,0,10706,191,47,50.0,0.0
28402,53244,0,53244,0,0,0,50.0,77.38
28403,339540,23,46860,16152,15,8,16.666666666666668,0.0
28404,78900,70,39990,397,60,10,3.333333333333333,0.0
28405,11784,106,0,2743,87,19,100.0,0.0
28406,492,1,492,300,1,0,33.333333333333336,99.5
28407,1860,3,1860,816,3,0,33.333333333333336,0.0
28408,80592,51,80592,371,45,6,5.555555555555555,77.74
28409,2412204,533,0,382575,221,312,1.7857142857142858,0.0
28410,477540,4,0,129786,2,2,33.333333333333336,94.99
28411,852,44,852,91,40,4,2.857142857142857,59.99
28412,82464,51,82464,2461,42,9,6.666666666666667,86.54
28413,1800,25,0,570,21,4,100.0,0.0
28414,1404,2,1404,600,2,0,50.0,0.0
28415,28308,165,28308,189,113,52,1.1235955056179776,20.13
28416,972,14,972,437,12,2,7.6923076923076925,89.6
28417,7881084,310,0,198598,212,98,2.127659574468085,5.43
28418,12721536,841,7544316,5398500,537,304,1.0,0.0
28419,154332,119,25704,12760,82,37,100.0,100.0
28420,8892,52,8892,8081,42,10,2.5641025641025643,39.19
28421,2520,1,2520,576,1,0,33.333333333333336,79.0
28422,7716,82,0,854,57,25,100.0,0.0
28423,2016,52,0,717,38,14,2.9411764705882355,0.0
28424,96,0,96,0,0,0,50.0,64.0
28425,12606552,2658,0,1560701,1533,1125,1.0,0.0
28426,2904,7,2904,361,7,0,25.0,0.0
28427,696972,28,696972,1501,23,5,5.555555555555555,84.06
28428,1632,2,1632,480,2,0,50.0,23.02
28429,1752,85,0,910,60,25,100.0,0.0
28430,7873788,248,7873356,37329,113,135,3.333333333333333,0.0
28431,936,19,936,104,17,2,5.555555555555555,65.35
28432,1404,10,1404,476,10,0,8.333333333333334,97.32
28433,314484,74,16056,5869,72,2,7.142857142857143,84.47
28434,210684,13,210684,396,7,6,16.666666666666668,77.58
28435,10224,184,0,876,124,60,100.0,0.0
28436,3198012,1049,0,12021,558,491,1.075268817204301,2.41
28437,10820748,105,0,485202,84,21,2.5641025641025643,0.0
28438,1236,1,1236,564,1,0,50.0,94.17
28439,984,125,984,336,83,42,1.6129032258064515,50.21
28440,360,1,360,192,1,0,50.0,99.69
28441,216,4,216,9,4,0,16.666666666666668,73.0
28442,1044,26,1044,231,18,8,7.142857142857143,87.47
28443,426768,64,426768,12714,36,28,5.2631578947368425,67.8
28444,180,2,180,12,2,0,25.0,91.02
28445,132,0,132,0,0,0,50.0,68.89
28446,1680,65,0,676,45,20,100.0,0.0
28447,10044,80,10044,3696,72,8,1.9230769230769231,47.25
28448,348,41,348,12,41,0,2.3255813953488373,59.6
28449,12576,48,0,610,35,13,100.0,0.0
28450,3261948,26,3261948,812732,23,3,4.761904761904762,72.67
28451,2734380,362,2734380,16083,160,202,2.9411764705882355,79.39
28452,3108,4,3108,42,2,2,50.0,0.0
28453,38436,1,38436,2172,1,0,33.333333333333336,62.66
28454,336,14,336,52,7,7,50.0,75.56
28455,480,15,252,181,12,3,9.090909090909092,0.0
28456,3325380,168,29856,20727,126,42,1.0,31.92
28457,14700,65,0,704,48,17,100.0,0.0
28458,39012,34,39012,740,31,3,8.333333333333334,47.49
28459,11658060,677,71436,108665,336,341,1.818181818181818,0.0
28460,948,86,948,26,86,0,2.127659574468085,57.14
28461,9507384,156,7825284,157937,73,83,2.631578947368421,0.0
28462,7842024,964,7842024,39614,538,426,1.1235955056179776,64.89
28463,7778940,520,3237984,54943,208,312,2.083333333333333,77.39
28464,11498148,836,7220292,314174,383,453,1.1494252873563218,0.0
28465,6384,7,6384,2019,3,4,50.0,99.81
28466,27612,102,0,1050,74,28,33.333333333333336,0.0
28467,370224,0,370224,0,0,0,50.0,95.0
28468,732,47,732,229,37,10,2.9411764705882355,86.78
28469,3356556,135,0,46267,75,60,100.0,0.0
28470,8487492,148,40392,438240,107,41,100.0,0.0
28471,540,67,540,56,64,3,1.5384615384615383,48.88
28472,312,32,312,94,20,12,9.090909090909092,65.54
28473,10199220,969,0,309616,557,412,1.1904761904761905,0.0
28474,718248,336,0,10283,186,150,2.4390243902439024,0.0
28475,8813436,30,8813436,6245,22,8,7.142857142857143,44.26
28476,10812,3,10812,9896,3,0,20.0,96.14
28477,66252,2,66252,1842,2,0,25.0,78.05
28478,8796,88,0,772,61,27,100.0,0.0
28479,3193248,121,0,26508,110,11,1.0,0.0
28480,11897280,751,0,889636,319,432,2.380952380952381,0.0
28481,1728,396,1728,281,242,154,1.075268817204301,64.38
28482,6132,117,0,476,76,41,100.0,0.0
28483,3487284,41,3487284,89941,22,19,14.285714285714286,0.0
28484,468,8,468,52,8,0,10.0,50.82
28485,1332,9,1332,604,7,2,25.0,96.2
28486,599232,28,0,24149,21,7,100.0,100.0
28487,3040500,421,0,18560,204,217,2.3255813953488373,0.0
28488,10440108,460,0,57262,258,202,1.5151515151515151,0.0
28489,9396,90,0,976,58,32,100.0,0.0
28490,140628,59,140628,3178,56,3,1.818181818181818,25.84
28491,792,11,792,144,8,3,14.285714285714286,48.23
28492,1464,32,1464,655,28,4,5.2631578947368425,78.34
28493,11902164,663,4547688,416493,386,277,1.5873015873015872,0.0
28494,12649728,500,6535020,3059891,283,217,1.0,0.0
28495,56292,22,1008,9968,16,6,6.666666666666667,0.0
28496,10962228,269,10962228,57440,127,142,3.333333333333333,80.14
28497,324,41,324,49,37,4,2.702702702702702,55.66
28498,8117448,770,2185962,248075,467,303,1.0,54.55
28499,12069552,2047,0,60421,1144,903,1.0,0.0
28500,21768,61,0,3463,30,31,5.555555555555555,0.0
28501,3270780,93,3270780,32001,42,51,8.333333333333334,79.04
28502,792,5,792,76,5,0,14.285714285714286,94.39
28503,684,2,684,120,2,0,25.0,97.41
28504,504,5,504,218,5,0,16.666666666666668,91.58
28505,8069472,183,8069472,65096,93,90,2.0,62.09
28506,166368,31,0,8891,21,10,100.0,100.0
28507,156,5,156,26,4,1,20.0,73.12
28508,4524,55,684,576,49,6,2.127659574468085,53.01
28509,144,0,144,0,0,0,50.0,77.44
28510,1608,5,1608,1219,4,1,16.666666666666668,95.87
28511,1062972,135,0,95881,80,55,2.631578947368421,0.0
28512,288,4,288,117,3,1,25.0,75.18
28513,456,17,96,76,14,3,12.5,0.0
28514,12739104,3759,3255340,2759081,2034,1725,1.0,0.0
28515,5422596,36,5422596,328948,12,24,4.0,31.36
28516,444,13,360,209,12,1,8.333333333333334,0.0
28517,15516,98,0,1168,69,29,100.0,0.0
28518,10267800,76,0,292992,41,35,12.5,6.9
28519,8232,1,8232,972,1,0,50.0,92.67
28520,468,18,468,446,18,0,4.761904761904762,57.95
28521,1008,152,1008,407,103,49,1.2195121951219512,53.09
28522,96,1,96,96,1,0,50.0,80.0
28523,12587076,3569,0,471537,2068,1501,1.0,0.0
28524,8369796,120,8369784,76056,83,37,1.492537313432836,0.0
28525,2762232,36,2762232,3838,17,19,12.5,0.0
28526,5186412,172,5186412,987,68,104,4.761904761904762,41.72
28527,1416,220,1416,826,152,68,1.0,7.41
28528,2570460,312,948072,21029,173,139,4.0,4.76
28529,35316,95,552,756,85,10,1.36986301369863,36.56
28530,8552688,1461,4347078,130388,664,797,1.0,69.9
28531,1140,6,1140,32,6,0,12.5,63.04
28532,30288,24,168,1302,19,5,6.666666666666667,57.49
28533,7565772,161,0,609327,92,69,3.0303030303030303,0.1
28534,1045428,334,0,4704,174,160,2.127659574468085,3.82
28535,21240,26,1332,1616,26,0,3.703703703703704,58.7
28536,12456276,183,0,3136291,81,102,3.0303030303030303,0.0
28537,588,14,588,248,9,5,16.666666666666668,81.87
28538,10889988,757,0,110298,431,326,2.380952380952381,0.0
28539,407832,76,407832,213,58,18,1.96078431372549,31.32
28540,11623464,760,0,179425,417,343,1.5151515151515151,5.0
28541,2376,1,2376,12,1,0,33.333333333333336,88.35
28542,3828,28,3828,231,28,0,3.333333333333333,0.01
28543,184752,12,0,15573,9,3,100.0,100.0
28544,3384,4,3384,525,4,0,16.666666666666668,83.37
28545,25200,269,2574,2260,141,128,1.639344262295082,59.96
28546,12757512,17666,4411737,3993313,8818,8848,1.0,0.0
28547,1332,16,0,438,14,2,100.0,0.0
28548,27312,163,0,2866,111,52,100.0,0.0
28549,275388,63,275388,2504,41,22,2.3255813953488373,33.32
28550,4680,18,0,877,14,4,100.0,0.0
28551,748320,15,748320,26032,14,1,7.142857142857143,78.42
28552,12737796,2597,0,7450947,1487,1110,1.0,0.0
28553,365688,83,365688,70907,77,6,1.7241379310344829,18.82
28554,4637220,208,0,227417,101,107,5.2631578947368425,0.0
28555,20832,25,20832,1156,22,3,5.882352941176471,70.21
28556,20748,33,20748,1192,29,4,9.090909090909092,43.21
28557,1548,36,1548,496,29,7,4.0,40.58
28558,3468,20,3468,676,17,3,9.090909090909092,37.14
28559,132276,477,132276,93677,359,118,1.0,47.54
28560,15312,32,3876,849,30,2,3.225806451612903,48.25
28561,1848,1,1848,660,1,0,100.0,97.36
28562,35496,59,0,2156,46,13,50.0,0.0
28563,6588,22,6588,476,21,1,16.666666666666668,29.63
28564,78192,79,78192,2943,63,16,100.0,0.0
28565,47808,6,47808,384,5,1,20.0,82.81
28566,1878888,1545,0,18993,845,700,1.0,0.0
28567,334548,31,0,55085,19,12,7.6923076923076925,0.0
28568,39108,116,0,1805,72,44,50.0,0.0
28569,249996,49,0,8612,40,9,100.0,0.0
28570,181284,114,0,27842,99,15,1.2345679012345678,0.35
28571,78432,5,78432,12165,4,1,20.0,77.09
28572,552,14,552,336,14,0,6.25,69.38
28573,52044,111,0,4140,87,24,20.0,0.0
28574,4356,11,4356,330,10,1,12.5,40.8
28575,14136,6,1356,2370,5,1,9.090909090909092,32.81
28576,24468,7,0,16407,5,2,50.0,99.99
28577,1691640,19,1498302,802828,19,0,8.333333333333334,47.69
28578,6252,20,6252,1050,18,2,6.25,74.38
28579,231252,1,156,231252,1,0,100.0,100.0
28580,43032,98,0,1314,62,36,100.0,0.0
28581,1308,31,1308,814,29,2,16.666666666666668,14.46
28582,5036484,134,5036484,399,62,72,4.166666666666667,80.82
28583,336,0,336,0,0,0,50.0,56.25
28584,144,5,144,0,5,0,14.285714285714286,56.39
28585,2084244,34,2084244,93,32,2,3.125,35.29
28586,6395424,106,0,68502,44,62,10.0,0.0
28587,168,5,168,69,5,0,14.285714285714286,91.99
28588,46872,164,0,3584,99,65,20.0,0.0
28589,10932,5,10932,453,5,0,20.0,0.0
28590,1404,20,1404,277,20,0,5.555555555555555,71.23
28591,11700,16,11700,432,16,0,5.555555555555555,51.92
28592,5028,18,0,638,14,4,100.0,0.0
28593,3322164,29,13428,622542,25,4,5.555555555555555,73.09
28594,606456,44,606456,233,42,2,2.4390243902439024,27.98
28595,3572964,107,0,152227,90,17,100.0,0.0
28596,60216,12,60216,4937,11,1,100.0,0.0
28597,13476,16,13476,637,12,4,9.090909090909092,27.61
28598,6300,18,6300,452,17,1,11.11111111111111,47.55
28599,12039180,167,64992,74275,162,5,4.0,33.07
28600,6230436,47,0,138749,30,17,50.0,0.0
28601,11604036,593,0,146432,326,267,1.818181818181818,0.0
28602,12776628,30761,3749328,2363103,15995,14766,1.0,50.68
28603,10908024,11932,678564,2886980,7292,4640,1.0,0.0
28604,14004,126,0,3134,99,27,100.0,0.0
28605,504,32,504,122,20,12,10.0,68.49
28606,528,87,528,253,43,44,4.3478260869565215,74.44
28607,7507404,406,0,38943,219,187,2.631578947368421,0.0
28608,264,10,0,49,5,5,50.0,0.0
28609,348,6,348,80,4,2,25.0,61.87
28610,288,0,288,0,0,0,100.0,100.0
28611,576,0,576,0,0,0,50.0,64.0
28612,528,36,528,145,34,2,3.703703703703704,73.97
28613,276,29,276,129,19,10,6.666666666666667,63.04
28614,888,0,888,0,0,0,100.0,100.0
28615,9552,48,0,741,35,13,100.0,0.0
28616,3132204,198,3132204,11005,131,67,3.571428571428572,66.45
28617,4380,53,0,1309,40,13,50.0,0.0
28618,2712,7,2712,1824,7,0,14.285714285714286,89.82
28619,924,33,924,128,33,0,3.8461538461538463,74.05
28620,528,0,528,0,0,0,50.0,98.01
28621,14256,245,0,2556,166,79,33.333333333333336,0.0
28622,169932,49,89250,804,43,6,5.2631578947368425,0.0
28623,719328,20,719328,56,17,3,11.11111111111111,85.18
28624,12497904,325,0,1084858,199,126,1.694915254237288,6.77
28625,432,109,0,26,98,11,1.0638297872340423,0.0
28626,588,8,588,178,5,3,33.333333333333336,96.2
28627,2760168,463,497890,22127,257,206,4.0,90.46
28628,8373312,1066,0,246661,630,436,1.351351351351351,0.75
28629,3225804,104,3225804,32777,37,67,16.666666666666668,83.85
28630,732,9,732,70,9,0,9.090909090909092,87.13
28631,876,7,876,5,7,0,11.11111111111111,46.83
28632,4228008,37,4228008,63961,25,12,7.6923076923076925,62.31
28633,12708372,2286,0,2137351,1320,966,1.0,0.0
28634,372,13,372,107,7,6,16.666666666666668,95.45
28635,660,0,660,0,0,0,100.0,100.0
28636,2304,155,1224,354,109,46,1.3333333333333333,3.37
28637,2496,12,2496,23,10,2,10.0,62.83
28638,180,0,180,0,0,0,50.0,81.0
28639,516,0,516,0,0,0,50.0,72.25
28640,924,7,924,82,6,1,16.666666666666668,87.97
28641,15012,105,15012,4079,57,48,2.857142857142857,49.52
28642,948,702,948,272,314,388,1.0,0.0
28643,12558072,97,0,165478,51,46,4.545454545454546,0.0
28644,71508,2,71508,810,2,0,33.333333333333336,98.88
28645,5436,0,5436,0,0,0,100.0,100.0
28646,132,0,132,0,0,0,100.0,90.0
28647,0,0,0,0,0,0,100.0,0.0
28648,780,66,780,91,50,16,2.272727272727273,33.2
28649,132,2,132,12,1,1,50.0,79.28
28650,228,5,228,120,5,0,14.285714285714286,82.17
28651,32292,35,0,1504,18,17,9.090909090909092,0.0
28652,552,20,552,152,16,4,6.25,78.01
28653,264,6,264,68,5,1,16.666666666666668,52.52
28654,1296,85,1260,81,61,24,1.96078431372549,33.03
28655,12619680,59,8896332,2974171,50,9,3.703703703703704,47.63
28656,1668,40,1668,44,25,15,7.6923076923076925,51.49
28657,708,91,456,155,67,24,1.818181818181818,38.94
28658,3955584,218,108420,19527,118,100,3.125,80.13
28659,372,0,372,0,0,0,100.0,90.0
28660,12559296,527,0,55481,312,215,1.7857142857142858,0.0
28661,2749344,262,2749344,96202,119,143,3.703703703703704,0.0
28662,516,4,516,75,3,1,33.333333333333336,87.01
28663,408,7,408,77,3,4,33.333333333333336,99.08
28664,996,27,996,89,9,18,50.0,99.63
28665,1068,98,0,289,46,52,4.545454545454546,0.0
28666,17532,72,17532,1880,71,1,1.5151515151515151,50.42
28667,3336,8,3336,138,4,4,25.0,0.0
28668,2099856,560,0,10513,322,238,1.0,5.0
28669,1932,35,1932,169,19,16,10.0,1.6
28670,1656,22,1656,302,22,0,4.166666666666667,57.31
28671,7464,19,7464,595,19,0,6.666666666666667,22.94
28672,180,2,180,18,2,0,25.0,56.49
28673,324,3,324,88,2,1,50.0,77.82
28674,396,85,396,136,41,44,5.0,69.99
28675,4536,74,204,232,60,14,1.7543859649122806,16.64
28676,2460,34,2460,123,28,6,3.703703703703704,64.82
28677,792,1,792,708,1,0,50.0,99.99
28678,1920360,99,0,61714,77,22,50.0,0.0
28679,10140456,667,0,287294,358,309,1.4285714285714286,0.0
28680,5450928,212,2942076,47717,100,112,4.761904761904762,0.0
28681,3218832,455,0,74776,195,260,2.0,0.0
28682,12293196,874,0,3154394,455,419,2.5641025641025643,0.0
28683,2678976,71,2678976,7658,32,39,4.761904761904762,0.0
28684,228,2,228,120,2,0,25.0,64.84
28685,8416020,226,8416020,36444,99,127,2.7777777777777777,72.0
28686,95508,3,95508,492,2,1,50.0,98.76
28687,84,24,84,18,18,6,5.882352941176471,50.28
28688,33300,60,0,6082,41,19,100.0,0.0
28689,1356,7,0,594,5,2,100.0,0.0
28690,1272,76,1272,450,52,24,2.631578947368421,18.55
28691,10167708,110,0,122525,63,47,6.25,0.0
28692,3516,72,3516,748,44,28,3.225806451612903,56.09
28693,91524,45,91524,2789,43,2,2.3255813953488373,19.46
28694,300,6,300,96,5,1,20.0,71.01
28695,12825372,4929,1028880,430684,2257,2672,1.0,0.0
28696,3531588,111,0,32893,58,53,5.2631578947368425,0.0
28697,1872,19,1872,368,19,0,5.555555555555555,85.45
28698,240,3,240,32,2,1,33.333333333333336,89.21
28699,240,9,240,48,9,0,11.11111111111111,88.09
28700,4385232,9,4385232,293444,7,2,100.0,100.0
28701,12782052,13734,458712,2910066,7802,5932,1.0,0.0
28702,588,39,0,173,34,5,100.0,0.0
28703,564,17,564,73,14,3,7.142857142857143,78.19
28704,32244,26,0,1816,20,6,100.0,0.0
28705,336,8,192,183,6,2,33.333333333333336,96.28
28706,432,4,432,198,3,1,50.0,99.58
28707,216,2,216,126,2,0,50.0,99.21
28708,3618948,81,0,102276,46,35,8.333333333333334,4.0
28709,7973616,629,7973616,1890634,330,299,1.0,0.0
28710,7878852,140,7878852,4971,72,68,4.545454545454546,71.3
28711,8820,7,8820,169,7,0,11.11111111111111,93.53
28712,1412892,5,1339968,284481,3,2,25.0,0.0
28713,10416,0,10416,0,0,0,50.0,85.3
28714,12326724,642,0,803487,353,289,1.3157894736842106,0.0
28715,2172,12,2172,234,8,4,12.5,63.28
28716,12445344,19,0,3326347,8,11,1.0,0.0
28717,5674404,372,5674404,59986,202,170,2.1739130434782608,74.56
28718,1020,43,1020,428,42,1,2.380952380952381,62.83
28719,192,2,192,42,2,0,25.0,68.08
28720,11934972,927,0,848989,517,410,1.1235955056179776,3.92
28721,132,2,132,36,1,1,50.0,79.28
28722,228,4,228,24,4,0,16.666666666666668,54.11
28723,120,0,120,0,0,0,50.0,64.72
28724,126996,207,126996,205,150,57,1.0,29.07
28725,3500892,307,0,89210,159,148,3.125,10.26
28726,720,73,720,114,63,10,1.7857142857142858,53.63
28727,216,46,204,68,28,18,4.761904761904762,44.06
28728,55464,118,786,912,70,48,2.3255813953488373,45.19
28729,7970124,77,7970124,127887,33,44,11.11111111111111,88.21
28730,180,10,180,62,5,5,33.333333333333336,55.37
28731,2304,53,2304,43,39,14,3.0303030303030303,53.89
28732,233928,2,233928,23082,0,2,1.0,0.0
28733,2742480,55,2742480,1684,28,27,6.666666666666667,0.0
28734,12825468,1178,1211952,5632008,674,504,1.0,0.0
28735,11953284,198,0,63560,98,100,3.571428571428572,4.92
28736,10452648,1074,10452648,103894,528,546,1.1235955056179776,65.8
28737,1614624,138,0,13186,80,58,7.142857142857143,0.0
28738,4320780,117,4320780,27799,73,44,4.0,29.01
28739,39108,43,39108,65,35,8,2.9411764705882355,6.0
28740,6550800,5,6550800,62,5,0,12.5,49.0
28741,776508,7,419262,80307,7,0,12.5,71.05
28742,3901956,89,0,46529,76,13,50.0,0.0
28743,1236,58,1236,130,54,4,2.1739130434782608,52.87
28744,59448,74,0,1512,52,22,100.0,0.0
28745,12299112,313,0,82772,165,148,4.3478260869565215,0.0
28746,374508,61,0,31434,46,15,100.0,0.0
28747,21168,88,21168,6777,63,25,2.127659574468085,32.81
28748,2892,9,2892,93,9,0,11.11111111111111,79.86
28749,5304,21,5304,800,20,1,14.285714285714286,32.73
28750,10290540,5,0,7519608,3,2,1.0,0.0
28751,64500,72,0,1892,48,24,50.0,0.0
28752,2628,20,2628,533,19,1,7.6923076923076925,68.09
28753,75048,60,68026,5428,33,27,5.555555555555555,7.36
28754,11624088,190,0,521375,101,89,4.545454545454546,0.0
28755,288,15,246,29,13,2,6.666666666666667,88.92
28756,12135372,397,0,1372357,252,145,1.0,0.0
28757,12391560,1744,0,103096,995,749,1.0,0.0
28758,70836,94,0,3053,74,20,100.0,0.0
28759,5782116,66,0,90355,59,7,50.0,0.0
28760,3276,234,3276,1250,111,123,2.631578947368421,62.65
28761,28392,21,28392,1858,21,0,5.2631578947368425,77.53
28762,5316,24,5316,438,22,2,25.0,72.56
28763,12703392,4918,1040640,1246829,2133,2785,1.0,0.0
28764,27456,500,16686,1836,323,177,1.0,0.0
28765,5868,3,5868,1168,3,0,25.0,0.0
28766,6168,181,6168,1210,123,58,1.96078431372549,0.0
28767,7944,102,0,2438,85,17,100.0,0.0
28768,16740,102,0,1105,61,41,100.0,0.0
28769,246564,59,0,5828,38,21,100.0,0.0
28770,6266940,70,6266940,51014,50,20,1.8867924528301887,34.34
28771,1692,0,1692,0,0,0,100.0,100.0
28772,6768,15,0,1258,13,2,100.0,0.0
28773,2635236,14,384,188311,9,5,20.0,88.61
28774,1224,58,1224,491,42,16,3.225806451612903,33.69
28775,1006008,10,1006008,395511,7,3,12.5,60.36
28776,9912,146,0,4535,114,32,100.0,0.0
28777,192,13,192,83,7,6,33.333333333333336,59.82
28778,10372320,404,0,97247,211,193,2.9411764705882355,8.43
28779,384,31,384,138,25,6,4.761904761904762,55.07
28780,172260,128,172260,441,97,31,1.2345679012345678,28.43
28781,4308,123,0,2280,98,25,50.0,0.0
28782,1992,57,1992,150,39,18,3.125,42.77
28783,48,0,48,0,0,0,50.0,75.03
28784,44184,743,44184,1963,523,220,1.0,16.13
28785,2640,33,0,972,28,5,3.571428571428572,0.0
28786,138144,435,138144,109115,362,73,1.0101010101010102,46.28
28787,6833736,59,0,315526,47,12,100.0,0.0
28788,1655004,274,1401408,149949,177,97,1.492537313432836,10.56
28789,1320,3,1320,412,3,0,33.333333333333336,0.0
28790,22644,108,0,4178,91,17,100.0,0.0
28791,204,0,204,0,0,0,50.0,72.25
28792,5664,52,0,588,39,13,2.9411764705882355,0.0
28793,312,24,312,95,24,0,3.8461538461538463,70.62
28794,2592,32,0,775,26,6,100.0,0.0
28795,10553208,61,912,173281,55,6,2.631578947368421,8.0
28796,105216,39,0,3688,26,13,100.0,0.0
28797,6322344,53,0,1794624,49,4,100.0,0.0
28798,1920,5,1920,501,5,0,20.0,0.0
28799,19236,74,0,1298,49,25,100.0,0.0
28800,240,33,240,82,29,4,3.571428571428572,60.49
28801,9329460,580,0,53360,350,230,1.1235955056179776,0.0
28802,84,0,84,0,0,0,50.0,80.0
28803,133728,22,133728,601,18,4,5.555555555555555,66.74
28804,240,2,240,54,2,0,25.0,77.54
28805,33288,70,408,623,34,36,5.555555555555555,71.48
28806,119640,10,0,12061,8,2,100.0,0.0
28807,84,0,84,0,0,0,50.0,80.0
28808,444,87,444,23,87,0,2.0408163265306123,55.64
28809,144,57,144,43,33,24,4.3478260869565215,65.89
28810,15120,118,0,874,84,34,100.0,0.0
28811,213936,25,213936,699,20,5,7.142857142857143,67.97
28812,11516412,573,0,52286,326,247,2.1739130434782608,0.0
28813,35736,1,35736,0,1,0,33.333333333333336,54.75
28814,240,17,240,76,8,9,33.333333333333336,96.2
28815,9251916,684,8898396,67275,271,413,3.0303030303030303,85.3
28816,3792,45,0,1132,32,13,100.0,0.0
28817,1572,8,1572,681,6,2,16.666666666666668,0.0
28818,456,59,252,85,33,26,4.761904761904762,75.2
28819,360,11,360,64,5,6,25.0,88.46
28820,564,39,564,62,25,14,5.555555555555555,74.98
28821,84,0,84,0,0,0,50.0,73.96
28822,52776,42,52776,1625,29,13,12.5,71.2
28823,672,38,672,190,34,4,2.9411764705882355,64.52
28824,52884,246,0,505,137,109,2.0408163265306123,0.0
28825,1668,4,0,1212,3,1,100.0,0.0
28826,228,5,228,43,4,1,25.0,95.31
28827,348,1,348,288,1,0,33.333333333333336,15.6
28828,908352,26,0,72983,13,13,50.0,0.0
28829,14544,6,14544,72,4,2,25.0,71.53
28830,12625512,425,0,289647,191,234,1.694915254237288,0.0
28831,312,1,312,24,1,0,50.0,78.44
28832,1225272,218,0,8778,109,109,4.545454545454546,0.0
28833,1233876,196,0,11990,106,90,3.333333333333333,0.0
28834,11604,100,11604,71,83,17,1.3888888888888888,23.56
28835,12563712,395,0,132466,212,183,2.5,0.0
28836,37848,129,0,3993,86,43,100.0,0.0
28837,804,21,804,64,16,5,6.666666666666667,76.79
28838,9248928,244,0,53625,115,129,4.3478260869565215,0.0
28839,5856,30,5856,247,19,11,7.142857142857143,80.99
28840,12252,45,12252,77,29,16,4.3478260869565215,47.07
28841,12209940,1434,0,85913,812,622,1.0,0.0
28842,3804,403,0,694,309,94,100.0,0.0
28843,1140,0,1140,0,0,0,50.0,16.0
28844,240,1,240,84,1,0,50.0,97.57
28845,180,4,180,21,4,0,16.666666666666668,58.87
28846,5352,24,0,1058,22,2,100.0,0.0
28847,12908628,26209,909096,846986,14780,11429,1.0,0.0
28848,384,12,384,43,12,0,7.6923076923076925,76.06
28849,168,5,168,64,3,2,50.0,0.0
28850,444,2,444,324,1,1,50.0,99.3
28851,336,46,336,132,26,20,5.555555555555555,57.82
28852,7446132,338,0,105086,174,164,2.631578947368421,0.0
28853,2059752,58,456,35621,32,26,6.25,82.84
28854,866544,402,0,3870,241,161,1.639344262295082,10.0
28855,300,4,300,6,3,1,25.0,63.33
28856,780,8,780,90,7,1,14.285714285714286,1.84
28857,852,14,852,121,8,6,25.0,57.41
28858,11879592,275,0,118190,147,128,2.083333333333333,0.0
28859,108,0,108,0,0,0,50.0,76.0
28860,1116,0,1116,0,0,0,50.0,64.0
28861,348,15,156,54,12,3,8.333333333333334,62.0
28862,1716,63,1716,97,42,21,3.333333333333333,1.3
28863,1704,35,1704,65,28,7,4.0,38.78
28864,2304,60,2304,106,51,9,2.3255813953488373,0.89
28865,168,14,168,66,10,4,11.11111111111111,78.09
28866,724356,65,724356,79,61,4,1.6129032258064515,12.57
28867,2184,153,2184,145,116,37,1.0101010101010102,19.58
28868,9200952,124,9200952,1152,83,41,5.882352941176471,88.83
28869,2880,17,2880,595,17,0,12.5,34.42
28870,1584,60,0,442,54,6,2.083333333333333,0.0
28871,540,39,540,91,37,2,4.0,71.94
28872,280440,4,171726,80760,4,0,20.0,0.0
28873,5340,7,5340,4107,6,1,16.666666666666668,55.74
28874,14628,57,0,652,44,13,100.0,100.0
28875,804,41,804,12,41,0,2.3255813953488373,62.39
28876,12908712,12698,3714048,4344297,6851,5847,1.0,0.0
28877,10267596,715,5686698,882972,362,353,2.5641025641025643,86.72
28878,8987592,27,8987592,256,23,4,4.545454545454546,60.48
28879,3948,32,1596,303,31,1,3.703703703703704,78.0
28880,2460,11,2460,843,10,1,10.0,91.13
28881,285096,59,0,6150,33,26,14.285714285714286,0.0
28882,564,1,0,564,0,1,100.0,0.0
28883,18468,24,0,1417,23,1,100.0,100.0
28884,2691696,55,2691696,602,27,28,7.142857142857143,0.0
28885,45348,0,45348,0,0,0,50.0,95.0
28886,11848728,731,0,85476,398,333,1.0,0.0
28887,5148,1,5148,48,1,0,33.333333333333336,60.32
28888,468,82,468,21,82,0,2.272727272727273,59.83
28889,216,12,216,29,11,1,8.333333333333334,55.99
28890,3936,20,3936,3760,20,0,4.545454545454546,80.83
28891,492,10,492,180,10,0,8.333333333333334,81.63
28892,360,14,360,88,8,6,14.285714285714286,86.12
28893,2894772,113,2894772,1031,46,67,5.2631578947368425,84.37
28894,2694288,12,2694288,25,12,0,6.25,0.0
28895,48468,13,48468,832,13,0,7.142857142857143,50.65
28896,2992200,112,2992200,51427,64,48,3.8461538461538463,57.24
28897,42996,102,42996,792,45,57,3.571428571428572,77.66
28898,1536,23,1536,593,21,2,5.882352941176471,33.12
28899,322764,14,322764,1195,12,2,10.0,70.49
28900,744,2,744,342,2,0,33.333333333333336,95.71
28901,10723800,3442,2831700,444295,1562,1880,1.0,7.04
28902,226416,27,226416,21582,25,2,5.2631578947368425,4.4
28903,2740884,372,2740884,8888,185,187,2.702702702702702,82.0
28904,51312,43,0,2252,27,16,100.0,0.0
28905,54960,10,54960,1648,10,0,11.11111111111111,47.48
28906,12919776,1980,491964,4269431,1119,861,1.0,0.0
28907,12548916,256,0,435516,134,122,3.4482758620689653,5.0
28908,2556,18,2556,894,17,1,33.333333333333336,0.0
28909,42468,36,0,1917,27,9,100.0,0.0
28910,996,114,0,135,101,13,1.020408163265306,0.0
28911,104940,118,0,42704,66,52,9.090909090909092,0.0
28912,732,21,732,260,20,1,16.666666666666668,51.42
28913,24024,35,24024,103,29,6,3.571428571428572,45.45
28914,2184,16,2184,956,16,0,7.142857142857143,73.59
28915,1200,11,1200,373,10,1,9.090909090909092,75.61
28916,12827484,28709,696304,5062638,17865,10844,1.0,0.0
28917,11621004,353,0,64060,191,162,1.4285714285714286,0.0
28918,5712,13,5712,1109,13,0,7.6923076923076925,49.72
28919,5768808,305,5768808,164427,168,137,2.7777777777777777,77.82
28920,264,32,264,108,32,0,2.9411764705882355,42.19
28921,348,3,348,76,2,1,33.333333333333336,78.45
28922,46320,44,0,1630,29,15,100.0,0.0
28923,12622248,1487,0,204989,792,695,1.0,0.0
28924,163212,27,0,12563,25,2,3.571428571428572,9.0
28925,3172344,138,3172332,23263,99,39,1.2820512820512822,0.0
28926,3744,8,3744,955,8,0,12.5,47.72
28927,605952,66,605952,7689,24,42,5.882352941176471,60.51
28928,12725316,1983,5934168,1616811,1085,898,1.0,0.0
28929,48324,128,0,1545,91,37,100.0,0.0
28930,84,30,84,17,24,6,4.3478260869565215,36.31
28931,9660,142,0,832,98,44,100.0,0.0
28932,7890516,178,7886296,68447,107,71,3.125,78.38
28933,2508,29,2508,225,17,12,50.0,0.0
28934,254964,989,0,2642,497,492,1.0,5.0
28935,156,24,156,50,14,10,9.090909090909092,63.38
28936,2220,6,2220,522,6,0,14.285714285714286,72.29
28937,18108,13,0,4691,10,3,50.0,0.0
28938,3246432,136,0,163290,58,78,9.090909090909092,0.0
28939,264,15,264,53,15,0,5.882352941176471,71.69
28940,252,3,252,28,3,0,20.0,59.24
28941,1464,50,1464,87,42,8,2.702702702702702,28.94
28942,429408,2,429408,294,1,1,100.0,100.0
28943,33984,42,0,2448,34,8,16.666666666666668,0.0
28944,4207392,462,0,61505,283,179,1.2658227848101269,0.0
28945,260880,7,260880,5352,5,2,25.0,67.59
28946,2136,28,2136,688,28,0,4.545454545454546,45.66
28947,2136,136,0,196,96,40,1.408450704225352,0.0
28948,1044,3,1044,636,3,0,50.0,98.08
28949,11902404,280,0,96318,142,138,4.3478260869565215,0.0
28950,22068,44,22068,1471,34,10,3.225806451612903,55.18
28951,126696,168,0,13984,116,52,100.0,0.0
28952,10766760,96,354534,1411467,34,62,5.2631578947368425,0.0
28953,18060,16,18060,473,16,0,5.882352941176471,74.41
28954,64848,22,64848,1561,17,5,12.5,59.97
28955,237912,17,237912,2717,15,2,7.6923076923076925,49.39
28956,10680,126,0,1508,78,48,50.0,0.0
28957,11146272,76,429282,1557402,33,43,5.882352941176471,0.0
28958,36588,97,0,9901,64,33,50.0,0.0
28959,2711640,48,2711640,702,24,24,9.090909090909092,0.0
28960,17256,200,0,1428,121,79,50.0,0.0
28961,156,5,156,50,3,2,25.0,30.81
28962,8817876,519,0,28151,300,219,1.36986301369863,4.89
28963,18960,1,18960,4272,1,0,33.333333333333336,89.26
28964,77232,109,77232,9708,87,22,100.0,0.0
28965,2683404,382,2683404,7713,223,159,2.7777777777777777,81.34
28966,81072,70,81072,1935,61,9,100.0,0.0
28967,3204,19,0,769,15,4,100.0,0.0
28968,18420,0,18420,0,0,0,100.0,100.0
28969,960,67,960,347,55,12,1.9230769230769231,54.64
28970,42372,45,0,2430,29,16,100.0,0.0
28971,8112,121,0,845,78,43,50.0,0.0
28972,30504,22,30504,1488,18,4,7.142857142857143,71.27
28973,1680,28,1680,420,26,2,9.090909090909092,31.1
28974,1608,25,1608,450,23,2,4.166666666666667,46.41
28975,23916,98,0,1841,44,54,10.0,0.0
28976,77100,76,77100,9185,59,17,1.6666666666666667,14.67
28977,86652,49,0,3080,44,5,100.0,0.0
28978,10869012,633,0,120738,353,280,2.0,0.0
28979,62856,95,0,5082,80,15,50.0,0.0
28980,9449124,5,25476,2826924,2,3,1.0,0.0
28981,2698020,50,2698020,28019,31,19,12.5,0.0
28982,19080,93,0,1057,56,37,50.0,0.0
28983,148380,22,148380,10035,16,6,11.11111111111111,1.65
28984,1488,21,1488,520,18,3,8.333333333333334,30.87
28985,251652,28,251652,247,24,4,100.0,0.0
28986,19260,25,19260,1640,21,4,6.666666666666667,5.37
28987,3528,27,3528,412,26,1,11.11111111111111,21.9
28988,324,81,324,17,81,0,2.3255813953488373,59.84
28989,69024,71,0,2322,46,25,100.0,0.0
28990,7104,26,2232,725,25,1,12.5,57.07
28991,0,1,0,0,1,0,25.0,0.0
28992,47196,19,47196,649,17,2,6.25,70.77
28993,157248,11,157248,648,10,1,12.5,80.18
28994,792,0,792,0,0,0,50.0,80.0
28995,37128,20,0,2693,17,3,100.0,0.0
28996,516,3,516,224,2,1,33.333333333333336,71.7
28997,384,17,384,117,9,8,14.285714285714286,94.62
28998,192,29,192,54,24,5,11.11111111111111,76.62
28999,140028,33,140028,7310,23,10,10.0,0.0
29000,3060,28,3060,450,26,2,10.0,60.19
29001,216,0,216,0,0,0,50.0,83.33
29002,2936400,221,2936400,23283,128,93,3.225806451612903,63.43
29003,8868972,959,0,663796,546,413,1.162790697674419,0.0
29004,7854768,168,7854768,80261,82,86,4.0,83.11
29005,1476,30,1476,441,29,1,7.6923076923076925,28.97
29006,2112,3,2112,532,3,0,33.333333333333336,0.0
29007,31356,51,0,1821,36,15,100.0,0.0
29008,1007808,101,0,29626,83,18,16.666666666666668,0.0
29009,10342296,261,1535670,217505,136,125,2.380952380952381,64.32
29010,16512,41,660,662,26,15,6.666666666666667,53.76
29011,10453872,69,10453872,39265,34,35,4.166666666666667,0.0
29012,16992,21,16992,1565,19,2,6.666666666666667,77.59
29013,600,3,600,220,3,0,20.0,95.07
29014,5316,29,5316,418,28,1,14.285714285714286,41.61
29015,650700,22,650700,10906,15,7,14.285714285714286,62.41
29016,192,38,192,61,22,16,6.25,58.42
29017,36144,69,0,1363,49,20,100.0,0.0
29018,143004,23,39996,6939,22,1,5.0,79.11
29019,96,1,96,0,1,0,33.333333333333336,84.17
29020,372,0,372,0,0,0,100.0,100.0
29021,4632,26,4632,570,24,2,11.11111111111111,31.15
29022,180,0,180,0,0,0,50.0,78.15
29023,0,0,0,0,0,0,50.0,0.0
29024,3297636,290,3297636,24272,185,105,1.9230769230769231,61.28
29025,3852,20,0,1050,18,2,100.0,0.0
29026,1356,10,1356,560,8,2,20.0,93.94
29027,10329564,37,780,279402,33,4,5.882352941176471,49.83
29028,11477316,370,0,2502417,229,141,1.492537313432836,10.27
29029,2052,9,2052,648,9,0,16.666666666666668,0.0
29030,12788820,2101,0,154406,1176,925,1.0,0.0
29031,3531972,242,0,25771,108,134,5.555555555555555,0.0
29032,636,1,636,72,1,0,50.0,51.9
29033,864,22,0,290,17,5,33.333333333333336,37.5
29034,15156,97,0,3318,77,20,25.0,0.0
29035,2628,18,2628,1100,15,3,8.333333333333334,92.49
29036,384,18,384,50,18,0,5.0,66.16
29037,223824,12,223824,173,9,3,14.285714285714286,89.56
29038,540984,4,540984,25065,1,3,100.0,100.0
29039,54792,18,54120,54125,14,4,7.6923076923076925,82.79
29040,1404,1,1404,456,1,0,100.0,0.0
29041,27276,1,27276,132,1,0,6.666666666666667,89.88
29042,30684,53,0,1465,41,12,100.0,0.0
29043,468,40,468,176,40,0,5.555555555555555,80.67
29044,3576,55,0,673,47,8,3.0303030303030303,0.0
29045,252,0,252,0,0,0,100.0,100.0
29046,2880,37,1404,218,37,0,4.545454545454546,67.08
29047,1500,81,1500,146,68,13,1.5625,41.55
29048,260508,129,260508,217,104,25,1.1235955056179776,35.25
29049,11651892,528,0,101647,289,239,2.3255813953488373,2.78
29050,1212,2,1212,510,2,0,50.0,16.29
29051,648,52,648,190,48,4,2.702702702702702,72.41
29052,1733760,147,312,13128,84,63,6.25,5.0
29053,34608,56,0,1671,42,14,100.0,0.0
29054,2448,1,2448,180,1,0,33.333333333333336,79.75
29055,8974308,204,0,57132,106,98,4.166666666666667,4.0
29056,180,13,180,62,13,0,6.666666666666667,75.63
29057,84,28,84,19,20,8,5.555555555555555,42.27
29058,180,2,180,42,2,0,25.0,78.43
29059,130188,763,72042,2412,687,76,1.0,0.0
29060,144,0,144,0,0,0,50.0,64.0
29061,48144,451,48144,299,243,208,1.0,34.36
29062,6480,51,0,680,40,11,3.333333333333333,0.0
29063,408,86,408,97,36,50,10.0,84.28
29064,12549756,890,0,424914,482,408,1.6666666666666667,0.0
29065,26988,0,26988,0,0,0,50.0,56.25
29066,8076,6,4170,3504,3,3,33.333333333333336,96.03
29067,7121400,209,7121400,16971,101,108,5.0,80.76
29068,1068,1,1068,0,1,0,33.333333333333336,88.93
29069,2829876,119,2829876,1984,51,68,6.666666666666667,82.89
29070,133872,14,0,9750,11,3,100.0,100.0
29071,2412228,13,2412228,1524,9,4,14.285714285714286,62.74
29072,134700,4,0,34680,2,2,100.0,100.0
29073,720,2,720,84,1,1,50.0,55.61
29074,264,40,264,119,40,0,2.4390243902439024,37.1
29075,516,176,0,79,141,35,1.0,0.0
29076,7513812,36,0,972936,18,18,8.333333333333334,2.0
29077,180,49,180,79,41,8,2.9411764705882355,32.36
29078,1020,21,1020,106,21,0,4.3478260869565215,80.96
29079,2148,58,2148,63,52,6,1.96078431372549,23.1
29080,8873796,190,0,47172,96,94,3.703703703703704,0.0
29081,10401516,638,0,48464,354,284,1.36986301369863,0.0
29082,1236,112,0,208,68,44,100.0,0.0
29083,12966720,16261,0,1581047,9036,7225,1.0,0.5
29084,852,71,852,59,57,14,1.8867924528301887,40.53
29085,12050316,27,12050316,8939,15,12,9.090909090909092,83.9
29086,2328,57,2328,39,53,4,1.8867924528301887,42.83
29087,852,29,852,43,23,6,4.545454545454546,69.62
29088,1218684,135,0,31129,64,71,5.0,2.28
29089,17100,49,0,801,35,14,100.0,0.0
29090,144,2,144,60,1,1,50.0,79.28
29091,5808,48,0,786,40,8,3.4482758620689653,0.0
29092,140124,169,140124,422,121,48,1.0416666666666667,20.31
29093,5105220,352,5105220,26583,203,149,3.0303030303030303,81.07
29094,9312,74,552,300,56,18,2.857142857142857,55.42
29095,120,4,120,48,2,2,50.0,78.56
29096,144,4,144,24,4,0,16.666666666666668,77.01
29097,216,7,216,63,6,1,14.285714285714286,58.23
29098,1764,7,1764,548,7,0,14.285714285714286,96.95
29099,108,0,108,0,0,0,50.0,85.0
29100,4920,3,4920,548,3,0,33.333333333333336,0.0
29101,636,51,636,48,47,4,2.127659574468085,44.68
29102,1920,13,0,422,11,2,100.0,0.0
29103,72,14,72,36,10,4,14.285714285714286,89.35
29104,0,0,0,0,0,0,1.0,0.0
29105,1356,11,1356,535,9,2,10.0,91.94
29106,72,1,72,0,1,0,33.333333333333336,78.0
29107,336,2,336,84,1,1,50.0,63.42
29108,240,12,240,63,7,5,25.0,58.4
29109,12055392,91,12055392,9381,39,52,9.090909090909092,87.46
29110,972,1,972,516,1,0,100.0,94.56
29111,11826384,1390,0,207580,763,627,1.0,0.0
29112,684,2,684,78,2,0,25.0,0.0
29113,39336,55,0,2744,34,21,100.0,0.0
29114,3924,115,0,487,83,32,100.0,0.0
29115,1200,12,1200,486,8,4,10.0,81.9
29116,2971284,33,2971284,8159,25,8,3.8461538461538463,42.31
29117,2484,224,0,211,155,69,1.0,0.0
29118,1224,0,1224,0,0,0,50.0,64.0
29119,96,0,96,0,0,0,50.0,80.0
29120,1980,1,1980,108,1,0,33.333333333333336,63.68
29121,10904844,338,10904844,4949,196,142,3.225806451612903,87.47
29122,444,48,444,24,45,3,2.2222222222222223,1.33
29123,10270020,626,0,47465,305,321,2.3255813953488373,0.0
29124,12648432,6173,1099284,358137,3499,2674,1.0,0.0
29125,4176,128,0,335,88,40,100.0,0.0
29126,396,113,396,41,101,12,1.7241379310344829,54.79
29127,5244,1,5244,36,1,0,50.0,56.62
29128,12472812,398,12472812,9297,217,181,2.4390243902439024,84.62
29129,2974488,151,2974488,71507,93,58,6.25,87.65
29130,12741900,5628,0,2332570,3999,1629,1.0,0.0
29131,1920,4,1920,819,4,0,25.0,22.34
29132,7752,67,0,1347,44,23,100.0,0.0
29133,54264,54,46848,5246,47,7,100.0,0.0
29134,204,8,204,42,5,3,25.0,62.12
29135,12850584,692,5877178,3711771,391,301,2.272727272727273,21.06
29136,840,17,840,345,14,3,8.333333333333334,90.06
29137,924,48,924,28,48,0,2.0,65.29
29138,1332,3,1332,540,3,0,33.333333333333336,0.0
29139,11959176,1106,6098060,973936,756,350,1.0,0.0
29140,7116,123,0,577,89,34,100.0,0.0
29141,2480328,31,303552,267552,24,7,5.882352941176471,87.11
29142,1561428,1133,0,9369,607,526,1.0,0.0
29143,103272,8,103272,34309,5,3,50.0,0.0
29144,119244,198,0,57286,136,62,100.0,100.0
29145,248940,206,0,3367,109,97,2.857142857142857,0.0
29146,244560,2,244560,3204,1,1,50.0,74.29
29147,2684880,144,2684880,5077,102,42,1.6666666666666667,47.95
29148,5187984,434,5187984,32724,236,198,2.702702702702702,0.0
29149,11545488,207,0,169791,133,74,2.1739130434782608,4.71
29150,45756,30,45756,311,21,9,100.0,0.0
29151,2028,85,2028,45,85,0,2.127659574468085,57.65
29152,7785204,380,7785204,3039,172,208,1.96078431372549,73.41
29153,9414588,15,0,745660,4,11,12.5,0.0
29154,16068,66,0,1062,50,16,100.0,0.0
29155,43644,43,0,2096,30,13,100.0,0.0
29156,15960,250,0,5472,140,110,50.0,0.0
29157,17856,4,372,4647,4,0,25.0,94.31
29158,12658428,1053,0,2775776,582,471,1.1904761904761905,0.0
29159,2752008,414,2752008,7498,228,186,3.333333333333333,0.0
29160,10549560,209,1680,51515,118,91,1.4285714285714286,28.29
29161,9432756,836,0,22318,484,352,1.1363636363636365,0.0
29162,192,11,192,20,11,0,7.6923076923076925,40.03
29163,443664,35,443664,145,29,6,3.333333333333333,4.59
29164,26748,144,0,267,130,14,1.0,0.0
29165,558420,44,0,16720,29,15,100.0,0.0
29166,2776824,202,0,275785,118,84,2.2222222222222223,0.0
29167,1236,0,1236,0,0,0,100.0,100.0
29168,180,27,180,50,18,9,8.333333333333334,59.24
29169,888,0,888,0,0,0,50.0,64.0
29170,117768,2,132,58890,2,0,50.0,89.33
29171,2664492,343,2664492,18928,159,184,2.9411764705882355,72.3
29172,876,0,876,0,0,0,100.0,100.0
29173,1320,8,1188,807,6,2,25.0,0.0
29174,12995928,2379,0,945656,955,1424,1.0,0.0
29175,576,33,576,166,33,0,2.9411764705882355,45.96
29176,1992,10,1992,0,10,0,8.333333333333334,65.6
29177,5231784,242,5231784,201545,123,119,5.882352941176471,86.87
29178,19296,7,19296,332,4,3,50.0,5.0
29179,564,17,564,222,15,2,5.882352941176471,71.53
29180,1356,19,0,625,11,8,12.5,0.0
29181,792,85,792,56,65,20,1.7543859649122806,58.01
29182,1656,23,0,461,17,6,100.0,0.0
29183,2995500,127,2995500,30939,71,56,3.4482758620689653,51.04
29184,7856280,463,7856280,5453,184,279,2.380952380952381,0.0
29185,6786612,142,523740,301001,50,92,2.272727272727273,0.0
29186,876,26,180,112,16,10,10.0,63.54
29187,348,7,348,89,5,2,16.666666666666668,94.06
29188,68676,59,68676,5454,56,3,100.0,0.0
29189,516,28,516,73,24,4,4.3478260869565215,59.63
29190,1236,117,1236,450,94,23,1.3157894736842106,31.38
29191,180,8,180,64,8,0,10.0,92.0
29192,468,151,396,229,116,35,1.0,32.92
29193,2304,14,0,577,12,2,100.0,0.0
29194,444,38,444,178,38,0,2.702702702702702,0.0
29195,16188,85,0,1430,57,28,100.0,0.0
29196,1896,3,1896,804,3,0,20.0,89.44
29197,360,46,336,131,44,2,7.142857142857143,43.54
29198,1109208,414,0,51781,240,174,1.0,0.0
29199,84744,35,84744,1290,28,7,3.8461538461538463,44.62
29200,9487704,15,0,822900,11,4,100.0,0.0
29201,420,6,420,66,3,3,50.0,85.11
29202,13812,8,1032,1753,7,1,11.11111111111111,70.13
29203,6175236,16,89172,387620,16,0,7.142857142857143,55.59
29204,70680,293,0,10895,204,89,100.0,0.0
29205,5952,20,5952,1216,18,2,6.25,74.05
29206,663336,377,334482,2886,257,120,1.0,6.24
29207,0,0,0,0,0,0,50.0,0.0
29208,10644,0,10644,0,0,0,100.0,100.0
29209,7877640,104,7877640,7154,55,49,14.285714285714286,97.42
29210,12931740,769,0,192053,425,344,1.2987012987012987,6.11
29211,7978512,276,40316,91912,211,65,1.2048192771084338,0.0
29212,2532,18,0,552,15,3,100.0,0.0
29213,6636,29,6636,295,27,2,3.703703703703704,52.57
29214,49020,116,0,5158,91,25,33.333333333333336,0.0
29215,10938960,3,12012,4923108,2,1,7.6923076923076925,83.69
29216,996,1,324,996,0,1,33.333333333333336,64.0
29217,26364,52,0,1216,37,15,50.0,0.0
29218,6434544,368,0,138212,177,191,2.5641025641025643,0.0
29219,84,0,84,0,0,0,50.0,67.24
29220,14652,12,14652,28,8,4,16.666666666666668,70.74
29221,27732,5,27732,722,5,0,11.11111111111111,0.0
29222,14664,21,14664,1023,19,2,6.25,71.72
29223,30252,60,0,1111,43,17,100.0,0.0
29224,12966600,1055,0,5435629,960,95,16.666666666666668,0.0
29225,82488,4,82488,20256,4,0,4.545454545454546,75.92
29226,696,117,696,142,94,23,1.818181818181818,55.56
29227,9612540,39,0,247053,32,7,3.703703703703704,0.0
29228,8184,230,0,1304,162,68,100.0,0.0
29229,9131172,1188,0,525957,639,549,1.1764705882352942,0.0
29230,1136064,203,481456,147372,158,45,1.492537313432836,34.77
29231,192,13,132,55,11,2,9.090909090909092,82.28
29232,4032,32,4032,776,31,1,8.333333333333334,33.45
29233,3192,18,0,588,13,5,100.0,0.0
29234,44616,65,0,1834,43,22,100.0,0.0
29235,1068,67,1068,37,67,0,1.4492753623188406,67.89
29236,218640,24,218640,3017,13,11,33.333333333333336,56.69
29237,9040068,736,9040068,69231,372,364,1.25,65.94
29238,85188,30,85188,8269,26,4,5.0,2.99
29239,216,6,216,48,5,1,16.666666666666668,71.35
29240,90372,34,90372,524,32,2,3.125,33.12
29241,8904120,27,4200,659969,26,1,14.285714285714286,30.58
29242,8076,79,0,1221,52,27,100.0,0.0
29243,7944,131,0,877,92,39,100.0,0.0
29244,482076,33,145188,21007,27,6,14.285714285714286,1.38
29245,16308,436,1968,268,233,203,1.0,34.15
29246,2959908,1117,0,22351,645,472,1.0,0.0
29247,39588,234,0,10974,140,94,50.0,0.0
29248,19968,264,0,1131,138,126,4.761904761904762,0.0
29249,3504,30,3504,886,29,1,10.0,19.27
29250,624,2,624,102,2,0,33.333333333333336,98.76
29251,6051792,23,15264,790169,20,3,6.666666666666667,67.93
29252,29532,24,29532,15393,15,9,1.0,0.0
29253,1692,20,0,439,16,4,100.0,0.0
29254,13500,69,0,1045,52,17,50.0,0.0
29255,17556,17,0,3657,15,2,6.666666666666667,0.0
29256,99744,80,0,3319,42,38,100.0,0.0
29257,3156,22,3156,1248,20,2,5.882352941176471,33.3
29258,3984,11,3984,1610,11,0,8.333333333333334,81.44
29259,44808,141,0,3086,94,47,100.0,0.0
29260,3696564,83,2820036,984207,59,24,11.11111111111111,0.0
29261,1776,28,1776,476,27,1,7.142857142857143,0.0
29262,20676,23,20676,1339,21,2,6.25,73.36
29263,1404,16,0,446,13,3,100.0,0.0
29264,16956,3,16956,508,3,0,33.333333333333336,0.0
29265,104700,417,56724,4392,320,97,1.0,0.0
29266,4800600,28,1512,171942,27,1,14.285714285714286,24.72
29267,7594212,143,0,111891,118,25,14.285714285714286,0.0
29268,129828,27,129828,1784,23,4,6.666666666666667,63.35
29269,8640,104,0,1402,70,34,100.0,0.0
29270,648,2,648,186,2,0,25.0,96.22
29271,82968,13,82968,4221,10,3,12.5,91.29
29272,24600,81,0,2174,68,13,100.0,0.0
29273,2441904,172,0,35601,79,93,7.142857142857143,0.0
29274,108324,44,0,5277,30,14,100.0,0.0
29275,3540,55,3540,77,53,2,1.818181818181818,24.21
29276,672,1,672,0,1,0,33.333333333333336,57.75
29277,5280,32,5280,5114,22,10,5.882352941176471,62.57
29278,1080,56,1080,54,52,4,1.9230769230769231,41.94
29279,65628,60,0,9971,47,13,100.0,0.0
29280,3516,26,3516,450,25,1,6.666666666666667,32.22
29281,2340,122,0,888,74,48,100.0,0.0
29282,228,25,228,42,20,5,5.882352941176471,36.8
29283,32688,40,0,1806,26,14,100.0,0.0
29284,12712896,805,0,159769,436,369,2.083333333333333,0.0
29285,11307504,1836,0,131860,1022,814,1.0,3.86
29286,4065108,234,0,22703,125,109,4.545454545454546,0.0
29287,912,136,0,109,127,9,1.0,0.0
29288,324,64,324,52,48,16,2.3255813953488373,27.1
29289,192,35,192,76,17,18,10.0,52.4
29290,12123960,55,12123960,879296,21,34,16.666666666666668,92.82
29291,176532,64,30984,5610,48,16,2.4390243902439024,26.17
29292,1116,64,1116,106,58,6,1.7543859649122806,39.43
29293,3888,30,3888,562,29,1,10.0,30.08
29294,8905164,41,0,320097,32,9,14.285714285714286,0.0
29295,7922232,332,7922232,12952,127,205,4.166666666666667,77.38
29296,11628,1,11628,1584,1,0,100.0,100.0
29297,174096,120,130260,55010,93,27,1.7857142857142858,0.0
29298,2124456,20,2124456,997303,20,0,7.6923076923076925,63.66
29299,2484,31,2484,1537,30,1,3.8461538461538463,2.86
29300,1956,8,1956,774,8,0,12.5,0.0
29301,600,41,600,92,36,5,4.3478260869565215,75.63
29302,1404,1,1404,564,1,0,100.0,96.27
29303,396,25,396,97,25,0,3.8461538461538463,70.05
29304,10848,101,0,1931,66,35,100.0,0.0
29305,36012,50,18540,316,47,3,5.555555555555555,0.0
29306,22404,102,0,1646,75,27,100.0,0.0
29307,2784,21,2784,1189,18,3,7.142857142857143,37.11
29308,9077304,628,0,55918,370,258,1.6129032258064515,0.0
29309,1272,263,0,155,228,35,1.0,0.0
29310,8976,37,0,1337,29,8,100.0,0.0
29311,2700,0,2700,0,0,0,50.0,64.0
29312,10140,149,0,1668,100,49,100.0,0.0
29313,7888656,580,7888656,22000,303,277,1.6129032258064515,75.19
29314,9299496,417,9299496,52343,258,159,1.818181818181818,57.49
29315,372,0,372,0,0,0,100.0,100.0
29316,240,0,240,0,0,0,100.0,100.0
29317,2100,0,2100,0,0,0,50.0,64.0
29318,780,8,780,267,5,3,33.333333333333336,96.33
29319,4752,2,4752,498,2,0,25.0,95.74
29320,13082580,23458,3008515,4611946,13701,9757,1.0,0.0
29321,7941504,244,7941504,43198,137,107,7.6923076923076925,86.54
29322,10642632,7,1188,1523235,4,3,20.0,67.22
29323,1284,12,1284,314,12,0,12.5,58.54
29324,2340,6,2340,92,6,0,12.5,68.93
29325,1524,32,1524,1353,20,12,7.6923076923076925,85.8
29326,5772,11,5772,414,11,0,11.11111111111111,30.06
29327,2040,43,1842,964,41,2,2.857142857142857,43.37
29328,157272,24,157272,1082,24,0,4.166666666666667,22.99
29329,1344036,38,1344036,27244,38,0,4.0,43.1
29330,2652948,16,2652948,56932,10,6,25.0,51.14
29331,5117004,599,5117004,6931,307,292,1.5384615384615383,65.12
29332,384,6,384,122,6,0,14.285714285714286,84.88
29333,65904,117,65904,3783,92,25,1.4705882352941178,2.54
29334,372,1,372,108,1,0,50.0,55.0
29335,10547064,1215,389184,99855,502,713,1.6666666666666667,0.0
29336,10322400,941,0,390832,595,346,1.0,0.0
29337,64812,167,0,3031,102,65,33.333333333333336,0.0
29338,6612,30,0,1400,23,7,100.0,0.0
29339,11935524,260,6208836,69324,140,120,4.0,82.53
29340,57804,17,57804,3025,11,6,16.666666666666668,48.54
29341,276,4,276,180,4,0,20.0,96.97
29342,336,2,336,72,1,1,50.0,78.64
29343,13086768,3468,6941760,5618237,1990,1478,1.0,0.0
29344,696,17,696,594,17,0,5.2631578947368425,64.44
29345,30996,76,0,1014,52,24,50.0,0.0
29346,19896,89,0,4364,59,30,100.0,0.0
29347,63792,26,63792,4810,23,3,4.761904761904762,4.74
29348,10853076,83,1384188,818944,46,37,1.0,0.0
29349,9264,136,0,1362,79,57,100.0,0.0
29350,13920,30,8100,3928,18,12,12.5,98.61
29351,2182164,1080,0,152086,612,468,1.0,0.0
29352,6579780,178,4237530,1453,116,62,1.5151515151515151,29.92
29353,263364,30,0,9570,23,7,100.0,100.0
29354,84,1,84,0,1,0,33.333333333333336,78.07
29355,156,30,84,25,24,6,4.545454545454546,44.17
29356,2624532,969,2624532,138445,477,492,1.36986301369863,0.0
29357,32316,129,0,2186,88,41,100.0,0.0
29358,8376,68,0,609,44,24,50.0,0.0
29359,3620376,1108,0,13837,644,464,1.0638297872340423,0.0
29360,79356,208,0,6294,135,73,33.333333333333336,0.0
29361,2760,1,2760,564,1,0,50.0,0.1
29362,38916,30,38916,675,27,3,3.8461538461538463,41.82
29363,11395380,863,0,23707,485,378,1.818181818181818,0.0
29364,840,23,840,507,20,3,5.0,79.73
29365,39396,69,31248,28349,68,1,1.4492753623188406,36.49
29366,62208,22,35340,6554,21,1,5.2631578947368425,68.38
29367,9853716,740,7823616,80803,343,397,1.075268817204301,0.0
29368,20388,15,20388,733,9,6,16.666666666666668,7.6
29369,2136,1,2136,744,1,0,100.0,100.0
29370,272568,23,0,12183,17,6,100.0,100.0
29371,86160,58,86160,1148,41,17,100.0,0.0
29372,0,0,0,0,0,0,100.0,0.0
29373,56100,102,0,2812,86,16,14.285714285714286,0.0
29374,684,55,684,339,48,7,2.0,18.24
29375,1080,9,1080,221,8,1,11.11111111111111,55.89
29376,44340,25,44340,1319,25,0,4.545454545454546,75.32
29377,17712,22,17712,460,21,1,14.285714285714286,32.15
29378,100584,87,100584,16742,72,15,100.0,0.0
29379,66204,5,66204,79,5,0,25.0,0.0
29380,696,97,696,171,67,30,2.0,28.31
29381,1116,125,1116,364,91,34,1.5625,18.06
29382,203868,10,161976,106881,5,5,33.333333333333336,96.94
29383,408,8,408,220,8,0,11.11111111111111,84.5
29384,72,23,72,22,21,2,5.0,61.85
29385,16668,69,0,1769,57,12,25.0,0.0
29386,12668868,1370,0,126609,792,578,1.1764705882352942,0.0
29387,14988,31,14988,1711,29,2,10.0,27.12
29388,10704564,72,0,449622,50,22,33.333333333333336,0.0
29389,372,6,144,102,3,3,33.333333333333336,61.3
29390,432,30,432,54,24,6,4.3478260869565215,43.25
29391,12110388,2740,3125796,1102595,1254,1486,1.0,0.0
29392,3204,31,2376,1467,31,0,5.2631578947368425,79.46
29393,1896,22,996,86,22,0,4.3478260869565215,59.34
29394,12157788,305,0,922450,161,144,1.818181818181818,0.0
29395,3900,25,3900,499,24,1,20.0,57.46
29396,8543268,125,5240766,100621,75,50,4.545454545454546,0.0
29397,42036,354,26538,3652,280,74,1.0,0.0
29398,462744,22,462744,4756,18,4,6.666666666666667,65.09
29399,312,11,156,99,10,1,9.090909090909092,65.6
29400,468,26,468,26,24,2,4.0,61.08
29401,9669732,1280,0,74626,730,550,1.1111111111111112,0.0
29402,5076,28,948,293,25,3,4.0,0.0
29403,131232,46,0,6357,32,14,100.0,0.0
29404,2628,47,0,987,39,8,2.857142857142857,0.0
29405,1454664,41,1454664,7710,33,8,4.166666666666667,53.63
29406,3408,118,0,1217,87,31,100.0,100.0
29407,1728,36,0,472,27,9,25.0,25.0
29408,6000,76,408,232,60,16,1.8867924528301887,57.49
29409,2268,2,2268,474,2,0,50.0,0.0
29410,130992,173,0,2578,115,58,25.0,0.0
29411,12913416,447,0,2230471,255,192,2.083333333333333,0.0
29412,288,63,108,36,47,16,2.380952380952381,23.62
29413,1320,19,1320,488,14,5,10.0,45.07
29414,9234408,22,9234408,707,21,1,4.3478260869565215,46.09
29415,2064,77,636,98,51,26,11.11111111111111,83.2
29416,600,319,600,131,181,138,1.0,13.74
29417,288,0,288,0,0,0,100.0,100.0
29418,14040,102,0,1440,74,28,100.0,0.0
29419,6468,217,0,1479,136,81,100.0,0.0
29420,588,35,588,25,29,6,3.703703703703704,0.0
29421,37908,52,37908,925,52,0,1.851851851851852,57.41
29422,9238860,39,6578892,414,31,8,4.545454545454546,68.02
29423,1299636,66,1299636,46906,44,22,4.761904761904762,49.28
29424,128904,50,128904,2146,47,3,2.127659574468085,21.08
29425,167712,217,0,2763,151,66,50.0,0.0
29426,2484,0,2484,0,0,0,100.0,100.0
29427,552,31,408,219,30,1,3.8461538461538463,78.37
29428,240,45,240,18,43,2,2.272727272727273,24.14
29429,3972,43,3972,92,37,6,2.7777777777777777,0.0
29430,300,21,300,38,11,10,25.0,93.95
29431,16272,67,96,465,42,25,5.0,67.25
29432,6048,2,6048,4566,1,1,50.0,0.0
29433,39708,141,39708,3593,99,42,100.0,0.0
29434,132288,24,132288,4176,19,5,6.666666666666667,1.23
29435,1416,14,1416,275,11,3,10.0,57.13
29436,420,56,420,18,56,0,1.7241379310344829,51.83
29437,14304,109,0,1210,83,26,100.0,100.0
29438,564,31,564,68,31,0,4.0,79.15
29439,2712,5,2712,871,3,2,50.0,98.45
29440,9245676,49,5602518,609,40,9,3.125,62.36
29441,434376,76,0,232813,55,21,3.0303030303030303,0.0
29442,374940,236,0,5456,138,98,100.0,0.0
29443,1380,5,1380,532,4,1,20.0,93.6
29444,720,14,720,229,12,2,7.6923076923076925,82.96
29445,10246344,675,0,170815,345,330,2.702702702702702,0.0
29446,756,32,756,241,32,0,3.0303030303030303,84.5
29447,1308,84,1308,24,84,0,2.1739130434782608,58.26
29448,276,0,276,0,0,0,50.0,4.0
29449,391512,149,0,66311,122,27,1.1764705882352942,0.0
29450,864,51,864,473,39,12,2.857142857142857,64.16
29451,684,30,684,253,19,11,8.333333333333334,32.87
29452,2784960,25,2784960,45210,14,11,12.5,0.0
29453,1812,33,0,474,27,6,100.0,0.0
29454,2508,9,0,745,6,3,100.0,0.0
29455,78744,39,0,2647,28,11,100.0,100.0
29456,132,10,132,57,6,4,25.0,74.82
29457,11694600,789,0,71875,453,336,1.0526315789473684,2.51
29458,11866068,171,2652276,778775,86,85,2.5641025641025643,47.97
29459,588,4,588,243,2,2,33.333333333333336,0.0
29460,408,8,408,72,5,3,25.0,59.12
29461,4584,53,600,110,51,2,1.96078431372549,53.95
29462,77748,45,77748,7454,38,7,4.545454545454546,5.11
29463,11335620,288,11335620,14368,158,130,1.639344262295082,56.85
29464,158712,61,158712,1227,56,5,1.8867924528301887,21.24
29465,2604,22,0,590,18,4,100.0,0.0
29466,1634304,50,2472,33537,43,7,2.127659574468085,0.0
29467,34212,26,34212,1768,24,2,8.333333333333334,33.56
29468,2916,41,396,199,37,4,4.3478260869565215,79.8
29469,1181520,12,0,412933,6,6,50.0,0.0
29470,14208,162,0,1995,104,58,100.0,100.0
29471,13160700,648,1755006,1073138,377,271,1.0,0.0
29472,22680,27,22680,1744,23,4,5.555555555555555,71.18
29473,2412,9,0,629,7,2,25.0,0.0
29474,1191660,87,1191660,335679,73,14,1.818181818181818,47.35
29475,149436,18,149436,1381,16,2,6.666666666666667,47.53
29476,1248,11,1248,867,11,0,7.6923076923076925,78.91
29477,1464,13,1464,1150,8,5,20.0,82.36
29478,67776,47,67776,463,34,13,100.0,0.0
29479,13176,39,13176,928,31,8,3.703703703703704,53.41
29480,636,1,636,0,1,0,33.333333333333336,95.25
29481,276,5,276,141,3,2,25.0,83.01
29482,528,72,528,198,49,23,2.5641025641025643,44.01
29483,8050896,250,8050896,11920,141,109,7.142857142857143,95.03
29484,3240,80,0,1365,59,21,100.0,100.0
29485,360,39,360,125,31,8,3.703703703703704,71.06
29486,2888580,104,2888580,2872,54,50,10.0,89.22
29487,8130828,2529,5889618,171264,1447,1082,1.0,0.0
29488,19668,214,0,2889,137,77,100.0,0.0
29489,264,4,264,153,4,0,16.666666666666668,92.18
29490,5962356,1100,0,35095,644,456,1.0,4.0
29491,1248,3,1248,64,3,0,20.0,51.78
29492,1478544,41,1478544,700355,17,24,1.0,0.0
29493,65712,109,65712,3761,88,21,100.0,0.0
29494,300,30,300,100,14,16,12.5,75.3
29495,2796,3,0,1032,2,1,100.0,0.0
29496,132,35,132,28,29,6,3.571428571428572,31.11
29497,2645520,242,2645520,4143,114,128,2.5641025641025643,76.66
29498,224232,55,0,10349,46,9,100.0,0.0
29499,36084,43,132,1755,37,6,2.702702702702702,24.57
29500,4620,206,0,266,107,99,10.0,0.0
29501,180,1,180,60,1,0,50.0,83.3
29502,143328,79,143328,3034,65,14,100.0,0.0
29503,32028,244,0,7100,154,90,100.0,0.0
29504,60,1,0,60,1,0,100.0,100.0
29505,1476,12,1476,222,10,2,11.11111111111111,85.93
29506,75708,55,18288,3936,51,4,2.083333333333333,19.92
29507,2148,109,2148,612,62,47,7.6923076923076925,94.76
29508,144036,28,144036,6900,22,6,7.6923076923076925,1.98
29509,10481688,1077,0,27750,610,467,1.2195121951219512,0.0
29510,3696,59,0,648,42,17,100.0,0.0
29511,355368,5,227204,225256,4,1,1.0,0.0
29512,1992,21,1992,402,20,1,10.0,26.28
29513,592104,17,426177,271245,5,12,1.0,0.0
29514,5544096,1807,3180030,2295050,1097,710,1.0,0.0
29515,6504,163,0,987,111,52,100.0,0.0
29516,1332,3,1332,468,3,0,50.0,0.0
29517,13716,21,13716,846,20,1,5.882352941176471,78.45
29518,12989436,1531,0,2554077,873,658,1.098901098901099,0.0
29519,43584,16,43584,309,13,3,9.090909090909092,64.07
29520,149028,56,0,6351,41,15,100.0,0.0
29521,552,2,552,6,2,0,33.333333333333336,98.92
29522,121608,32,2640,5622,30,2,25.0,31.1
29523,71424,126,29304,2563,90,36,1.8867924528301887,2.15
29524,4020,0,4020,0,0,0,50.0,42.25
29525,5388,105,0,1245,75,30,100.0,100.0
29526,852,7,0,497,5,2,100.0,0.0
29527,1380,1,1380,648,1,0,100.0,97.31
29528,2460,31,2460,671,28,3,10.0,39.52
29529,229068,49,0,5950,33,16,100.0,0.0
29530,10716,32,10716,244,25,7,3.8461538461538463,20.99
29531,516,2,516,222,2,0,33.333333333333336,93.88
29532,58836,61,0,3693,39,22,100.0,0.0
29533,780,17,780,184,16,1,8.333333333333334,72.83
29534,480,47,480,263,39,8,2.857142857142857,47.6
29535,14316,1,14316,12,1,0,50.0,99.92
29536,265632,57,0,6943,35,22,100.0,0.0
29537,1464,24,1464,415,24,0,9.090909090909092,47.4
29538,4200,65,0,610,48,17,100.0,0.0
29539,22152,27,22152,1663,23,4,7.6923076923076925,1.32
29540,18036,24,18036,1028,22,2,5.555555555555555,78.92
29541,1116,36,1116,743,20,16,7.142857142857143,80.11
29542,1872,17,0,391,14,3,100.0,0.0
29543,23280,1,23280,0,1,0,33.333333333333336,88.34
29544,3048,33,3048,661,32,1,11.11111111111111,34.25
29545,68100,108,0,3801,92,16,100.0,0.0
29546,58872,98,0,3193,79,19,100.0,0.0
29547,66720,60,0,3001,42,18,100.0,0.0
29548,1956,62,0,722,49,13,2.5641025641025643,0.0
29549,120,10,120,39,5,5,50.0,61.97
29550,35868,108,0,2773,73,35,50.0,0.0
29551,144,7,144,27,4,3,33.333333333333336,81.34
29552,435036,45,435036,164,44,1,2.1739130434782608,23.91
29553,160692,74,888,2289,66,8,1.5151515151515151,43.13
29554,300,7,0,111,4,3,50.0,0.0
29555,13140,13,13140,708,10,3,12.5,0.0
29556,13224,19,13224,704,17,2,7.142857142857143,70.53
29557,17784,49,17784,1169,45,4,2.2222222222222223,22.19
29558,27696,15,27696,4288,8,7,50.0,78.04
29559,741636,63,0,44518,53,10,50.0,0.0
29560,819528,70,305376,47849,62,8,1.851851851851852,25.29
29561,1032,45,0,269,36,9,33.333333333333336,37.5
29562,4082148,294,0,60309,150,144,2.9411764705882355,4.84
29563,78636,56,78636,36214,33,23,3.225806451612903,93.32
29564,936,12,936,459,10,2,11.11111111111111,0.0
29565,49296,2,49296,450,1,1,100.0,100.0
29566,30828,157,0,4071,107,50,33.333333333333336,0.0
29567,1005228,98,0,61470,83,15,33.333333333333336,0.0
29568,1164,54,1164,512,52,2,4.3478260869565215,71.99
29569,12731244,55,0,726442,39,16,33.333333333333336,0.0
29570,78252,45,0,2581,26,19,100.0,0.0
29571,13368,24,13368,384,23,1,10.0,58.63
29572,636,34,636,202,32,2,4.3478260869565215,37.51
29573,5748,18,0,945,16,2,100.0,0.0
29574,3806040,62,3806040,2802,51,11,2.5641025641025643,40.65
29575,3561204,163,3561204,5153,108,55,4.3478260869565215,81.97
29576,232608,46,0,6987,38,8,50.0,0.0
29577,11052,93,0,2166,76,17,20.0,0.0
29578,84,0,84,0,0,0,100.0,100.0
29579,79644,52,0,2618,35,17,100.0,0.0
29580,132,1,132,108,1,0,33.333333333333336,99.01
29581,34800,54,0,1752,40,14,100.0,0.0
29582,936,78,936,46,72,6,2.3255813953488373,33.38
29583,2747772,26,2747772,447038,20,6,5.555555555555555,68.9
29584,4896,26,4896,1957,23,3,5.0,29.64
29585,1056,40,432,110,38,2,3.703703703703704,0.0
29586,1284,31,1284,704,31,0,12.5,58.3
29587,576,7,576,270,7,0,11.11111111111111,87.47
29588,2916,5,2916,669,5,0,20.0,0.0
29589,1152,20,1152,384,19,1,7.142857142857143,70.78
29590,11152764,938,11152764,58112,582,356,1.020408163265306,80.06
29591,29028,57,0,2272,34,23,100.0,0.0
29592,29412,68,0,2669,53,15,100.0,0.0
29593,1752,29,1752,339,28,1,11.11111111111111,50.4
29594,17688,58,0,830,42,16,100.0,0.0
29595,20724,5,20724,52,5,0,14.285714285714286,0.0
29596,2088,69,0,593,57,12,2.7777777777777777,0.0
29597,504,14,504,138,14,0,6.25,72.91
29598,106824,1137,42928,14659,891,246,1.0,13.58
29599,1788,9,1788,526,9,0,11.11111111111111,15.36
29600,408,7,408,289,4,3,33.333333333333336,0.0
29601,2880,36,2880,441,33,3,25.0,45.22
29602,2661408,56,1872,95125,46,10,2.4390243902439024,0.0
29603,1116,2,1116,444,2,0,50.0,0.0
29604,6984,26,6984,1922,23,3,4.761904761904762,48.73
29605,432,21,432,190,17,4,5.882352941176471,70.2
29606,7248,9,0,2556,6,3,100.0,100.0
29607,4386636,222,949344,516346,118,104,1.0,0.0
29608,9248028,135,0,86428,110,25,14.285714285714286,0.0
29609,92904,37,92904,13319,31,6,3.8461538461538463,37.39
29610,300,59,300,78,40,19,4.0,70.94
29611,372,19,372,108,16,3,8.333333333333334,73.18
29612,131928,0,131928,0,0,0,100.0,100.0
29613,5796,39,5796,1989,37,2,8.333333333333334,25.61
29614,1572,3,1572,588,3,0,50.0,15.97
29615,14640,58,0,2433,47,11,100.0,0.0
29616,13229400,1373,0,358404,792,581,1.0526315789473684,0.0
29617,69240,27,0,2911,23,4,100.0,0.0
29618,2148,29,576,333,26,3,4.545454545454546,46.59
29619,267024,265,133998,75003,98,167,5.555555555555555,72.3
29620,588,4,588,120,2,2,50.0,62.85
29621,7916280,166,7916280,10671,79,87,12.5,94.3
29622,72,6,72,24,3,3,50.0,70.83
29623,168,13,168,58,11,2,10.0,81.64
29624,144,10,144,24,5,5,50.0,56.16
29625,360,3,360,0,3,0,20.0,74.0
29626,1152,143,0,132,112,31,1.0101010101010102,0.0
29627,49440,56,49440,1014,53,3,1.8867924528301887,25.26
29628,7881288,731,7881024,78166,374,357,1.2048192771084338,54.64
29629,300,26,300,98,26,0,3.703703703703704,54.66
29630,91896,0,91896,0,0,0,50.0,95.0
29631,26616,115,0,1553,71,44,50.0,0.0
29632,372,4,372,81,2,2,33.333333333333336,0.0
29633,6264,22,6264,2392,20,2,5.2631578947368425,52.3
29634,96,14,96,11,12,2,8.333333333333334,0.0
29635,144,0,144,0,0,0,50.0,80.0
29636,144,2,144,30,1,1,50.0,58.66
29637,1884,10,1884,27,10,0,8.333333333333334,82.6
29638,1368,84,1368,28,84,0,2.1739130434782608,58.79
29639,2202672,8,0,277081,6,2,25.0,32.67
29640,1272,23,1272,423,14,9,14.285714285714286,78.6
29641,36888,150,36888,3642,112,38,1.36986301369863,4.79
29642,300,24,300,113,14,10,9.090909090909092,57.18
29643,9327276,17,9327276,374,15,2,7.142857142857143,77.89
29644,44712,213,0,5111,146,67,33.333333333333336,0.0
29645,6645012,56,3391284,3000120,41,15,2.702702702702702,70.21
29646,1980,38,1980,35,32,6,3.225806451612903,73.91
29647,408,9,372,368,7,2,14.285714285714286,88.05
29648,84624,250,0,2575,173,77,25.0,0.0
29649,456,59,456,35,59,0,1.6666666666666667,45.73
29650,35568,66,0,32384,41,25,50.0,0.0
29651,132,18,132,81,12,6,9.090909090909092,85.39
29652,5952,59,5952,576,59,0,1.851851851851852,25.22
29653,4944,214,0,986,134,80,100.0,0.0
29654,68916,34,68916,14012,28,6,6.25,5.4
29655,13258236,1657,0,87901,930,727,1.0,0.0
29656,10934160,196,0,517661,115,81,3.571428571428572,3.69
29657,2573460,314,2573460,4396,198,116,3.333333333333333,83.83
29658,7995624,29,0,1853423,14,15,1.694915254237288,0.04
29659,576,11,576,73,9,2,11.11111111111111,51.06
29660,14868,5,7476,3187,5,0,20.0,3.21
29661,720,11,720,194,11,0,8.333333333333334,6.47
29662,12955512,602,0,982752,335,267,1.0,5.15
29663,11582412,1883,7891222,243990,841,1042,1.0,0.0
29664,15984,118,732,237,96,22,1.1904761904761905,40.51
29665,40116,176,0,21843,113,63,50.0,0.0
29666,59412,32,0,22264,21,11,100.0,0.0
29667,744,24,744,294,14,10,9.090909090909092,78.62
29668,8888904,928,8888904,92254,508,420,1.0526315789473684,60.11
29669,2988,6,2988,1384,3,3,33.333333333333336,98.96
29670,3000,113,3000,436,107,6,1.0,71.91
29671,96,13,96,17,12,1,7.6923076923076925,79.71
29672,444,8,0,145,4,4,20.0,0.0
29673,12321924,0,12321616,0,0,0,50.0,99.1
29674,12835260,112,0,7030845,68,44,2.5,0.0
29675,12033936,2598,219504,139216,1439,1159,1.0,1.43
29676,11674392,261,0,962494,143,118,2.1739130434782608,0.0
29677,398844,283,0,3340,137,146,5.2631578947368425,0.0
29678,2748,18,2748,723,16,2,6.666666666666667,42.89
29679,1368,0,1368,0,0,0,50.0,70.0
29680,2340,4,2340,696,2,2,33.333333333333336,86.08
29681,6012,2,6012,72,2,0,33.333333333333336,3.29
29682,82152,8,82152,37795,4,4,50.0,94.68
29683,43308,41,43308,526,38,3,2.631578947368421,25.78
29684,2136,38,2136,1936,18,20,10.0,91.28
29685,55332,74,55332,838,58,16,100.0,0.0
29686,1848,98,1848,25,98,0,1.6666666666666667,51.73
29687,12345372,0,12345372,0,0,0,100.0,100.0
29688,766008,13,766008,2399,11,2,25.0,0.62
29689,552,20,552,252,16,4,6.25,86.99
29690,168,21,168,56,17,4,6.25,63.59
29691,2136,4,2136,168,4,0,16.666666666666668,0.0
29692,13266168,6953,0,3012166,4202,2751,1.0,0.0
29693,180,21,180,68,16,5,8.333333333333334,50.41
29694,9852,21,9852,908,20,1,5.555555555555555,78.99
29695,924,49,744,222,43,6,2.4390243902439024,0.0
29696,2752884,106,2752884,25438,46,60,9.090909090909092,0.0
29697,2388,15,0,1566,9,6,16.666666666666668,0.0
29698,169692,74,4104,14447,60,14,100.0,0.0
29699,25032,429,0,10003,147,282,1.4492753623188406,0.55
29700,101520,12,101520,30716,9,3,14.285714285714286,99.11
29701,12761832,1240,0,30605,716,524,1.0638297872340423,2.99
29702,2016,2,0,2016,2,0,20.0,0.0
29703,11376096,285,344832,190095,167,118,3.225806451612903,0.0
29704,326292,140,326292,257,114,26,1.1235955056179776,48.11
29705,3790008,35,0,109374,28,7,20.0,0.0
29706,1860,13,0,1734,11,2,7.142857142857143,0.0
29707,840,1,840,204,1,0,33.333333333333336,69.31
29708,60,3,0,20,2,1,20.0,65.41
29709,8748,25,0,1887,17,8,100.0,0.0
29710,37476,4,37476,1257,3,1,33.333333333333336,98.9
29711,996,12,996,608,6,6,20.0,79.07
29712,6936,53,6936,770,35,18,100.0,0.0
29713,13042608,791,0,4260293,412,379,7.142857142857143,0.0
29714,0,1,0,0,0,1,50.0,10.0
29715,190080,14,190080,1880,14,0,7.142857142857143,16.23
29716,12256020,423,0,99119,255,168,1.5384615384615383,0.0
29717,1452,31,1440,1417,31,0,3.125,76.75
29718,10357200,1425,0,296890,854,571,1.0,0.0
29719,11940,45,11940,1248,42,3,100.0,0.0
29720,9960,21,9960,833,20,1,5.882352941176471,74.14
29721,7164972,21,7164972,9711,16,5,12.5,61.88
29722,73584,67,73584,4327,28,39,11.11111111111111,47.22
29723,21492,43,0,2346,28,15,100.0,0.0
29724,31032,84,0,1286,74,10,50.0,0.0
29725,5268,19,0,822,14,5,100.0,0.0
29726,68568,1,68568,1008,1,0,50.0,51.75
29727,178152,50,9108,4803,41,9,100.0,0.0
29728,2724,5,2724,333,5,0,16.666666666666668,0.0
29729,372,1,372,132,1,0,50.0,0.0
29730,32256,50,32256,1459,48,2,2.127659574468085,25.24
29731,11520,119,0,2593,95,24,14.285714285714286,0.0
29732,1332,20,1332,517,14,6,14.285714285714286,0.05
29733,12125244,585,0,55336,328,257,1.7857142857142858,0.0
29734,84564,77,84564,3320,64,13,100.0,0.0
29735,11485692,1735,3377860,1051096,1119,616,1.0,25.0
29736,432,5,432,194,5,0,16.666666666666668,78.61
29737,2376,4,2376,387,4,0,33.333333333333336,0.0
29738,68424,25,68424,787,24,1,5.2631578947368425,61.98
29739,234216,4,234216,165,3,1,25.0,63.03
29740,3444,18,0,632,13,5,100.0,0.0
29741,5976,36,5976,3603,31,5,3.4482758620689653,16.98
29742,82644,36,82644,12257,29,7,5.882352941176471,1.54
29743,4140,19,4140,1095,13,6,50.0,0.0
29744,45624,167,0,7591,126,41,100.0,0.0
29745,274980,531,0,4684,303,228,1.818181818181818,0.0
29746,891084,126,891084,200176,75,51,1.25,0.0
29747,684,2,684,330,1,1,50.0,99.59
29748,12306228,2095,0,177833,1196,899,1.0,0.0
29749,2472,54,2472,500,40,14,2.4390243902439024,10.76
29750,960,8,816,430,6,2,16.666666666666668,0.0
29751,1944,27,1944,340,25,2,5.0,34.7
29752,28404,131,0,2275,89,42,100.0,0.0
29753,7992,60,7992,1107,56,4,1.818181818181818,21.12
29754,1956,38,1956,521,37,1,16.666666666666668,34.38
29755,12972,52,12972,2437,50,2,100.0,0.0
29756,37164,4,37164,3768,2,2,33.333333333333336,69.22
29757,1596,52,1596,901,50,2,2.4390243902439024,68.81
29758,10344,106,0,1214,74,32,50.0,0.0
29759,336,0,336,0,0,0,100.0,100.0
29760,1272,46,1272,422,44,2,33.333333333333336,32.24
29761,576,9,576,313,6,3,33.333333333333336,0.0
29762,9096,26,9096,822,21,5,7.6923076923076925,68.25
29763,429324,75,3984,6449,56,19,100.0,0.0
29764,2040,68,0,604,57,11,2.631578947368421,0.0
29765,1548,41,1548,537,39,2,14.285714285714286,24.35
29766,660,79,660,224,79,0,2.127659574468085,46.05
29767,3060,32,3060,2152,21,11,7.142857142857143,75.45
29768,43200,271,0,9657,156,115,100.0,0.0
29769,12349920,211,610656,786580,89,122,5.0,0.0
29770,492,38,492,164,36,2,4.166666666666667,68.65
29771,90984,341,0,1250,178,163,3.333333333333333,0.0
29772,2832,39,2832,881,38,1,14.285714285714286,24.13
29773,504,64,504,121,56,8,3.225806451612903,64.86
29774,1016724,220,1016724,786,178,42,1.0,41.9
29775,61968,53,0,3978,44,9,100.0,0.0
29776,61872,0,61872,0,0,0,100.0,100.0
29777,7875672,453,7875672,12619,254,199,2.083333333333333,84.56
29778,16704,100,0,2521,81,19,16.666666666666668,0.0
29779,4313652,125,0,111620,106,19,50.0,0.0
29780,1692,1,1692,180,1,0,33.333333333333336,57.16
29781,43056,168,0,3708,113,55,33.333333333333336,0.0
29782,792,7,792,181,6,1,9.090909090909092,35.23
29783,11441772,53,0,283915,42,11,33.333333333333336,0.0
29784,127092,41,114552,23251,37,4,3.333333333333333,39.02
29785,65904,42,0,3102,36,6,100.0,0.0
29786,12751020,1417,7447032,381347,816,601,1.1363636363636365,71.37
29787,7522620,24,20196,941380,21,3,5.882352941176471,77.8
29788,360,2,360,54,1,1,100.0,100.0
29789,307080,251,269244,1709,204,47,1.0,26.4
29790,168,0,168,0,0,0,100.0,100.0
29791,4188,22,0,703,17,5,50.0,99.0
29792,3708,35,3708,883,33,2,7.142857142857143,1.89
29793,2160,4,2160,102,2,2,50.0,71.02
29794,360,11,360,111,7,4,25.0,98.47
29795,10356,131,0,1293,80,51,100.0,0.0
29796,696,8,576,319,5,3,25.0,73.87
29797,840,7,840,318,6,1,14.285714285714286,10.0
29798,37980,2,37098,864,2,0,50.0,98.09
29799,272016,178,272016,252,134,44,1.0,40.47
29800,170556,852,102912,12272,623,229,1.0,0.0
29801,377748,131,377748,171281,81,50,1.351351351351351,27.54
29802,12151152,222,3242295,232347,151,71,1.8867924528301887,78.48
29803,77904,17,756,4986,13,4,10.0,0.0
29804,3468,19,0,821,16,3,100.0,0.0
29805,5556,55,5556,881,53,2,8.333333333333334,13.61
29806,348,24,348,96,22,2,4.761904761904762,54.99
29807,6307548,59,0,324954,46,13,50.0,0.0
29808,1728,10,1728,510,6,4,33.333333333333336,73.46
29809,852,0,852,0,0,0,50.0,98.01
29810,408,36,408,125,36,0,4.545454545454546,62.67
29811,277836,456,277836,543,313,143,1.0,25.26
29812,1596,18,1596,101,8,10,20.0,94.43
29813,10824,111,0,2342,90,21,25.0,0.0
29814,12761808,357,3647784,55183,214,143,1.96078431372549,66.87
29815,2016,3,2016,504,1,2,50.0,99.64
29816,600,0,600,0,0,0,50.0,86.35
29817,7368,181,7368,325,130,51,1.0,25.71
29818,4452,0,4452,0,0,0,50.0,65.8
29819,5412,40,5412,597,38,2,9.090909090909092,22.24
29820,9420,194,9420,346,135,59,1.0526315789473684,28.03
29821,1500,3,1500,540,3,0,33.333333333333336,0.0
29822,23448,17,23448,278,14,3,9.090909090909092,61.57
29823,73236,28,73236,9022,27,1,4.166666666666667,45.18
29824,15600,46,0,3294,38,8,100.0,0.0
29825,2436,24,0,649,20,4,100.0,0.0
29826,2868,31,2868,1112,29,2,8.333333333333334,24.59
29827,5028,67,336,349,59,8,1.851851851851852,42.18
29828,1896,4,1896,831,4,0,25.0,0.0
29829,264,5,264,40,3,2,25.0,0.0
29830,348,12,348,222,12,0,7.142857142857143,67.16
29831,144,12,144,28,8,4,16.666666666666668,69.18
29832,8748,24,8748,3735,20,4,6.666666666666667,38.65
29833,396,14,396,20,14,0,6.25,49.17
29834,12768672,8374,670296,3113604,4902,3472,1.0,1.29
29835,456,41,456,109,40,1,3.8461538461538463,69.64
29836,7380,33,7380,3023,27,6,7.142857142857143,73.7
29837,1980,29,0,558,25,4,100.0,0.0
29838,13238856,690,0,174673,401,289,1.2048192771084338,0.0
29839,2820,79,2820,38,69,10,2.2222222222222223,39.82
29840,732,3,732,4,3,0,20.0,61.0
29841,1932,122,612,186,112,10,1.1111111111111112,31.17
29842,13043112,563,3480876,1127339,297,266,1.4492753623188406,0.0
29843,9679248,445,0,537678,253,192,2.1739130434782608,0.0
29844,636,110,0,63,97,13,1.0869565217391304,0.0
29845,528,28,528,39,24,4,4.166666666666667,62.5
29846,701172,13,0,215010,12,1,4.761904761904762,0.0
29847,588,29,588,219,19,10,6.25,80.59
29848,1408956,14,279888,332844,11,3,14.285714285714286,65.67
29849,1356,24,1356,92,15,9,9.090909090909092,78.36
29850,1164,42,0,377,33,9,33.333333333333336,37.5
29851,23832,36,0,1956,32,4,100.0,0.0
29852,40584,1,40584,180,1,0,50.0,93.74
29853,2448,43,2448,565,42,1,7.6923076923076925,15.62
29854,163356,19,0,8976,3,16,100.0,100.0
29855,24360,53,0,1848,45,8,100.0,0.0
29856,99300,2,99300,216,2,0,25.0,93.1
29857,37800,17,37800,3862,15,2,7.142857142857143,73.84
29858,696,6,696,392,6,0,12.5,62.6
29859,12772752,2758,0,558262,1563,1195,1.0,0.0
29860,10649844,232,0,202300,122,110,1.7241379310344829,3.07
29861,43896,10,43896,0,10,0,7.6923076923076925,58.17
29862,33408,135,33408,3359,95,40,1.8867924528301887,1.83
29863,12096,27,12096,1076,22,5,6.666666666666667,69.13
29864,168,10,168,63,5,5,50.0,61.12
29865,229440,57,0,4966,42,15,10.0,0.0
29866,13259556,18626,1390572,5653729,11865,6761,1.0,0.82
29867,840,15,840,308,14,1,6.666666666666667,86.67
29868,1764,27,1764,663,26,1,8.333333333333334,0.86
29869,36516,89,36516,78,86,3,2.127659574468085,56.9
29870,1212,2,1212,492,2,0,50.0,0.0
29871,672,81,672,43,73,8,2.083333333333333,33.24
29872,228,9,228,64,5,4,33.333333333333336,75.14
29873,5064,2,5064,144,2,0,100.0,100.0
29874,5050392,31,0,169145,24,7,100.0,100.0
29875,2364,3,2364,212,2,1,33.333333333333336,61.9
29876,14076,121,0,1004,86,35,100.0,0.0
29877,432,94,432,29,94,0,1.7857142857142858,53.29
29878,3732,2,3732,1908,1,1,100.0,100.0
29879,408,45,408,260,18,27,16.666666666666668,93.67
29880,804,168,0,81,151,17,1.0,0.0
29881,624,20,624,222,17,3,6.25,53.99
29882,888,8,888,321,6,2,20.0,80.94
29883,252,53,252,34,51,2,1.9230769230769231,61.11
29884,180,24,180,81,24,0,3.8461538461538463,39.14
29885,276,14,276,159,14,0,6.25,93.13
29886,60648,33,60648,1014,33,0,3.225806451612903,38.7
29887,11051628,121,2232,91787,92,29,1.408450704225352,28.21
29888,108,0,108,0,0,0,50.0,64.0
29889,11690916,2467,4094376,340164,1486,981,1.0,0.0
29890,1428456,59,1428456,53098,47,12,3.4482758620689653,45.49
29891,70164,22,0,4374,9,13,14.285714285714286,0.33
29892,636,202,444,165,173,29,1.0,28.06
29893,9416784,11,9416784,249,10,1,11.11111111111111,77.72
29894,25008,22,25008,478,17,5,7.142857142857143,71.95
29895,4332,6,2856,1886,4,2,25.0,92.69
29896,817272,170,817272,260889,91,79,6.25,67.41
29897,528,144,528,79,132,12,1.0,40.58
29898,157728,27,157728,42778,20,7,7.6923076923076925,0.0
29899,2004,19,2004,1361,19,0,5.555555555555555,32.19
29900,94788,47,0,6073,21,26,33.333333333333336,0.0
29901,10197840,805,2828376,18274,436,369,1.5384615384615383,0.0
29902,12103884,17,61836,1442260,9,8,1.694915254237288,0.0
29903,1884,17,1884,537,12,5,20.0,95.03
29904,12768,103,0,184,88,15,1.2195121951219512,0.0
29905,264,3,264,120,3,0,20.0,97.0
29906,1266384,60,0,27376,39,21,50.0,0.0
29907,60,0,60,0,0,0,100.0,100.0
29908,396,1,396,324,1,0,50.0,74.81
29909,6816,25,6816,693,24,1,4.545454545454546,56.11
29910,5203908,156,5203908,67640,93,63,1.9230769230769231,16.65
29911,60,26,60,13,21,5,5.555555555555555,68.73
29912,2544,5,2544,67,5,0,16.666666666666668,97.5
29913,158076,42,158076,3688,38,4,2.7777777777777777,35.53
29914,1068,3,1068,256,3,0,25.0,85.51
29915,13136436,1345,0,53551,792,553,1.0,0.1
29916,17424,5,17424,21,4,1,20.0,73.28
29917,1764,90,1764,25,90,0,1.9230769230769231,56.52
29918,3588,1,3588,420,1,0,50.0,98.22
29919,11328,30,0,6047,21,9,100.0,0.0
29920,16020,86,8292,1312,76,10,1.3888888888888888,60.63
29921,1895424,22,9288,99552,21,1,7.142857142857143,0.0
29922,7949928,596,7949928,12276,287,309,1.351351351351351,74.65
29923,4788,141,0,272,118,23,1.36986301369863,0.0
29924,132,20,108,47,14,6,7.6923076923076925,55.29
29925,3374124,154,566772,753681,71,83,3.333333333333333,0.0
29926,1308,16,1308,1276,14,2,6.666666666666667,82.85
29927,3936,2,3936,1950,2,0,33.333333333333336,82.82
29928,636,46,600,223,46,0,2.127659574468085,41.52
29929,10379136,578,7081488,40852,317,261,1.639344262295082,66.82
29930,8211456,69,8211456,4875,46,23,10.0,86.55
29931,2718816,56,2718816,579,25,31,8.333333333333334,0.0
29932,68760,113,0,15610,90,23,1.694915254237288,0.0
29933,4524,90,0,1997,71,19,100.0,0.0
29934,1640904,47,1073802,353078,47,0,2.380952380952381,26.5
29935,73248,38,0,2947,24,14,100.0,0.0
29936,564,87,564,143,82,5,1.492537313432836,28.7
29937,402840,64,402840,138404,54,10,2.0408163265306123,0.0
29938,19800,5,19800,4003,4,1,33.333333333333336,98.71
29939,2244,35,2244,818,23,12,14.285714285714286,76.5
29940,576,40,504,479,35,5,3.225806451612903,0.0
29941,258792,22,168786,2958,21,1,5.2631578947368425,39.63
29942,82104,414,45498,19481,117,297,1.6666666666666667,35.48
29943,9780,55,9780,9714,25,30,7.6923076923076925,61.1
29944,2756268,207,2756268,64870,90,117,6.666666666666667,0.0
29945,3384,0,3384,0,0,0,100.0,100.0
29946,13092,59,13092,1184,56,3,1.7543859649122806,21.04
29947,533916,422,0,3046,240,182,1.0,0.0
29948,11514576,1631,0,234792,874,757,1.0,0.11
29949,11628,191,11628,432,127,64,1.2048192771084338,55.1
29950,12911448,290,0,225514,169,121,2.0,4.0
29951,12874440,4943,62580,72346,2885,2058,1.0,0.0
29952,3108,38,0,513,26,12,4.761904761904762,0.0
29953,233124,30,72,15592,27,3,4.761904761904762,37.24
29954,7920960,1352,7920960,57929,742,610,1.0,51.24
29955,6175116,952,98030,48050,687,265,1.0,0.0
29956,18780,21,18780,1112,20,1,5.882352941176471,71.86
29957,22428,15,22428,9047,8,7,33.333333333333336,99.88
29958,73488,73,73488,3277,57,16,100.0,0.0
29959,2196,23,156,267,19,4,6.25,61.35
29960,8838720,371,0,1290056,198,173,3.333333333333333,0.0
29961,51672,107,0,3590,83,24,33.333333333333336,0.0
29962,11220840,1899,3121860,1286120,1043,856,1.0,0.0
29963,21864,59,21864,833,54,5,100.0,0.0
29964,70884,4,70884,11016,4,0,16.666666666666668,81.52
29965,53256,1,53256,3744,1,0,20.0,44.97
29966,3588,101,3588,2482,62,39,3.0303030303030303,25.19
29967,26400,25,18888,2757,23,2,5.0,79.43
29968,54168,2,54168,1980,2,0,20.0,44.9
29969,58272,26,58272,2112,26,0,3.4482758620689653,41.05
29970,7885308,254,7885308,27058,129,125,4.761904761904762,91.79
29971,66192,0,66192,0,0,0,100.0,100.0
29972,38136,40,38136,1037,32,8,4.0,14.85
29973,6300,56,6276,900,33,23,7.142857142857143,79.41
29974,142344,52,0,13458,36,16,100.0,0.0
29975,13308756,2977,8483772,2844240,1626,1351,1.0,0.0
29976,75300,29,75300,629,22,7,4.3478260869565215,9.82
29977,94704,33,94704,21212,25,8,7.142857142857143,1.0
29978,47412,49,0,2815,39,10,100.0,0.0
29979,13380588,2893,0,7379338,1544,1349,1.0,0.06
29980,1488,1,1488,564,1,0,100.0,0.0
29981,7995636,170,0,82973,99,71,4.3478260869565215,0.0
29982,384,60,384,185,38,22,3.125,41.99
29983,42504,12,42504,277,11,1,10.0,79.91
29984,1853304,502,0,5139,260,242,1.0,0.0
29985,4596,30,4596,1706,25,5,7.142857142857143,0.0
29986,11560860,5,0,3096403,1,4,2.0408163265306123,0.1
29987,3408,28,3408,237,22,6,4.166666666666667,39.35
29988,6872844,7,0,1063553,2,5,33.333333333333336,0.06
29989,6260088,39,1068,160771,31,8,100.0,0.0
29990,17796,139,17796,174,98,41,1.694915254237288,35.85
29991,11117892,107,4668,104670,95,12,1.2048192771084338,23.36
29992,12215172,357,0,586392,145,212,1.7241379310344829,0.0
29993,3982380,1009,171624,109211,749,260,1.0,56.91
29994,2568,2,2550,1704,1,1,100.0,100.0
29995,2784,19,2784,508,16,3,9.090909090909092,58.19
29996,122412,78,122412,23560,66,12,2.2222222222222223,4.01
29997,5976,43,0,1560,38,5,100.0,0.0
29998,3633036,1406,0,15061,584,822,1.1111111111111112,0.0
29999,182892,37,182892,2163,19,18,50.0,97.42
30000,492,112,0,50,95,17,1.1235955056179776,0.0
30001,98112,10,98112,790,9,1,10.0,72.66
30002,52944,22,52944,970,20,2,7.6923076923076925,62.61
30003,2580,61,2580,533,42,19,100.0,0.0
30004,2460,15,2460,576,14,1,9.090909090909092,35.83
30005,73260,91,0,27203,57,34,100.0,0.0
30006,13369920,7134,0,3777510,3925,3209,1.0,27.0
30007,24264,180,24264,333,142,38,1.0,30.91
30008,516,81,516,18,81,0,2.3255813953488373,59.81
30009,6948,1,6948,540,1,0,100.0,100.0
30010,30228,188,30228,509,146,42,1.0,63.87
30011,2541024,0,2541024,0,0,0,100.0,100.0
30012,168444,32,168444,10009,28,4,4.0,38.86
30013,35736,230,18822,824,205,25,2.0,68.38
30014,8538456,89,0,194243,76,13,50.0,0.0
30015,60612,39,0,4366,29,10,100.0,0.0
30016,40236,4,40236,40065,4,0,16.666666666666668,96.35
30017,27156,264,27156,485,188,76,1.0,45.4
30018,4800,42,0,1604,38,4,50.0,99.43
30019,7440,21,0,957,18,3,100.0,0.0
30020,1500,0,1500,0,0,0,100.0,100.0
30021,2328,12,2328,1877,8,4,11.11111111111111,84.68
30022,80652,15,80652,3062,13,2,14.285714285714286,69.03
30023,1653468,254,1653468,495,205,49,1.0,25.08
30024,2496,175,1772,1084,157,18,2.4390243902439024,27.65
30025,1721172,955,0,6764,611,344,1.3888888888888888,0.0
30026,924,35,0,337,29,6,33.333333333333336,37.5
30027,14736,37,14736,1749,33,4,3.333333333333333,1.56
30028,7152,29,7152,811,27,2,8.333333333333334,37.41
30029,360,16,72,50,12,4,8.333333333333334,56.39
30030,79860,59,79860,10131,47,12,2.5641025641025643,32.35
30031,64488,66,0,6420,55,11,100.0,0.0
30032,324,43,324,121,42,1,4.761904761904762,70.37
30033,11656368,747,0,25059,389,358,1.851851851851852,3.0
30034,852,94,852,88,70,24,1.694915254237288,21.92
30035,444,48,444,179,46,2,4.0,53.2
30036,1692,15,1692,317,10,5,14.285714285714286,60.64
30037,2148,55,0,743,46,9,2.7777777777777777,0.0
30038,3156,34,3156,1052,32,2,8.333333333333334,6.49
30039,1260,19,1260,617,18,1,5.882352941176471,38.71
30040,4764,21,0,554,16,5,100.0,0.0
30041,14328,105,0,2146,87,18,33.333333333333336,51.33
30042,10770936,3680,0,53159,2084,1596,1.0,0.0
30043,3825036,53,0,230447,47,6,50.0,0.0
30044,8133996,2086,4296090,232812,1181,905,1.0,0.0
30045,4500,58,0,768,46,12,2.7777777777777777,0.0
30046,36756,88,36756,69,60,28,1.7543859649122806,26.25
30047,2268,19,2268,714,17,2,8.333333333333334,26.68
30048,2220,25,0,564,17,8,100.0,0.0
30049,10560,48,0,2396,39,9,100.0,0.0
30050,4440,56,4440,753,53,3,2.702702702702702,42.68
30051,32892,87,32892,67,81,6,1.639344262295082,29.24
30052,2184,44,2184,785,40,4,11.11111111111111,34.59
30053,39048,97,39048,181,76,21,1.5384615384615383,39.29
30054,17124,26,17124,1051,21,5,6.25,67.17
30055,45828,12,1788,4586,12,0,10.0,0.0
30056,828,109,828,41,85,24,1.639344262295082,42.48
30057,78324,203,73830,64927,141,62,1.2820512820512822,0.0
30058,4212,37,4212,1038,36,1,10.0,27.65
30059,29592,72,0,3079,49,23,100.0,0.0
30060,4160544,2108,0,21862,1037,1071,1.0,0.0
30061,2688,29,2652,943,28,1,5.0,26.33
30062,13350768,3586,1114404,609447,2022,1564,1.0,1.0
30063,312,39,312,130,39,0,2.7777777777777777,59.98
30064,12432564,173,0,101237,96,77,4.761904761904762,0.0
30065,2496,4,2496,735,4,0,25.0,0.0
30066,1632,23,1632,1115,21,2,4.545454545454546,35.3
30067,6612,9,6612,1058,7,2,14.285714285714286,71.68
30068,24312,3,24312,284,3,0,20.0,47.58
30069,11791872,619,0,108950,360,259,1.818181818181818,0.0
30070,52296,107,52296,576,95,12,1.098901098901099,12.33
30071,11794620,355,0,151419,192,163,2.5,2.0
30072,156,1,156,48,1,0,33.333333333333336,78.4
30073,1200,80,1176,636,66,14,2.857142857142857,71.33
30074,372,5,372,50,4,1,20.0,73.72
30075,89268,96,33570,9745,74,22,1.96078431372549,2.58
30076,25572,20,25572,24465,20,0,4.761904761904762,72.74
30077,240,13,240,214,13,0,6.666666666666667,74.85
30078,2460,11,2460,434,8,3,14.285714285714286,44.07
30079,4932,22,4932,898,20,2,5.555555555555555,82.78
30080,528,35,528,200,21,14,8.333333333333334,61.19
30081,11348424,121,0,501248,62,59,7.6923076923076925,0.0
30082,6937848,440,0,32998,226,214,1.8867924528301887,0.0
30083,7428,5,7428,184,4,1,20.0,73.31
30084,276,0,276,0,0,0,50.0,64.0
30085,13083528,780,0,48074,435,345,1.36986301369863,0.0
30086,14736,61,14736,202,57,4,2.5,61.19
30087,144,12,144,55,10,2,10.0,62.56
30088,540,88,540,123,79,9,1.7543859649122806,59.14
30089,588,4,588,369,2,2,100.0,99.48
30090,168,6,168,40,4,2,25.0,60.67
30091,144,22,108,26,21,1,4.761904761904762,41.96
30092,148224,75,93594,1590,52,23,1.96078431372549,34.89
30093,2160,199,0,320,132,67,100.0,0.0
30094,253368,17,253368,942,17,0,14.285714285714286,96.95
30095,90828,3,90828,284,3,0,33.333333333333336,0.69
30096,12929664,407,0,167965,233,174,1.5873015873015872,1.0
30097,2652,45,1428,835,33,12,3.4482758620689653,0.0
30098,2476764,488,638898,10370,402,86,1.2987012987012987,43.68
30099,432,6,432,226,4,2,33.333333333333336,92.9
30100,2100,127,0,185,107,20,1.0101010101010102,0.0
30101,82560,5,0,17102,3,2,25.0,10.0
30102,9504936,26,6544572,290,24,2,4.0,63.73
30103,3664224,1055,4668,40368,508,547,1.0,0.0
30104,1040160,3,1040160,18088,2,1,100.0,100.0
30105,1596,13,1596,1100,13,0,7.142857142857143,87.93
30106,1368,38,1368,1061,38,0,2.5,73.45
30107,6600,29,6600,3827,25,4,5.0,41.73
30108,888504,21,0,43913,21,0,3.225806451612903,0.0
30109,84336,2,84336,30,1,1,50.0,76.19
30110,82584,372,0,5586,256,116,100.0,100.0
30111,792,25,738,207,24,1,100.0,0.0
30112,2194368,391,0,22401,214,177,2.1739130434782608,0.0
30113,10359348,1749,522072,189827,910,839,1.0,0.0
30114,7385232,16,1608,462210,10,6,20.0,91.54
30115,11144808,153,2884236,79135,77,76,4.545454545454546,84.04
30116,25728,95,25728,364,84,11,1.851851851851852,30.82
30117,7901364,1313,5230836,122217,710,603,1.0,52.3
30118,13249464,2981,7886736,3460498,1320,1661,1.0,2.62
30119,264,15,192,137,13,2,7.142857142857143,55.24
30120,13114596,911,3593916,856127,307,604,1.0,0.02
30121,648,7,432,447,6,1,14.285714285714286,0.0
30122,1764,2,1572,1686,1,1,50.0,90.0
30123,99804,23,3396,6806,22,1,4.0,0.0
30124,792,7,792,368,5,2,20.0,90.62
30125,966408,68,72540,30717,64,4,1.694915254237288,20.96
30126,1008,29,1008,591,28,1,3.571428571428572,59.74
30127,13202340,2161,477840,197116,1128,1033,1.0,0.0
30128,51264,15,132,4025,11,4,8.333333333333334,61.9
30129,12819924,226,0,766180,116,110,4.3478260869565215,0.0
30130,156,16,156,29,13,3,8.333333333333334,58.55
30131,59016,130,0,2174,60,70,4.166666666666667,5.0
30132,744,4,744,0,4,0,16.666666666666668,72.0
30133,12947100,159,0,102199,79,80,5.882352941176471,1.0
30134,1212,0,1212,0,0,0,50.0,64.0
30135,1704,4,1704,54,2,2,50.0,62.99
30136,144,27,84,69,21,6,5.882352941176471,60.58
30137,8643708,311,0,35101,178,133,1.8867924528301887,0.0
30138,10522992,660,251232,115705,352,308,2.5,0.39
30139,8643840,40,0,221956,23,17,14.285714285714286,0.0
30140,8642964,46,0,384933,22,24,12.5,0.0
30141,11502528,1774,3524844,243226,1076,698,1.0,0.0
30142,204,0,204,0,0,0,50.0,64.0
30143,1080,8,1080,348,6,2,20.0,59.3
30144,21312,227,8517,4064,190,37,1.6129032258064515,0.0
30145,4824,5,4824,309,3,2,50.0,99.11
30146,13056660,3254,3302659,857349,1911,1343,1.0,0.0
30147,516,320,516,177,164,156,1.0,38.37
30148,1203720,130,132,17192,67,63,8.333333333333334,0.37
30149,12661596,872,1418688,1588152,429,443,1.0,2.36
30150,1296,92,1296,253,65,27,2.1739130434782608,25.68
30151,1140,59,1140,196,47,12,3.8461538461538463,60.97
30152,60204,12,60204,2400,12,0,12.5,68.81
30153,13324344,1235,6733392,6916957,773,462,1.0,0.0
30154,56412,51,56412,396,41,10,2.702702702702702,3.49
30155,13463376,6626,422304,1659277,3816,2810,1.0,0.0
30156,63192,50,0,7366,40,10,100.0,0.0
30157,840,28,840,422,20,8,5.555555555555555,74.62
30158,79368,102,0,49437,69,33,100.0,0.0
30159,8484,235,8484,1836,112,123,1.9230769230769231,49.55
30160,2736,26,2736,1000,24,2,7.6923076923076925,14.27
30161,162828,91,3456,3143,69,22,100.0,0.0
30162,1728276,159,1728276,6569,127,32,1.0,13.96
30163,12861276,491,1560,69558,233,258,1.8867924528301887,2.38
30164,648,21,648,333,19,2,5.555555555555555,48.26
30165,12342528,5892,4660446,427619,3346,2546,1.0,0.0
30166,384,21,204,82,18,3,4.761904761904762,0.0
30167,2506536,16,1608918,429368,6,10,33.333333333333336,91.48
30168,2760,78,2760,1166,63,15,1.6666666666666667,1.44
30169,104856,49,0,5105,32,17,100.0,0.0
30170,89004,81,89004,379,67,14,1.639344262295082,24.97
30171,668736,11,668736,56149,1,10,7.142857142857143,0.0
30172,1440,3,1440,1036,1,2,50.0,99.8
30173,2064,28,2064,622,28,0,4.166666666666667,45.38
30174,31224,54,31224,848,50,4,2.127659574468085,24.07
30175,105672,139,105672,574,103,36,1.2820512820512822,25.32
30176,2160,21,2160,646,19,2,7.6923076923076925,30.26
30177,1500,73,1500,1074,67,6,3.0303030303030303,57.02
30178,492,5,492,271,5,0,14.285714285714286,88.96
30179,10752132,537,0,54496,298,239,1.2820512820512822,6.09
30180,264,35,264,86,30,5,12.5,85.5
30181,2556,8,2556,937,6,2,20.0,72.53
30182,1404,21,0,396,16,5,100.0,0.0
30183,11179032,363,0,35422,178,185,3.125,2.91
30184,1428,179,1428,356,133,46,1.0,12.2
30185,13416,66,13416,1834,55,11,4.545454545454546,48.48
30186,77688,58,0,2802,43,15,100.0,0.0
30187,3036,36,3036,903,32,4,9.090909090909092,0.0
30188,2601936,112,2601936,354449,63,49,7.142857142857143,86.34
30189,9062772,413,9062772,37281,226,187,1.492537313432836,70.13
30190,2639376,205,2639376,105024,102,103,7.142857142857143,63.95
30191,68376,157,0,3667,122,35,25.0,0.0
30192,1692,39,1692,782,36,3,4.761904761904762,31.96
30193,13012056,313,2693448,48269,200,113,2.5641025641025643,83.41
30194,69264,82,0,2630,58,24,100.0,0.0
30195,82980,42,80388,9724,37,5,3.0303030303030303,49.89
30196,624,50,624,16,50,0,2.083333333333333,37.4
30197,4656,19,4656,1891,18,1,100.0,0.0
30198,152244,34,152244,135927,20,14,8.333333333333334,76.58
30199,113160,69,0,4338,48,21,100.0,0.0
30200,1404,4,240,1056,3,1,33.333333333333336,62.4
30201,8075808,858,4380222,214937,465,393,1.075268817204301,51.38
30202,7791132,1778,4057164,418835,952,826,1.1111111111111112,73.56
30203,869016,37,178116,39861,35,2,3.4482758620689653,31.05
30204,6648,32,6648,793,31,1,7.6923076923076925,24.49
30205,8602128,1294,8602128,179819,742,552,1.0,57.08
30206,51828,39,51828,1930,33,6,3.8461538461538463,0.58
30207,2016,66,0,768,55,11,2.272727272727273,0.0
30208,2427408,129,2427408,1980,61,68,4.545454545454546,86.84
30209,17568,162,0,3073,86,76,100.0,0.0
30210,144,0,144,0,0,0,50.0,65.46
30211,222852,46,165948,21906,36,10,3.703703703703704,41.97
30212,3744,26,3744,1627,21,5,8.333333333333334,79.76
30213,3144,4,1950,2217,4,0,16.666666666666668,92.04
30214,4212,28,0,1430,21,7,50.0,99.0
30215,12779640,1769,1132632,66337,1011,758,1.0,8.4
30216,32148,38,32148,149,14,24,25.0,97.41
30217,32664,3,32664,88,1,2,50.0,99.68
30218,9396600,59,0,606803,47,12,100.0,0.0
30219,32820,3,32820,400,2,1,33.333333333333336,62.23
30220,1536,51,1536,680,34,17,25.0,94.81
30221,312,1,312,60,1,0,33.333333333333336,76.21
30222,12991164,1741,0,143773,957,784,1.0,0.0
30223,9281244,161,0,464332,131,30,33.333333333333336,0.0
30224,456,0,456,0,0,0,100.0,100.0
30225,1188,2,1188,444,2,0,50.0,0.0
30226,324,18,324,136,16,2,5.555555555555555,78.5
30227,120,2,120,54,1,1,50.0,63.42
30228,1339476,100,0,66952,82,18,2.4390243902439024,0.05
30229,156,2,156,0,2,0,25.0,76.0
30230,648,30,648,216,30,0,3.8461538461538463,48.77
30231,156,21,156,32,17,4,6.666666666666667,52.84
30232,492,108,492,79,52,56,4.3478260869565215,81.33
30233,132,8,132,3,8,0,10.0,64.0
30234,1140,2,1140,456,2,0,50.0,0.0
30235,528,4,528,54,2,2,50.0,64.65
30236,12843948,3090,8491728,4690085,1781,1309,1.0,0.0
30237,20796,112,1152,638,61,51,4.761904761904762,79.97
30238,2395176,9,2395176,63230,5,4,20.0,95.74
30239,24852,9,0,3473,7,2,100.0,0.0
30240,1566432,25,116496,63419,17,8,9.090909090909092,94.93
30241,3888,15,0,705,12,3,100.0,0.0
30242,3114876,185,3114876,17294,95,90,4.0,0.0
30243,372,1,0,372,0,1,100.0,0.0
30244,3468,47,0,391,40,7,4.0,0.0
30245,564,57,564,186,55,2,3.333333333333333,48.18
30246,264,12,264,0,12,0,7.142857142857143,44.8
30247,12372,170,12372,466,121,49,1.020408163265306,41.63
30248,1212,31,1212,324,27,4,4.545454545454546,39.16
30249,840,34,840,75,30,4,3.333333333333333,51.73
30250,122256,48,0,6655,31,17,100.0,0.0
30251,1500,3,1500,568,3,0,33.333333333333336,33.27
30252,1620,18,0,546,13,5,100.0,0.0
30253,648,1,648,492,1,0,100.0,100.0
30254,4176,57,0,918,48,9,2.7777777777777777,0.0
30255,864,35,696,690,31,4,3.225806451612903,69.35
30256,480,51,480,37,39,12,2.7777777777777777,50.87
30257,1692,27,0,474,23,4,50.0,50.0
30258,2628480,219,0,54321,124,95,4.3478260869565215,0.0
30259,1128,33,0,374,29,4,33.333333333333336,37.5
30260,2832,43,1056,425,20,23,4.166666666666667,83.0
30261,35784,17,35784,314,14,3,8.333333333333334,57.99
30262,6840,14,6840,2422,10,4,16.666666666666668,89.42
30263,9948,41,0,2278,34,7,100.0,0.0
30264,504,28,504,79,24,4,4.166666666666667,65.36
30265,965496,364,27540,135508,226,138,16.666666666666668,0.0
30266,1344,24,1344,558,23,1,11.11111111111111,14.23
30267,9721116,445,9721116,28941,285,160,1.694915254237288,84.32
30268,1440,13,0,477,10,3,100.0,0.0
30269,1368,8,1368,1197,6,2,14.285714285714286,93.77
30270,2076,1,0,2076,0,1,100.0,0.0
30271,1668,59,1656,393,30,29,8.333333333333334,83.56
30272,52392,103,52392,1295,40,63,33.333333333333336,98.26
30273,2076,5,2076,484,5,0,20.0,0.0
30274,3108,44,3108,309,24,20,6.25,60.45
30275,1416,23,1272,580,21,2,12.5,51.14
30276,3180,0,3180,0,0,0,50.0,64.0
30277,336,16,336,39,12,4,8.333333333333334,60.16
30278,9108,23,0,817,18,5,50.0,0.0
30279,29376,14,28362,8005,6,8,14.285714285714286,47.74
30280,133416,130,133416,46968,76,54,3.0303030303030303,29.69
30281,2088,2,2088,60,1,1,50.0,96.33
30282,1008,22,1008,111,13,9,16.666666666666668,58.5
30283,67596,56,67596,1303,49,7,2.083333333333333,28.8
30284,768,23,0,379,11,12,100.0,0.0
30285,864,67,864,286,26,41,20.0,3.03
30286,13474416,1719,966564,1189636,991,728,1.0,0.0
30287,312,22,240,140,19,3,5.2631578947368425,67.39
30288,2208,28,1350,883,26,2,5.882352941176471,53.86
30289,1308,29,756,778,25,4,3.8461538461538463,63.9
30290,648,69,648,50,63,6,2.857142857142857,42.1
30291,1140,28,1140,79,26,2,3.703703703703704,56.87
30292,792,95,792,102,93,2,1.851851851851852,55.67
30293,1135464,153,0,22339,115,38,1.0,0.0
30294,2400,69,2400,15,67,2,2.5,48.36
30295,2748,44,2748,355,38,6,2.702702702702702,72.09
30296,216,38,192,48,30,8,3.571428571428572,44.48
30297,492,90,492,41,90,0,1.492537313432836,56.01
30298,4984272,565,4984272,39339,306,259,2.272727272727273,83.46
30299,9069540,26,9053388,330,23,3,4.545454545454546,68.79
30300,11224392,742,2669304,188826,321,421,1.2987012987012987,0.0
30301,672,6,672,16,6,0,12.5,55.76
30302,408,3,408,180,3,0,20.0,69.0
30303,432,40,432,113,39,1,3.4482758620689653,73.76
30304,51528,167,28716,3033,119,48,1.351351351351351,7.09
30305,2726088,309,2726088,8923,175,134,2.380952380952381,69.05
30306,812088,20,0,57477,12,8,11.11111111111111,3.69
30307,2690568,136,2690568,4715,66,70,7.142857142857143,75.29
30308,744,160,0,54,126,34,1.0,0.0
30309,1188,158,504,149,125,33,1.3157894736842106,52.54
30310,252,1,252,24,1,0,33.333333333333336,98.05
30311,2134296,60,612,71176,52,8,2.083333333333333,63.65
30312,2179740,127,504,34365,107,20,1.6666666666666667,58.31
30313,2703552,75,2703552,8692,50,25,5.555555555555555,0.0
30314,372,29,372,151,25,4,4.166666666666667,60.43
30315,52968,48,0,4454,31,17,100.0,0.0
30316,444,35,444,93,35,0,3.225806451612903,79.52
30317,1644,57,1644,110,45,12,2.5641025641025643,43.82
30318,43320,50,43320,954,38,12,100.0,0.0
30319,1224,64,1224,435,46,18,2.702702702702702,53.72
30320,85824,4,85824,2142,4,0,20.0,81.88
30321,420,109,420,101,89,20,1.4492753623188406,50.76
30322,14616,29,14616,3228,19,10,9.090909090909092,93.54
30323,1248,28,1248,685,28,0,4.166666666666667,45.83
30324,492,30,492,244,11,19,25.0,0.0
30325,9016560,488,8597200,780894,184,304,2.1739130434782608,0.0
30326,12718500,19010,5689212,6498665,10764,8246,1.0,1.27
30327,2720988,8,2720988,1062,4,4,25.0,0.0
30328,540,60,528,193,51,9,3.0303030303030303,53.65
30329,828,189,0,83,149,40,1.0,0.0
30330,876,2,876,228,1,1,100.0,100.0
30331,9076788,26,5257878,144,25,1,3.703703703703704,66.61
30332,1256124,61,1256124,2029,23,38,11.11111111111111,73.53
30333,1164,149,1164,66,133,16,1.25,44.28
30334,1308,115,1104,114,101,14,1.162790697674419,0.0
30335,42600,97,42600,221,79,18,1.36986301369863,27.89
30336,168,26,168,79,12,14,14.285714285714286,0.0
30337,89556,3,89556,276,3,0,25.0,50.36
30338,216,85,204,81,61,24,1.96078431372549,53.52
30339,10848,74,10848,1413,71,3,1.4492753623188406,17.98
30340,44052,70,44052,55,66,4,1.5384615384615383,19.61
30341,13508112,1926,1019556,1337235,1068,858,1.0,0.0
30342,12111228,13846,5947206,3540871,8024,5822,1.0,0.0
30343,23484,43,0,1582,29,14,100.0,0.0
30344,492,120,492,125,64,56,2.857142857142857,0.0
30345,13519740,127440,6122515,6484840,84045,43395,1.0,1.78
30346,11436624,101,44436,113327,82,19,1.36986301369863,20.96
30347,2746716,22,2746716,2648,16,6,7.142857142857143,0.0
30348,84732,132,45600,745,98,34,1.4285714285714286,25.67
30349,852,42,636,246,34,8,100.0,0.0
30350,1692,8,1692,576,7,1,14.285714285714286,65.2
30351,2604,6,1908,1992,4,2,2.7777777777777777,93.65
30352,46164,178,46164,164,116,62,1.2195121951219512,31.7
30353,58632,0,58632,0,0,0,100.0,100.0
30354,9156,17,9156,446,14,3,7.6923076923076925,48.71
30355,12365868,196,0,184359,80,116,3.125,3.04
30356,48996,95,48996,290,75,20,1.5625,26.97
30357,7718472,213,1438098,57755,200,13,3.4482758620689653,75.99
30358,3756,108,3756,75,89,19,1.2658227848101269,32.96
30359,240,52,120,54,52,0,1.9230769230769231,57.67
30360,50976,155,50976,156,107,48,1.2195121951219512,17.98
30361,10975668,492,0,147794,228,264,1.0,0.0
30362,9826200,2741,8323416,55730,1143,1598,1.0,66.45
30363,79056,510,0,7479,347,163,1.0,0.0
30364,144,5,144,62,5,0,14.285714285714286,70.73
30365,156,0,156,0,0,0,50.0,64.0
30366,47124,56,0,2067,36,20,100.0,0.0
30367,52596,120,52596,172,84,36,1.492537313432836,50.54
30368,13014216,11914,0,4483065,7132,4782,1.0,0.0
30369,1320,157,0,69,134,23,1.0,0.0
30370,8388516,84,8388516,9048,52,32,20.0,98.22
30371,11400,49,6900,599,42,7,2.857142857142857,5.42
30372,17748,3,17748,876,1,2,50.0,63.77
30373,2340,24,0,642,18,6,100.0,0.0
30374,167232,401,165036,125621,317,84,1.2658227848101269,42.8
30375,13338084,6847,1038924,435478,3828,3019,1.0,0.0
30376,188136,313,0,2706,172,141,1.96078431372549,1.0
30377,11234124,576,0,39819,324,252,1.098901098901099,5.98
30378,5460,12,5460,1134,10,2,14.285714285714286,94.61
30379,12571644,3617,0,177342,2030,1587,1.0,0.0
30380,4764,0,4764,0,0,0,50.0,40.0
30381,2616,22,0,705,18,4,50.0,99.0
30382,36300,110,0,3045,88,22,50.0,0.0
30383,9372,203,9372,2118,114,89,1.4705882352941178,34.15
30384,15612,64,15612,1216,59,5,1.7543859649122806,21.75
30385,8068068,894,0,56000,481,413,1.36986301369863,0.0
30386,20856,64,20856,131,62,2,1.5625,18.34
30387,3050256,171,3050256,18517,88,83,4.0,81.53
30388,13362828,2551,182952,170838,1486,1065,1.0,0.0
30389,1380,7,1380,524,5,2,33.333333333333336,96.91
30390,10532784,26,0,1216091,19,7,25.0,0.0
30391,16644,69,16644,747,49,20,100.0,0.0
30392,1572,1,1572,0,1,0,14.285714285714286,61.53
30393,360,2,360,24,2,0,33.333333333333336,90.48
30394,2049216,61,0,36561,46,15,50.0,0.0
30395,81948,646,31704,10316,442,204,1.0,0.0
30396,3156,5,3156,684,5,0,16.666666666666668,67.54
30397,18012,56,0,1288,39,17,100.0,0.0
30398,22920,13,0,12859,9,4,50.0,0.0
30399,7402596,51,0,1180993,42,9,50.0,0.0
30400,384,6,384,126,5,1,20.0,81.68
30401,4141008,32,0,129916,25,7,100.0,0.0
30402,1560,24,0,406,18,6,100.0,0.0
30403,219276,28,219276,1258,25,3,6.666666666666667,52.29
30404,220224,7,0,37513,4,3,33.333333333333336,0.0
30405,9383916,10,0,940798,4,6,4.761904761904762,0.0
30406,1596,49,1596,1093,47,2,3.4482758620689653,56.25
30407,7144980,34,0,210751,27,7,100.0,0.0
30408,4147644,84,0,51987,62,22,50.0,0.0
30409,1989612,8,1260,496156,6,2,20.0,90.89
30410,10692744,384,247116,266406,280,104,1.0526315789473684,47.46
30411,475188,39,0,25546,35,4,100.0,0.0
30412,1476,34,1476,666,32,2,7.6923076923076925,34.87
30413,516,14,516,143,10,4,20.0,52.72
30414,13207548,2851,0,337634,1638,1213,1.0,0.0
30415,1843392,51,0,145883,33,18,50.0,0.0
30416,163716,131,0,4460,100,31,50.0,0.0
30417,3683940,47,3635832,92528,47,0,1.8867924528301887,47.11
30418,1208856,126,3084,38478,88,38,1.5625,32.28
30419,18072,12,15600,8037,6,6,14.285714285714286,0.0
30420,4812,24,4812,1591,12,12,50.0,0.0
30421,158532,47,158532,15054,38,9,4.166666666666667,0.77
30422,2843556,357,0,15083,199,158,3.225806451612903,0.0
30423,2432100,416,0,9844,224,192,1.8867924528301887,0.0
30424,5274936,5,5274936,278546,2,3,100.0,100.0
30425,171012,24,171012,8157,23,1,4.545454545454546,42.78
30426,23496,99,0,2395,77,22,100.0,0.0
30427,4570872,90,0,98623,77,13,50.0,0.0
30428,456,37,408,207,34,3,3.125,45.95
30429,1680,0,1680,0,0,0,50.0,81.0
30430,10520472,61,0,338465,27,34,9.090909090909092,0.0
30431,86808,38,86808,5401,32,6,3.571428571428572,48.03
30432,732,41,732,174,38,3,4.166666666666667,63.09
30433,912,10,0,103,9,1,100.0,0.0
30434,12385992,1431,1763796,1582098,820,611,1.0,0.0
30435,156,24,156,45,15,9,12.5,60.36
30436,8116740,53,0,367840,47,6,50.0,0.0
30437,10849992,612,0,107774,362,250,1.0638297872340423,0.0
30438,31968,59,0,1844,38,21,100.0,0.0
30439,90792,53,0,7640,43,10,50.0,0.0
30440,8208,107,0,2109,87,20,100.0,0.0
30441,13072152,917,0,122224,512,405,1.2195121951219512,0.0
30442,36252,16,36252,2352,12,4,20.0,97.26
30443,12947232,4300,0,335519,2507,1793,1.0,0.09
30444,1788,32,1788,700,29,3,8.333333333333334,19.38
30445,49536,10,49536,6288,6,4,33.333333333333336,96.12
30446,1440,7,1440,485,7,0,14.285714285714286,0.0
30447,98496,115,98496,222,65,50,2.380952380952381,51.78
30448,2028,9,2028,844,7,2,10.0,78.7
30449,260172,147,0,258412,93,54,50.0,0.0
30450,53952,160,53952,258,114,46,1.1363636363636365,38.53
30451,261060,40,261060,17400,36,4,3.225806451612903,60.72
30452,3624,12,3624,2757,11,1,10.0,79.23
30453,14556,100,0,2202,81,19,100.0,0.0
30454,5796,55,0,1861,49,6,100.0,0.0
30455,1541136,3,2088,514216,3,0,100.0,0.0
30456,6840,55,0,2032,43,12,100.0,0.0
30457,101652,170,101652,326,106,64,1.351351351351351,53.97
30458,235812,56,235812,2136,42,14,2.857142857142857,43.54
30459,59124,139,59124,93,99,40,1.408450704225352,35.68
30460,612000,33,308472,18687,21,12,5.2631578947368425,43.42
30461,2052,34,2052,590,33,1,10.0,20.38
30462,3992628,1080,0,27556,576,504,1.0526315789473684,0.0
30463,2640,56,1008,428,56,0,3.571428571428572,60.64
30464,11730300,103,11730300,2837915,47,56,1.0,49.17
30465,1080,78,1080,316,62,16,2.3255813953488373,41.57
30466,12654108,58,0,272607,39,19,50.0,0.0
30467,1812,26,0,563,20,6,100.0,0.0
30468,2160,35,2160,856,33,2,6.25,44.18
30469,3199704,210,3199704,21878,110,100,3.703703703703704,86.15
30470,81276,23,81276,394,19,4,7.6923076923076925,57.29
30471,6348,9,4788,1938,9,0,9.090909090909092,82.25
30472,1824,3,1824,788,3,0,33.333333333333336,19.16
30473,141336,44,2568,10504,39,5,6.666666666666667,33.7
30474,1188,35,1188,582,30,5,3.8461538461538463,78.12
30475,12240,196,12240,629,122,74,1.1494252873563218,40.08
30476,13370556,71,0,309096,58,13,2.7777777777777777,0.0
30477,1776,26,0,587,20,6,100.0,0.0
30478,4092,81,4092,222,61,20,2.0,37.65
30479,432,5,204,144,4,1,20.0,97.11
30480,2388,29,2388,643,28,1,9.090909090909092,52.94
30481,4656,4,4656,66,2,2,50.0,0.0
30482,1428,56,1428,639,35,21,7.142857142857143,87.17
30483,2124,8,2124,1221,6,2,14.285714285714286,84.73
30484,216,23,216,68,15,8,11.11111111111111,0.0
30485,372,40,348,65,34,6,3.4482758620689653,67.13
30486,2595096,101,2595024,197929,38,63,10.0,0.0
30487,4908,31,2040,937,29,2,12.5,59.8
30488,948492,36,948492,117166,20,16,16.666666666666668,91.81
30489,351984,8,351984,350983,8,0,11.11111111111111,87.13
30490,51468,45,51360,8774,31,14,7.6923076923076925,80.43
30491,576,6,576,212,4,2,50.0,92.74
30492,698916,5,0,171501,3,2,25.0,0.0
30493,689676,70,689676,1840,58,12,1.851851851851852,0.49
30494,2376,6,2376,478,6,0,16.666666666666668,0.0
30495,168,0,168,0,0,0,100.0,100.0
30496,71892,91,45948,1721,67,24,100.0,0.0
30497,11978880,22,0,558103,18,4,100.0,0.0
30498,14172,59,0,2417,48,11,100.0,0.0
30499,154200,6,154200,4998,5,1,25.0,99.48
30500,154212,4,154212,369,3,1,33.333333333333336,99.67
30501,900,8,0,286,7,1,100.0,0.0
30502,40500,175,40500,2936,136,39,1.0309278350515465,6.12
30503,3420,73,2478,1010,65,8,1.694915254237288,0.0
30504,10860156,73,0,150472,51,22,100.0,0.0
30505,34728,30,2640,3009,21,9,20.0,2.18
30506,504,79,504,206,48,31,2.9411764705882355,65.9
30507,348,0,348,0,0,0,50.0,0.0
30508,9060,35,9060,1314,30,5,9.090909090909092,63.07
30509,516,29,516,220,25,4,5.555555555555555,0.0
30510,9154296,30,9138144,436,25,5,4.3478260869565215,69.23
30511,1320,0,1320,0,0,0,50.0,0.0
30512,258744,34,13152,23637,24,10,7.142857142857143,69.77
30513,372,3,0,276,1,2,50.0,0.0
30514,4752,202,228,151,131,71,1.818181818181818,46.83
30515,372,47,372,82,41,6,2.702702702702702,50.76
30516,1661904,66,0,56560,47,19,33.333333333333336,0.0
30517,12636,114,444,697,102,12,1.694915254237288,51.91
30518,5268,106,1200,362,93,13,1.1764705882352942,40.86
30519,9161928,34,5343420,757,32,2,3.0303030303030303,52.85
30520,2707548,73,2707548,694,62,11,1.7857142857142858,0.0
30521,876,153,876,75,137,16,1.162790697674419,40.06
30522,768,18,768,606,17,1,5.555555555555555,85.9
30523,1188,52,1164,641,38,14,5.0,56.84
30524,7981740,1293,7851792,44347,743,550,1.020408163265306,0.0
30525,144,1,144,0,1,0,33.333333333333336,65.6
30526,192,0,192,0,0,0,50.0,59.29
30527,2712000,1053,2712000,6878,694,359,1.0,0.0
30528,8376,106,1236,127,100,6,1.7241379310344829,52.67
30529,27396,47,0,1859,31,16,100.0,0.0
30530,84108,105,84108,8028,55,50,5.2631578947368425,45.81
30531,312,40,312,104,29,11,5.555555555555555,66.82
30532,1092,0,1092,0,0,0,100.0,100.0
30533,6665016,18,6665016,38452,13,5,10.0,80.98
30534,3960,129,3960,3138,56,73,2.857142857142857,64.08
30535,169824,0,169824,0,0,0,100.0,100.0
30536,180,0,180,0,0,0,50.0,67.24
30537,13554456,1692,3719400,243269,956,736,1.0,0.0
30538,2762496,412,2762496,31100,350,62,1.6129032258064515,77.85
30539,86712,10,86712,4833,8,2,12.5,80.44
30540,6060,23,6060,1015,18,5,9.090909090909092,66.74
30541,48360,105,48360,1423,73,32,1.5625,25.7
30542,3912,0,3912,0,0,0,50.0,73.88
30543,79308,177,79308,1191,135,42,1.0,36.3
30544,26856,72,0,2036,50,22,100.0,0.0
30545,960,1,960,96,1,0,50.0,99.01
30546,768,59,768,196,51,8,2.631578947368421,55.55
30547,11952,18,11952,3979,14,4,20.0,95.29
30548,4308,8,324,1153,5,3,25.0,9.66
30549,1392,0,1392,0,0,0,16.666666666666668,90.12
30550,324,5,324,57,4,1,20.0,73.3
30551,133776,40,133776,21975,37,3,3.225806451612903,30.37
30552,444,36,384,201,33,3,3.4482758620689653,50.49
30553,3828,24,2436,1680,22,2,4.3478260869565215,60.4
30554,552,34,348,208,33,1,3.0303030303030303,36.83
30555,5400,83,5400,981,63,20,1.694915254237288,24.97
30556,13623036,25625,1013142,5216198,13651,11974,1.0,0.03
30557,45768,36,324,2586,33,3,3.125,47.59
30558,41940,59,41940,1153,44,15,3.225806451612903,54.68
30559,6264,11,6264,1279,7,4,20.0,92.58
30560,1428,22,0,396,18,4,100.0,0.0
30561,48684,112,0,3646,87,25,100.0,0.0
30562,2340,0,2340,0,0,0,100.0,80.95
30563,29832,63,0,3455,51,12,100.0,0.0
30564,29196,76,29196,2351,70,6,100.0,0.0
30565,99192,16,99192,10818,16,0,7.142857142857143,43.46
30566,35520,77,0,3141,68,9,100.0,0.0
30567,4536,53,4536,1099,42,11,100.0,0.0
30568,27540,31,0,2270,25,6,100.0,0.0
30569,576,39,576,247,37,2,3.8461538461538463,52.66
30570,17412,51,0,1235,35,16,100.0,0.0
30571,3312,10,3312,582,6,4,33.333333333333336,76.18
30572,10818216,234,0,2326225,96,138,1.0,0.0
30573,996,1,996,612,1,0,33.333333333333336,94.27
30574,552,51,360,208,36,15,4.0,0.0
30575,2775216,126,2775216,70826,61,65,4.761904761904762,87.64
30576,444,42,408,97,41,1,2.9411764705882355,52.18
30577,21528,19,21528,817,19,0,5.882352941176471,83.19
30578,2400,83,2400,860,79,4,2.5641025641025643,28.14
30579,27684,99,27684,6603,47,52,3.4482758620689653,49.07
